"Participant","Event","Valence","E1","eBR","BR","E2","direction","update"
1,4,3,30,50,78,30,"1",0
1,8,3,100,100,75,100,"-1",0
1,12,3,100,100,78,80,"-1",20
1,24,3,5,5,14,10,"1",-5
1,26,3,100,75,29,100,"-1",0
1,28,3,20,20,20,20,"0",0
1,33,3,10,10,15,20,"1",-10
1,34,3,100,80,80,100,"-1",0
1,36,3,50,50,26,50,"-1",0
1,37,3,90,80,30,80,"-1",10
1,43,3,60,30,81,60,"1",0
1,47,3,100,20,20,100,"-1",0
2,11,3,10,20,31,10,"1",0
2,12,3,99,99,78,99,"-1",0
2,20,3,10,10,40,25,"1",-15
2,24,3,20,20,14,15,"-1",5
2,28,3,33,33,20,20,"-1",13
2,30,3,15,10,48,15,"1",0
2,41,3,10,5,17,50,"1",-40
2,42,3,20,25,13,25,"-1",-5
2,44,3,10,10,19,10,"1",0
2,45,3,0,25,19,0,"1",0
3,3,3,0,3,29,0,"1",0
3,4,3,10,3,78,10,"1",0
3,25,3,0,2,14,1,"1",-1
3,28,3,5,5,20,7,"1",-2
3,34,3,0,2,80,0,"1",0
3,37,3,1,1,30,5,"1",-4
3,43,3,0,1,81,0,"1",0
3,44,3,1,3,19,5,"1",-4
3,47,3,0,3,20,0,"1",0
3,50,3,0,4,38,0,"1",0
3,51,3,7,4,26,5,"1",2
4,1,3,50,40,26,25,"-1",25
4,3,3,0,40,29,0,"1",0
4,21,3,40,45,35,65,"-1",-25
4,26,3,100,85,29,85,"-1",15
4,27,3,60,60,45,95,"-1",-35
4,28,3,19,25,20,20,"1",-1
4,31,3,75,85,19,15,"-1",60
4,33,3,100,70,15,100,"-1",0
4,37,3,30,30,30,65,"0",-35
4,38,3,100,95,71,100,"-1",0
4,39,3,40,55,43,30,"1",10
4,41,3,45,33,17,75,"-1",-30
4,42,3,100,95,13,100,"-1",0
4,43,3,5,20,81,35,"1",-30
4,44,3,30,30,19,20,"-1",10
4,45,3,100,60,19,75,"-1",25
4,50,3,0,20,38,0,"1",0
5,1,3,72,42,26,60,"-1",12
5,3,3,0,36,29,0,"1",0
5,4,3,95,98,78,80,"-1",15
5,6,3,5,10,29,5,"1",0
5,7,3,80,35,45,90,"-1",-10
5,8,3,10,30,75,20,"1",-10
5,9,3,36,22,29,40,"-1",-4
5,10,3,28,67,56,60,"1",-32
5,11,3,5,20,31,5,"1",0
5,12,3,20,36,78,20,"1",0
5,15,3,46,78,60,30,"1",16
5,17,3,0,18,43,10,"1",-10
5,19,3,0,32,21,0,"1",0
5,20,3,0,22,40,0,"1",0
5,21,3,20,20,35,20,"1",0
5,24,3,2,25,14,10,"1",-8
5,25,3,1,36,14,0,"1",1
5,26,3,100,90,29,99,"-1",1
5,28,3,54,65,20,10,"-1",44
5,30,3,0,19,48,0,"1",0
5,31,3,80,50,19,10,"-1",70
5,32,3,80,40,33,80,"-1",0
5,33,3,70,60,15,20,"-1",50
5,34,3,50,20,80,80,"1",-30
5,35,3,50,64,17,20,"-1",30
5,37,3,80,65,30,80,"-1",0
5,38,3,95,95,71,80,"-1",15
5,39,3,90,80,43,80,"-1",10
5,40,3,2,36,21,10,"1",-8
5,41,3,70,64,17,80,"-1",-10
5,42,3,78,67,13,70,"-1",8
5,43,3,32,22,81,10,"1",22
5,44,3,1,1,19,50,"1",-49
5,45,3,85,62,19,90,"-1",-5
5,46,3,70,60,45,60,"-1",10
5,47,3,0,20,20,0,"1",0
5,48,3,0,10,18,0,"1",0
5,49,3,0,12,11,0,"1",0
5,50,3,0,36,38,0,"1",0
6,1,3,50,50,26,50,"-1",0
6,3,3,20,20,29,10,"1",10
6,8,3,100,85,75,100,"-1",0
6,9,3,5,10,29,10,"1",-5
6,12,3,100,100,78,100,"-1",0
6,16,3,55,45,26,60,"-1",-5
6,21,3,99,99,35,100,"-1",-1
6,24,3,10,10,14,10,"1",0
6,26,3,100,80,29,100,"-1",0
6,27,3,80,80,45,50,"-1",30
6,28,3,19,19,20,20,"1",-1
6,30,3,100,39,48,100,"-1",0
6,31,3,50,50,19,40,"-1",10
6,33,3,50,50,15,50,"-1",0
6,34,3,100,100,80,100,"-1",0
6,37,3,67,67,30,50,"-1",17
6,40,3,100,95,21,100,"-1",0
6,42,3,28,58,13,20,"-1",8
6,44,3,19,19,19,15,"0",4
6,47,3,80,80,20,80,"-1",0
6,48,3,10,50,18,0,"1",10
6,49,3,0,10,11,10,"1",-10
7,3,3,0,12,29,0,"1",0
7,11,3,10,42,31,15,"1",-5
7,20,3,0,17,40,0,"1",0
7,24,3,20,20,14,20,"-1",0
7,25,3,2,36,14,10,"1",-8
7,26,3,0,78,29,4,"1",-4
7,28,3,19,16,20,20,"1",-1
7,30,3,0,23,48,0,"1",0
7,33,3,80,34,15,100,"-1",-20
7,34,3,69,78,80,43,"1",26
7,38,3,60,60,71,81,"1",-21
7,39,3,98,75,43,78,"-1",20
7,40,3,45,45,21,25,"-1",20
7,41,3,83,57,17,0,"-1",83
7,44,3,20,20,19,20,"-1",0
7,45,3,10,25,19,10,"1",0
7,48,3,25,30,18,21,"-1",4
7,51,3,15,4,26,4,"1",11
8,3,3,70,74,29,56,"-1",14
8,7,3,15,75,45,29,"1",-14
8,8,3,50,43,75,70,"1",-20
8,24,3,4,8,14,1,"1",3
8,26,3,100,89,29,99,"-1",1
8,27,3,88,32,45,100,"-1",-12
8,28,3,23,20,20,28,"-1",-5
8,30,3,73,40,48,67,"-1",6
8,33,3,10,40,15,20,"1",-10
8,38,3,92,88,71,91,"-1",1
8,40,3,1,1,21,4,"1",-3
8,41,3,100,64,17,99,"-1",1
8,43,3,0,87,81,100,"1",-100
8,44,3,2,17,19,1,"1",1
8,47,3,0,9,20,10,"1",-10
8,48,3,20,15,18,20,"-1",0
8,50,3,66,33,38,75,"-1",-9
9,4,3,90,79,78,60,"-1",30
9,24,3,40,30,14,54,"-1",-14
9,28,3,40,30,20,15,"-1",25
9,29,3,74,70,66,50,"-1",24
9,34,3,100,90,80,60,"-1",40
9,42,3,80,80,13,35,"-1",45
9,44,3,10,60,19,23,"1",-13
10,12,3,100,90,78,100,"-1",0
10,24,3,30,30,14,20,"-1",10
10,26,3,100,85,29,100,"-1",0
10,28,3,30,35,20,20,"-1",10
10,33,3,100,40,15,30,"-1",70
10,34,3,25,29,80,65,"1",-40
10,39,3,100,70,43,95,"-1",5
10,41,3,95,90,17,85,"-1",10
10,43,3,5,2,81,60,"1",-55
10,44,3,15,20,19,15,"1",0
10,49,3,0,10,11,0,"1",0
10,51,3,100,85,26,60,"-1",40
11,3,3,10,60,29,5,"1",5
11,4,3,40,60,78,40,"1",0
11,12,3,0,80,78,5,"1",-5
11,21,3,85,80,35,70,"-1",15
11,24,3,40,40,14,25,"-1",15
11,25,3,50,40,14,25,"-1",25
11,26,3,100,100,29,100,"-1",0
11,27,3,75,55,45,55,"-1",20
11,28,3,20,20,20,20,"0",0
11,33,3,10,40,15,15,"1",-5
11,34,3,80,80,80,60,"0",20
11,39,3,40,60,43,25,"1",15
11,42,3,75,60,13,40,"-1",35
11,44,3,5,10,19,10,"1",-5
11,47,3,10,70,20,0,"1",10
11,49,3,0,30,11,5,"1",-5
11,50,3,10,45,38,15,"1",-5
11,51,3,50,45,26,50,"-1",0
12,3,3,3,44,29,5,"1",-2
12,4,3,40,45,78,50,"1",-10
12,9,3,20,20,29,20,"1",0
12,12,3,90,75,78,80,"-1",10
12,26,3,100,66,29,100,"-1",0
12,27,3,22,30,45,20,"1",2
12,28,3,20,20,20,15,"0",5
12,31,3,40,70,19,50,"-1",-10
12,34,3,80,80,80,80,"0",0
12,37,3,55,55,30,20,"-1",35
12,40,3,5,20,21,50,"1",-45
12,41,3,30,40,17,50,"-1",-20
12,42,3,5,12,13,15,"1",-10
12,43,3,2,12,81,60,"1",-58
12,44,3,18,18,19,15,"1",3
12,48,3,100,35,18,100,"-1",0
12,49,3,80,20,11,80,"-1",0
12,50,3,5,35,38,10,"1",-5
12,51,3,10,23,26,10,"1",0
13,1,3,0,3,26,0,"1",0
13,8,3,45,25,75,70,"1",-25
13,19,3,60,65,21,20,"-1",40
13,24,3,30,30,14,10,"-1",20
13,26,3,99,67,29,30,"-1",69
13,27,3,99,88,45,98,"-1",1
13,28,3,50,51,20,20,"-1",30
13,30,3,0,38,48,20,"1",-20
13,40,3,87,78,21,30,"-1",57
13,51,3,49,23,26,50,"-1",-1
14,4,3,100,90,78,100,"-1",0
14,8,3,20,50,75,15,"1",5
14,12,3,100,70,78,100,"-1",0
14,24,3,5,5,14,5,"1",0
14,25,3,50,50,14,20,"-1",30
14,26,3,10,20,29,20,"1",-10
14,28,3,20,20,20,15,"0",5
14,30,3,50,40,48,25,"-1",25
14,31,3,100,85,19,0,"-1",100
14,36,3,80,80,26,40,"-1",40
14,37,3,75,75,30,30,"-1",45
14,39,3,90,75,43,100,"-1",-10
14,40,3,50,55,21,40,"-1",10
14,41,3,0,10,17,0,"1",0
14,42,3,5,65,13,0,"1",5
14,43,3,60,75,81,75,"1",-15
14,44,3,15,15,19,15,"1",0
14,48,3,55,40,18,40,"-1",15
14,50,3,0,25,38,0,"1",0
14,51,3,10,20,26,5,"1",5
15,3,3,0,20,29,15,"1",-15
15,4,3,100,80,78,30,"-1",70
15,9,3,10,14,29,15,"1",-5
15,10,3,20,60,56,20,"1",0
15,21,3,60,15,35,50,"-1",10
15,24,3,15,15,14,15,"-1",0
15,26,3,100,25,29,100,"-1",0
15,28,3,20,20,20,20,"0",0
15,33,3,70,70,15,60,"-1",10
15,37,3,70,70,30,30,"-1",40
15,40,3,0,25,21,0,"1",0
15,42,3,100,15,13,60,"-1",40
15,43,3,20,60,81,70,"1",-50
15,44,3,0,15,19,20,"1",-20
15,45,3,80,8,19,40,"-1",40
15,48,3,100,60,18,75,"-1",25
16,3,3,0,27,29,0,"1",0
16,6,3,0,25,29,0,"1",0
16,8,3,100,76,75,80,"-1",20
16,9,3,0,29,29,10,"1",-10
16,10,3,0,45,56,0,"1",0
16,12,3,100,90,78,100,"-1",0
16,24,3,30,30,14,14,"-1",16
16,26,3,100,70,29,100,"-1",0
16,28,3,15,15,20,15,"1",0
16,34,3,60,60,80,80,"1",-20
16,36,3,40,40,26,26,"-1",14
16,37,3,100,67,30,30,"-1",70
16,41,3,100,70,17,100,"-1",0
16,42,3,100,75,13,100,"-1",0
16,44,3,10,15,19,19,"1",-9
16,45,3,100,23,19,100,"-1",0
16,50,3,40,30,38,50,"-1",-10
17,2,3,90,48,20,80,"-1",10
17,4,3,100,100,78,100,"-1",0
17,7,3,0,47,45,0,"1",0
17,8,3,100,45,75,100,"-1",0
17,9,3,100,60,29,100,"-1",0
17,10,3,100,46,56,100,"-1",0
17,12,3,100,100,78,100,"-1",0
17,13,3,9,76,22,80,"1",-71
17,19,3,7,29,21,0,"1",7
17,24,3,8,46,14,50,"1",-42
17,26,3,100,99,29,100,"-1",0
17,27,3,50,48,45,50,"-1",0
17,28,3,40,70,20,50,"-1",-10
17,30,3,100,69,48,100,"-1",0
17,31,3,100,55,19,100,"-1",0
17,32,3,25,50,33,100,"1",-75
17,33,3,100,87,15,100,"-1",0
17,34,3,2,43,80,0,"1",2
17,37,3,5,75,30,20,"1",-15
17,38,3,100,100,71,100,"-1",0
17,40,3,99,55,21,100,"-1",-1
17,41,3,100,100,17,100,"-1",0
17,44,3,90,67,19,50,"-1",40
17,45,3,58,54,19,60,"-1",-2
17,46,3,100,88,45,100,"-1",0
17,47,3,80,32,20,50,"-1",30
17,48,3,80,87,18,100,"-1",-20
17,49,3,9,7,11,0,"1",9
17,50,3,0,7,38,0,"1",0
18,1,3,0,24,26,25,"1",-25
18,7,3,100,60,45,100,"-1",0
18,8,3,100,100,75,100,"-1",0
18,14,3,10,50,41,10,"1",0
18,20,3,100,47,40,75,"-1",25
18,21,3,100,80,35,100,"-1",0
18,24,3,45,33,14,50,"-1",-5
18,28,3,70,60,20,50,"-1",20
18,33,3,60,5,15,50,"-1",10
18,35,3,0,4,17,0,"1",0
18,37,3,50,50,30,50,"-1",0
18,39,3,0,33,43,0,"1",0
18,40,3,80,44,21,80,"-1",0
18,42,3,0,38,13,0,"1",0
18,43,3,25,43,81,70,"1",-45
18,44,3,5,20,19,20,"1",-15
19,12,3,100,70,78,70,"-1",30
19,27,3,10,20,45,50,"1",-40
19,28,3,10,10,20,50,"1",-40
19,43,3,60,50,81,40,"1",20
19,44,3,0,40,19,0,"1",0
19,49,3,10,30,11,10,"1",0
19,50,3,0,20,38,0,"1",0
19,51,3,20,20,26,20,"1",0
20,3,3,33,33,29,0,"-1",33
20,5,3,75,65,56,55,"-1",20
20,8,3,56,88,75,60,"1",-4
20,24,3,37,45,14,30,"-1",7
20,25,3,0,25,14,0,"1",0
20,28,3,88,88,20,25,"-1",63
20,30,3,0,20,48,10,"1",-10
20,33,3,33,44,15,0,"-1",33
20,34,3,67,67,80,80,"1",-13
20,38,3,100,100,71,99,"-1",1
20,39,3,78,78,43,100,"-1",-22
20,41,3,80,90,17,87,"-1",-7
20,42,3,67,67,13,20,"-1",47
20,44,3,13,13,19,33,"1",-20
20,47,3,33,45,20,10,"-1",23
20,51,3,50,78,26,20,"-1",30
21,1,3,0,36,26,0,"1",0
21,8,3,10,65,75,10,"1",0
21,12,3,40,35,78,80,"1",-40
21,14,3,15,36,41,15,"1",0
21,24,3,50,25,14,30,"-1",20
21,25,3,60,56,14,25,"-1",35
21,26,3,100,80,29,100,"-1",0
21,27,3,50,35,45,14,"-1",36
21,28,3,0,5,20,10,"1",-10
21,30,3,0,15,48,0,"1",0
21,32,3,0,37,33,0,"1",0
21,34,3,0,1,80,0,"1",0
21,37,3,75,75,30,90,"-1",-15
21,39,3,25,50,43,15,"1",10
21,40,3,75,26,21,75,"-1",0
21,41,3,0,67,17,0,"1",0
21,42,3,98,75,13,75,"-1",23
21,43,3,50,56,81,50,"1",0
21,44,3,0,60,19,0,"1",0
21,46,3,0,20,45,0,"1",0
21,47,3,0,15,20,5,"1",-5
21,50,3,0,37,38,0,"1",0
21,51,3,5,15,26,15,"1",-10
22,3,3,10,56,29,11,"1",-1
22,4,3,100,80,78,100,"-1",0
22,12,3,100,90,78,100,"-1",0
22,15,3,67,50,60,89,"-1",-22
22,21,3,100,100,35,45,"-1",55
22,24,3,15,15,14,29,"-1",-14
22,28,3,70,80,20,19,"-1",51
22,30,3,100,12,48,100,"-1",0
22,33,3,0,14,15,0,"1",0
22,34,3,60,60,80,80,"1",-20
22,39,3,10,12,43,34,"1",-24
22,41,3,100,43,17,100,"-1",0
22,42,3,100,20,13,99,"-1",1
22,44,3,98,78,19,77,"-1",21
22,45,3,100,40,19,100,"-1",0
22,47,3,0,10,20,0,"1",0
22,49,3,100,56,11,100,"-1",0
23,1,3,5,5,26,20,"1",-15
23,2,3,10,5,20,10,"1",0
23,14,3,90,60,41,60,"-1",30
23,22,3,80,80,60,40,"-1",40
23,28,3,10,10,20,20,"1",-10
23,30,3,10,20,48,10,"1",0
23,38,3,100,90,71,90,"-1",10
23,42,3,0,40,13,20,"1",-20
23,44,3,5,10,19,10,"1",-5
23,46,3,10,30,45,5,"1",5
23,47,3,5,10,20,0,"1",5
23,48,3,30,5,18,5,"-1",25
24,17,3,95,70,43,85,"-1",10
24,19,3,90,38,21,90,"-1",0
24,21,3,95,69,35,85,"-1",10
24,22,3,80,65,60,65,"-1",15
24,24,3,12,12,14,12,"1",0
24,26,3,100,86,29,100,"-1",0
24,28,3,50,55,20,50,"-1",0
24,30,3,0,24,48,5,"1",-5
24,33,3,100,30,15,100,"-1",0
24,36,3,50,26,26,50,"-1",0
24,37,3,80,38,30,85,"-1",-5
24,39,3,75,19,43,75,"-1",0
24,44,3,5,30,19,10,"1",-5
24,45,3,0,19,19,22,"1",-22
24,47,3,5,18,20,20,"1",-15
24,48,3,50,20,18,50,"-1",0
24,50,3,5,48,38,5,"1",0
24,51,3,25,28,26,26,"1",-1
25,1,3,0,5,26,0,"1",0
25,6,3,30,20,29,30,"-1",0
25,8,3,90,80,75,80,"-1",10
25,24,3,2,2,14,15,"1",-13
25,28,3,26,20,20,20,"-1",6
25,33,3,25,75,15,20,"-1",5
25,34,3,85,75,80,75,"-1",10
25,40,3,0,0,21,0,"1",0
25,41,3,100,20,17,100,"-1",0
25,42,3,50,20,13,50,"-1",0
25,43,3,10,70,81,100,"1",-90
25,44,3,30,30,19,20,"-1",10
25,47,3,0,20,20,10,"1",-10
25,50,3,0,10,38,0,"1",0
26,3,3,60,10,29,16,"-1",44
26,6,3,20,40,29,40,"1",-20
26,7,3,20,80,45,40,"1",-20
26,8,3,50,70,75,70,"1",-20
26,9,3,80,60,29,50,"-1",30
26,12,3,80,80,78,70,"-1",10
26,13,3,10,40,22,10,"1",0
26,15,3,90,90,60,80,"-1",10
26,24,3,30,30,14,60,"-1",-30
26,26,3,100,90,29,100,"-1",0
26,28,3,8,70,20,60,"1",-52
26,29,3,2,5,66,60,"1",-58
26,38,3,100,100,71,7,"-1",93
26,42,3,60,30,13,30,"-1",30
26,44,3,0,5,19,5,"1",-5
26,47,3,10,10,20,20,"1",-10
26,48,3,80,20,18,20,"-1",60
26,49,3,10,70,11,5,"1",5
26,50,3,20,50,38,35,"1",-15
26,51,3,0,50,26,30,"1",-30
27,1,3,80,80,26,60,"-1",20
27,2,3,2,20,20,20,"1",-18
27,4,3,100,50,78,100,"-1",0
27,8,3,40,80,75,25,"1",15
27,9,3,5,20,29,5,"1",0
27,12,3,80,90,78,70,"-1",10
27,24,3,10,20,14,25,"1",-15
27,26,3,100,85,29,85,"-1",15
27,28,3,30,30,20,32,"-1",-2
27,33,3,40,60,15,85,"-1",-45
27,36,3,1,25,26,70,"1",-69
27,38,3,60,60,71,87,"1",-27
27,39,3,99,50,43,85,"-1",14
27,40,3,100,50,21,99,"-1",1
27,41,3,40,60,17,20,"-1",20
27,44,3,1,20,19,10,"1",-9
27,47,3,99,40,20,50,"-1",49
27,49,3,5,10,11,5,"1",0
27,50,3,20,10,38,20,"1",0
28,4,3,100,80,78,95,"-1",5
28,6,3,3,10,29,25,"1",-22
28,7,3,100,15,45,95,"-1",5
28,8,3,89,89,75,98,"-1",-9
28,10,3,85,80,56,95,"-1",-10
28,12,3,100,89,78,95,"-1",5
28,24,3,2,8,14,12,"1",-10
28,25,3,85,75,14,85,"-1",0
28,26,3,100,72,29,95,"-1",5
28,28,3,15,15,20,20,"1",-5
28,29,3,94,85,66,90,"-1",4
28,30,3,55,45,48,75,"-1",-20
28,31,3,91,75,19,80,"-1",11
28,33,3,25,35,15,80,"-1",-55
28,34,3,75,75,80,80,"1",-5
28,36,3,78,78,26,50,"-1",28
28,37,3,70,60,30,35,"-1",35
28,39,3,2,3,43,50,"1",-48
28,40,3,5,20,21,25,"1",-20
28,41,3,95,45,17,85,"-1",10
28,42,3,80,15,13,80,"-1",0
28,43,3,20,52,81,80,"1",-60
28,44,3,2,2,19,20,"1",-18
28,46,3,0,60,45,0,"1",0
28,47,3,100,20,20,100,"-1",0
28,48,3,100,5,18,100,"-1",0
28,49,3,60,8,11,50,"-1",10
28,50,3,0,40,38,0,"1",0
29,12,3,10,80,78,20,"1",-10
29,15,3,80,40,60,40,"-1",40
29,17,3,40,40,43,40,"1",0
29,21,3,100,90,35,70,"-1",30
29,24,3,10,10,14,20,"1",-10
29,25,3,60,40,14,10,"-1",50
29,27,3,1,1,45,80,"1",-79
29,28,3,50,50,20,10,"-1",40
29,30,3,7,10,48,5,"1",2
29,34,3,10,10,80,10,"1",0
29,40,3,80,90,21,50,"-1",30
29,44,3,100,60,19,90,"-1",10
29,49,3,10,30,11,10,"1",0
29,51,3,30,30,26,20,"-1",10
30,8,3,50,60,75,75,"1",-25
30,21,3,40,50,35,50,"-1",-10
30,24,3,55,45,14,5,"-1",50
30,25,3,20,29,14,10,"-1",10
30,27,3,25,25,45,75,"1",-50
30,28,3,30,30,20,15,"-1",15
30,30,3,15,20,48,20,"1",-5
30,31,3,10,40,19,45,"1",-35
30,33,3,40,50,15,25,"-1",15
30,34,3,60,50,80,75,"1",-15
30,35,3,25,35,17,10,"-1",15
30,41,3,60,70,17,20,"-1",40
30,42,3,80,70,13,30,"-1",50
30,43,3,50,30,81,20,"1",30
30,44,3,5,10,19,5,"1",0
30,49,3,10,15,11,10,"1",0
31,1,3,19,12,26,60,"1",-41
31,4,3,70,80,78,95,"1",-25
31,8,3,20,30,75,80,"1",-60
31,12,3,98,91,78,88,"-1",10
31,16,3,78,22,26,70,"-1",8
31,21,3,15,15,35,30,"1",-15
31,24,3,1,5,14,1,"1",0
31,25,3,98,70,14,97,"-1",1
31,26,3,99,92,29,90,"-1",9
31,28,3,40,30,20,30,"-1",10
31,29,3,80,70,66,80,"-1",0
31,34,3,80,71,80,90,"0",-10
31,36,3,60,40,26,50,"-1",10
31,38,3,99,94,71,87,"-1",12
31,39,3,13,30,43,5,"1",8
31,42,3,33,48,13,11,"-1",22
31,44,3,50,46,19,40,"-1",10
31,45,3,31,33,19,18,"-1",13
31,48,3,88,37,18,80,"-1",8
31,49,3,1,18,11,20,"1",-19
31,51,3,35,35,26,30,"-1",5
32,1,3,2,2,26,2,"1",0
32,7,3,0,76,45,1,"1",-1
32,8,3,80,40,75,80,"-1",0
32,12,3,0,76,78,10,"1",-10
32,17,3,50,50,43,67,"-1",-17
32,24,3,5,5,14,12,"1",-7
32,26,3,100,65,29,100,"-1",0
32,27,3,50,24,45,45,"-1",5
32,28,3,20,20,20,20,"0",0
32,31,3,78,56,19,3,"-1",75
32,33,3,23,43,15,30,"-1",-7
32,34,3,23,43,80,15,"1",8
32,39,3,0,10,43,0,"1",0
32,41,3,50,12,17,43,"-1",7
32,42,3,80,64,13,80,"-1",0
32,43,3,10,23,81,80,"1",-70
32,44,3,0,10,19,19,"1",-19
32,50,3,65,56,38,65,"-1",0
33,1,3,20,10,26,20,"1",0
33,4,3,95,90,78,90,"-1",5
33,13,3,1,20,22,1,"1",0
33,20,3,80,50,40,80,"-1",0
33,24,3,40,35,14,10,"-1",30
33,26,3,100,100,29,80,"-1",20
33,27,3,80,70,45,80,"-1",0
33,28,3,30,30,20,20,"-1",10
33,30,3,5,15,48,5,"1",0
33,33,3,99,60,15,99,"-1",0
33,34,3,60,60,80,80,"1",-20
33,35,3,5,40,17,5,"1",0
33,37,3,80,70,30,80,"-1",0
33,40,3,99,80,21,99,"-1",0
33,42,3,5,30,13,10,"1",-5
33,43,3,80,75,81,80,"1",0
33,44,3,20,20,19,20,"-1",0
33,48,3,80,40,18,80,"-1",0
33,50,3,5,30,38,5,"1",0
33,51,3,5,25,26,5,"1",0
34,12,3,100,85,78,100,"-1",0
34,24,3,20,20,14,55,"-1",-35
34,27,3,55,80,45,20,"-1",35
34,28,3,70,70,20,30,"-1",40
34,30,3,5,45,48,5,"1",0
34,33,3,5,10,15,5,"1",0
34,34,3,1,20,80,5,"1",-4
34,35,3,0,55,17,0,"1",0
34,38,3,100,100,71,100,"-1",0
34,40,3,0,10,21,0,"1",0
34,41,3,0,65,17,0,"1",0
34,43,3,25,55,81,45,"1",-20
34,44,3,0,10,19,0,"1",0
34,49,3,5,25,11,10,"1",-5
34,51,3,0,85,26,0,"1",0
35,8,3,99,80,75,80,"-1",19
35,24,3,10,10,14,14,"1",-4
35,26,3,99,60,29,99,"-1",0
35,28,3,14,14,20,14,"1",0
35,33,3,99,30,15,1,"-1",98
35,34,3,1,20,80,20,"1",-19
35,41,3,15,60,17,10,"1",5
35,43,3,90,70,81,1,"-1",89
35,44,3,14,14,19,14,"1",0
35,47,3,1,40,20,1,"1",0
36,3,3,0,19,29,0,"1",0
36,7,3,0,25,45,10,"1",-10
36,8,3,100,100,75,70,"-1",30
36,11,3,30,40,31,20,"1",10
36,13,3,10,0,22,0,"1",10
36,19,3,0,20,21,10,"1",-10
36,24,3,50,50,14,10,"-1",40
36,25,3,5,10,14,10,"1",-5
36,26,3,100,80,29,100,"-1",0
36,27,3,40,60,45,40,"1",0
36,28,3,10,10,20,15,"1",-5
36,31,3,10,50,19,20,"1",-10
36,33,3,75,80,15,30,"-1",45
36,34,3,45,45,80,30,"1",15
36,35,3,40,40,17,40,"-1",0
36,37,3,90,25,30,90,"-1",0
36,39,3,50,89,43,29,"-1",21
36,40,3,10,20,21,10,"1",0
36,41,3,20,20,17,25,"-1",-5
36,42,3,30,40,13,15,"-1",15
36,43,3,0,30,81,100,"1",-100
36,44,3,11,11,19,15,"1",-4
36,46,3,30,75,45,30,"1",0
36,48,3,70,30,18,30,"-1",40
36,49,3,0,30,11,0,"1",0
36,50,3,0,18,38,0,"1",0
36,51,3,0,45,26,0,"1",0
37,1,3,10,10,26,20,"1",-10
37,4,3,0,25,78,0,"1",0
37,6,3,20,20,29,10,"1",10
37,8,3,10,25,75,10,"1",0
37,10,3,5,30,56,10,"1",-5
37,14,3,75,75,41,50,"-1",25
37,21,3,40,40,35,50,"-1",-10
37,24,3,2,2,14,20,"1",-18
37,25,3,70,50,14,50,"-1",20
37,26,3,10,80,29,10,"1",0
37,28,3,30,30,20,20,"-1",10
37,30,3,50,20,48,50,"-1",0
37,31,3,100,15,19,0,"-1",100
37,32,3,100,20,33,100,"-1",0
37,33,3,100,80,15,100,"-1",0
37,34,3,0,15,80,0,"1",0
37,38,3,100,100,71,50,"-1",50
37,40,3,0,15,21,0,"1",0
37,41,3,0,40,17,0,"1",0
37,42,3,0,80,13,0,"1",0
37,43,3,0,10,81,100,"1",-100
37,44,3,10,10,19,20,"1",-10
37,47,3,10,10,20,10,"1",0
37,48,3,70,70,18,40,"-1",30
37,49,3,80,20,11,80,"-1",0
37,50,3,5,5,38,15,"1",-10
37,51,3,50,50,26,30,"-1",20
38,2,3,10,20,20,10,"1",0
38,3,3,10,43,29,10,"1",0
38,4,3,50,20,78,58,"1",-8
38,5,3,25,20,56,20,"1",5
38,8,3,10,16,75,25,"1",-15
38,9,3,10,23,29,10,"1",0
38,10,3,12,27,56,25,"1",-13
38,12,3,75,75,78,78,"1",-3
38,13,3,0,10,22,0,"1",0
38,14,3,60,57,41,50,"-1",10
38,16,3,20,30,26,20,"1",0
38,17,3,25,60,43,27,"1",-2
38,19,3,15,20,21,10,"1",5
38,21,3,50,26,35,56,"-1",-6
38,24,3,1,1,14,23,"1",-22
38,26,3,100,80,29,100,"-1",0
38,27,3,15,6,45,45,"1",-30
38,28,3,12,23,20,56,"1",-44
38,31,3,70,2,19,10,"-1",60
38,32,3,98,50,33,100,"-1",-2
38,33,3,40,10,15,67,"-1",-27
38,34,3,5,5,80,76,"1",-71
38,35,3,75,56,17,20,"-1",55
38,36,3,50,35,26,30,"-1",20
38,37,3,80,80,30,20,"-1",60
38,38,3,100,80,71,100,"-1",0
38,39,3,75,34,43,23,"-1",52
38,41,3,56,78,17,23,"-1",33
38,42,3,27,30,13,56,"-1",-29
38,43,3,65,59,81,26,"1",39
38,44,3,25,50,19,10,"-1",15
38,47,3,100,10,20,100,"-1",0
38,48,3,45,25,18,40,"-1",5
38,49,3,0,10,11,1,"1",-1
38,50,3,0,20,38,0,"1",0
38,51,3,0,3,26,0,"1",0
39,4,3,100,70,78,100,"-1",0
39,8,3,50,60,75,90,"1",-40
39,12,3,90,90,78,100,"-1",-10
39,24,3,25,25,14,19,"-1",6
39,26,3,100,90,29,100,"-1",0
39,28,3,5,5,20,25,"1",-20
39,33,3,80,70,15,90,"-1",-10
39,37,3,90,90,30,90,"-1",0
39,42,3,50,75,13,50,"-1",0
39,44,3,25,25,19,25,"-1",0
39,47,3,50,60,20,50,"-1",0
39,48,3,90,70,18,50,"-1",40
39,49,3,15,10,11,15,"-1",0
39,50,3,0,15,38,0,"1",0
40,4,3,90,95,78,89,"-1",1
40,6,3,25,35,29,21,"1",4
40,7,3,5,35,45,29,"1",-24
40,8,3,60,70,75,69,"1",-9
40,24,3,35,35,14,15,"-1",20
40,25,3,9,26,14,29,"1",-20
40,26,3,89,85,29,78,"-1",11
40,28,3,35,40,20,24,"-1",11
40,31,3,99,50,19,23,"-1",76
40,33,3,25,18,15,12,"-1",13
40,34,3,70,67,80,75,"1",-5
40,35,3,45,48,17,45,"-1",0
40,41,3,45,25,17,13,"-1",32
40,42,3,55,60,13,24,"-1",31
40,43,3,45,30,81,49,"1",-4
40,44,3,5,7,19,12,"1",-7
40,47,3,15,25,20,23,"1",-8
40,49,3,5,30,11,9,"1",-4
40,50,3,0,18,38,0,"1",0
40,51,3,0,23,26,23,"1",-23
41,1,3,21,20,26,20,"1",1
41,4,3,80,40,78,70,"-1",10
41,5,3,40,30,56,50,"1",-10
41,6,3,25,30,29,30,"1",-5
41,8,3,80,70,75,80,"-1",0
41,9,3,20,25,29,30,"1",-10
41,24,3,35,20,14,10,"-1",25
41,25,3,20,35,14,10,"-1",10
41,26,3,80,75,29,50,"-1",30
41,28,3,12,10,20,10,"1",2
41,32,3,30,30,33,30,"1",0
41,33,3,65,50,15,50,"-1",15
41,40,3,60,70,21,60,"-1",0
41,41,3,30,40,17,10,"-1",20
41,42,3,60,45,13,30,"-1",30
41,43,3,19,25,81,30,"1",-11
41,44,3,10,20,19,12,"1",-2
41,45,3,70,50,19,30,"-1",40
41,47,3,25,20,20,15,"-1",10
41,48,3,44,50,18,20,"-1",24
41,49,3,10,20,11,10,"1",0
41,50,3,35,40,38,38,"1",-3
42,1,3,5,15,26,10,"1",-5
42,10,3,23,72,56,40,"1",-17
42,12,3,40,26,78,70,"1",-30
42,24,3,8,8,14,15,"1",-7
42,25,3,60,23,14,60,"-1",0
42,26,3,95,62,29,80,"-1",15
42,28,3,25,32,20,10,"-1",15
42,32,3,15,22,33,15,"1",0
42,33,3,75,70,15,75,"-1",0
42,34,3,5,15,80,20,"1",-15
42,37,3,80,56,30,80,"-1",0
42,42,3,90,45,13,95,"-1",-5
42,43,3,68,36,81,15,"1",53
42,44,3,5,17,19,5,"1",0
42,48,3,65,35,18,65,"-1",0
42,50,3,0,3,38,0,"1",0
43,2,3,22,23,20,20,"-1",2
43,6,3,0,22,29,0,"1",0
43,11,3,15,24,31,2,"1",13
43,13,3,45,0,22,0,"-1",45
43,14,3,54,43,41,15,"-1",39
43,15,3,50,33,60,100,"1",-50
43,16,3,25,99,26,100,"1",-75
43,19,3,0,43,21,0,"1",0
43,24,3,1,12,14,12,"1",-11
43,25,3,0,44,14,0,"1",0
43,30,3,5,55,48,0,"1",5
43,32,3,10,49,33,10,"1",0
43,35,3,0,5,17,0,"1",0
43,37,3,20,44,30,10,"1",10
43,44,3,5,5,19,25,"1",-20
43,47,3,25,43,20,20,"-1",5
43,48,3,0,1,18,23,"1",-23
43,50,3,100,45,38,100,"-1",0
44,8,3,99,99,75,60,"-1",39
44,10,3,75,75,56,50,"-1",25
44,12,3,95,95,78,90,"-1",5
44,24,3,5,5,14,10,"1",-5
44,28,3,20,20,20,20,"0",0
44,30,3,10,25,48,15,"1",-5
44,34,3,5,10,80,20,"1",-15
44,39,3,99,60,43,90,"-1",9
44,41,3,80,90,17,20,"-1",60
44,42,3,2,10,13,10,"1",-8
44,43,3,25,25,81,75,"1",-50
44,44,3,10,20,19,20,"1",-10
44,48,3,100,90,18,100,"-1",0
45,3,3,0,35,29,0,"1",0
45,5,3,60,70,56,20,"-1",40
45,6,3,15,20,29,15,"1",0
45,15,3,30,30,60,30,"1",0
45,24,3,6,20,14,50,"1",-44
45,26,3,100,99,29,100,"-1",0
45,27,3,5,35,45,10,"1",-5
45,28,3,60,50,20,40,"-1",20
45,30,3,10,30,48,10,"1",0
45,31,3,68,57,19,30,"-1",38
45,32,3,100,43,33,15,"-1",85
45,33,3,45,55,15,90,"-1",-45
45,34,3,0,10,80,10,"1",-10
45,35,3,70,47,17,30,"-1",40
45,36,3,0,12,26,0,"1",0
45,37,3,85,85,30,80,"-1",5
45,39,3,10,40,43,30,"1",-20
45,41,3,100,80,17,100,"-1",0
45,42,3,10,20,13,10,"1",0
45,43,3,18,5,81,100,"1",-82
45,44,3,5,11,19,10,"1",-5
45,47,3,80,40,20,40,"-1",40
45,50,3,0,20,38,0,"1",0
46,12,3,70,70,78,20,"1",50
46,28,3,40,40,20,40,"-1",0
46,30,3,10,33,48,10,"1",0
46,42,3,20,40,13,20,"-1",0
46,44,3,20,20,19,20,"-1",0
47,12,3,100,100,78,100,"-1",0
47,19,3,0,33,21,10,"1",-10
47,24,3,13,10,14,25,"1",-12
47,28,3,45,45,20,13,"-1",32
47,29,3,10,10,66,66,"1",-56
47,31,3,0,10,19,100,"1",-100
47,32,3,0,11,33,0,"1",0
47,33,3,0,12,15,0,"1",0
47,39,3,80,65,43,50,"-1",30
47,41,3,100,2,17,100,"-1",0
47,42,3,10,10,13,10,"1",0
47,44,3,25,15,19,25,"-1",0
47,51,3,0,25,26,0,"1",0
48,1,3,10,20,26,10,"1",0
48,2,3,10,20,20,30,"1",-20
48,6,3,20,20,29,50,"1",-30
48,7,3,10,50,45,20,"1",-10
48,9,3,40,20,29,50,"-1",-10
48,13,3,35,0,22,0,"-1",35
48,16,3,40,10,26,10,"-1",30
48,27,3,70,20,45,100,"-1",-30
48,28,3,50,40,20,20,"-1",30
48,29,3,99,99,66,100,"-1",-1
48,31,3,50,20,19,80,"-1",-30
48,32,3,100,100,33,20,"-1",80
48,33,3,0,20,15,0,"1",0
48,34,3,20,20,80,80,"1",-60
48,35,3,0,10,17,0,"1",0
48,37,3,40,40,30,30,"-1",10
48,38,3,100,100,71,100,"-1",0
48,39,3,0,30,43,0,"1",0
48,40,3,30,50,21,50,"-1",-20
48,41,3,100,50,17,100,"-1",0
48,42,3,50,35,13,20,"-1",30
48,43,3,50,40,81,50,"1",0
48,44,3,10,30,19,30,"1",-20
48,45,3,70,50,19,50,"-1",20
48,49,3,10,30,11,20,"1",-10
48,51,3,30,50,26,80,"-1",-50
49,10,3,5,50,56,10,"1",-5
49,12,3,20,70,78,20,"1",0
49,13,3,10,1,22,2,"1",8
49,15,3,99,80,60,60,"-1",39
49,16,3,10,10,26,10,"1",0
49,24,3,5,5,14,12,"1",-7
49,26,3,99,50,29,99,"-1",0
49,28,3,20,20,20,20,"0",0
49,32,3,95,60,33,90,"-1",5
49,33,3,99,75,15,99,"-1",0
49,34,3,2,30,80,5,"1",-3
49,36,3,30,30,26,20,"-1",10
49,37,3,99,95,30,80,"-1",19
49,38,3,99,95,71,78,"-1",21
49,42,3,1,17,13,1,"1",0
49,44,3,5,25,19,19,"1",-14
49,47,3,15,40,20,25,"1",-10
50,3,3,0,25,29,0,"1",0
50,12,3,78,66,78,99,"0",-21
50,24,3,50,50,14,12,"-1",38
50,27,3,75,55,45,75,"-1",0
50,28,3,20,15,20,14,"0",6
50,33,3,10,75,15,70,"1",-60
50,34,3,50,40,80,60,"1",-10
50,39,3,15,25,43,25,"1",-10
50,40,3,45,50,21,75,"-1",-30
50,42,3,0,25,13,0,"1",0
50,44,3,20,10,19,15,"-1",5
50,46,3,0,56,45,0,"1",0
50,47,3,0,20,20,20,"1",-20
50,49,3,20,15,11,10,"-1",10
50,50,3,0,35,38,0,"1",0
50,51,3,50,25,26,50,"-1",0
51,24,3,5,12,14,2,"1",3
51,25,3,66,71,14,75,"-1",-9
51,27,3,22,15,45,64,"1",-42
51,28,3,45,35,20,25,"-1",20
51,30,3,5,8,48,5,"1",0
51,33,3,10,41,15,15,"1",-5
51,34,3,5,1,80,80,"1",-75
51,37,3,15,35,30,33,"1",-18
51,40,3,87,65,21,65,"-1",22
51,41,3,100,75,17,98,"-1",2
51,44,3,21,25,19,55,"-1",-34
51,49,3,5,35,11,15,"1",-10
51,51,3,50,41,26,45,"-1",5
52,6,3,0,5,29,0,"1",0
52,24,3,2,2,14,2,"1",0
52,28,3,80,80,20,2,"-1",78
52,30,3,0,12,48,0,"1",0
52,33,3,0,20,15,0,"1",0
52,44,3,2,2,19,2,"1",0
52,46,3,0,77,45,0,"1",0
52,47,3,0,3,20,0,"1",0
52,51,3,0,70,26,0,"1",0
53,3,3,0,40,29,10,"1",-10
53,26,3,100,80,29,80,"-1",20
53,33,3,10,20,15,20,"1",-10
53,37,3,70,70,30,40,"-1",30
53,43,3,0,20,81,70,"1",-70
54,24,3,87,76,14,50,"-1",37
54,28,3,33,17,20,50,"-1",-17
54,30,3,0,16,48,21,"1",-21
54,33,3,5,66,15,10,"1",-5
54,34,3,0,13,80,80,"1",-80
54,41,3,33,28,17,66,"-1",-33
54,42,3,100,76,13,30,"-1",70
54,44,3,98,33,19,99,"-1",-1
54,45,3,20,33,19,25,"-1",-5
54,47,3,68,70,20,68,"-1",0
54,50,3,3,46,38,22,"1",-19
54,51,3,25,33,26,40,"1",-15
55,8,3,20,40,75,50,"1",-30
55,12,3,100,50,78,100,"-1",0
55,21,3,30,30,35,20,"1",10
55,24,3,20,20,14,14,"-1",6
55,27,3,2,15,45,50,"1",-48
55,28,3,20,20,20,25,"0",-5
55,33,3,100,40,15,100,"-1",0
55,34,3,100,80,80,100,"-1",0
55,40,3,90,50,21,100,"-1",-10
55,41,3,100,30,17,80,"-1",20
55,42,3,0,60,13,50,"1",-50
55,43,3,90,80,81,70,"-1",20
55,49,3,0,5,11,0,"1",0
55,51,3,20,25,26,25,"1",-5
56,1,3,10,10,26,20,"1",-10
56,4,3,50,50,78,60,"1",-10
56,14,3,25,25,41,30,"1",-5
56,15,3,80,80,60,50,"-1",30
56,16,3,50,50,26,60,"-1",-10
56,21,3,60,60,35,60,"-1",0
56,24,3,10,10,14,10,"1",0
56,26,3,100,80,29,100,"-1",0
56,27,3,70,60,45,50,"-1",20
56,28,3,30,30,20,20,"-1",10
56,31,3,50,50,19,20,"-1",30
56,33,3,50,20,15,30,"-1",20
56,39,3,50,40,43,50,"-1",0
56,40,3,0,0,21,0,"1",0
56,41,3,50,50,17,60,"-1",-10
56,42,3,10,20,13,20,"1",-10
56,44,3,15,15,19,15,"1",0
56,47,3,0,9,20,20,"1",-20
56,48,3,15,10,18,40,"1",-25
56,49,3,0,23,11,10,"1",-10
56,50,3,20,20,38,25,"1",-5
57,8,3,25,75,75,50,"1",-25
57,12,3,75,75,78,75,"1",0
57,21,3,85,85,35,50,"-1",35
57,24,3,25,5,14,25,"-1",0
57,25,3,95,20,14,95,"-1",0
57,26,3,100,80,29,100,"-1",0
57,28,3,15,15,20,20,"1",-5
57,30,3,1,20,48,5,"1",-4
57,33,3,99,17,15,100,"-1",-1
57,34,3,75,75,80,80,"1",-5
57,36,3,50,50,26,50,"-1",0
57,38,3,100,20,71,95,"-1",5
57,39,3,0,45,43,0,"1",0
57,40,3,99,80,21,100,"-1",-1
57,41,3,75,50,17,80,"-1",-5
57,42,3,100,5,13,100,"-1",0
57,43,3,50,80,81,50,"1",0
57,44,3,10,10,19,10,"1",0
57,47,3,10,30,20,10,"1",0
57,48,3,100,20,18,100,"-1",0
57,51,3,100,40,26,100,"-1",0
58,1,3,0,20,26,0,"1",0
58,2,3,0,0,20,0,"1",0
58,4,3,100,90,78,100,"-1",0
58,12,3,100,100,78,100,"-1",0
58,23,3,50,65,71,20,"1",30
58,24,3,10,10,14,14,"1",-4
58,26,3,100,80,29,100,"-1",0
58,27,3,80,80,45,0,"-1",80
58,28,3,28,28,20,8,"-1",20
58,33,3,10,56,15,0,"1",10
58,34,3,10,40,80,80,"1",-70
58,36,3,0,78,26,0,"1",0
58,38,3,100,100,71,80,"-1",20
58,41,3,56,50,17,50,"-1",6
58,42,3,40,40,13,0,"-1",40
58,43,3,40,23,81,80,"1",-40
58,44,3,0,50,19,0,"1",0
58,45,3,0,30,19,0,"1",0
58,48,3,80,70,18,80,"-1",0
58,51,3,50,50,26,50,"-1",0
59,7,3,70,35,45,100,"-1",-30
59,8,3,100,70,75,100,"-1",0
59,9,3,10,20,29,20,"1",-10
59,10,3,60,34,56,75,"-1",-15
59,16,3,10,8,26,25,"1",-15
59,18,3,38,25,82,80,"1",-42
59,24,3,30,50,14,11,"-1",19
59,25,3,0,12,14,0,"1",0
59,26,3,100,60,29,100,"-1",0
59,28,3,15,15,20,24,"1",-9
59,29,3,40,35,66,70,"1",-30
59,30,3,0,21,48,0,"1",0
59,33,3,100,70,15,100,"-1",0
59,34,3,60,45,80,60,"1",0
59,37,3,20,30,30,43,"1",-23
59,38,3,90,68,71,70,"-1",20
59,41,3,100,15,17,100,"-1",0
59,42,3,0,65,13,0,"1",0
59,43,3,10,50,81,100,"1",-90
59,44,3,50,40,19,60,"-1",-10
59,45,3,10,5,19,10,"1",0
59,47,3,0,20,20,0,"1",0
59,50,3,100,35,38,10,"-1",90
59,51,3,0,35,26,100,"1",-100
60,3,3,0,40,29,0,"1",0
60,5,3,20,50,56,20,"1",0
60,12,3,0,50,78,0,"1",0
60,13,3,20,0,22,0,"1",20
60,20,3,100,25,40,100,"-1",0
60,22,3,60,60,60,60,"0",0
60,24,3,3,3,14,19,"1",-16
60,26,3,100,80,29,100,"-1",0
60,28,3,18,18,20,19,"1",-1
60,29,3,50,50,66,50,"1",0
60,31,3,50,80,19,40,"-1",10
60,33,3,0,5,15,0,"1",0
60,34,3,0,5,80,0,"1",0
60,36,3,50,70,26,50,"-1",0
60,38,3,100,100,71,100,"-1",0
60,40,3,40,60,21,60,"-1",-20
60,42,3,90,60,13,80,"-1",10
60,44,3,14,14,19,18,"1",-4
60,49,3,0,20,11,0,"1",0
60,50,3,0,10,38,0,"1",0
60,51,3,70,70,26,30,"-1",40
61,6,3,15,15,29,20,"1",-5
61,8,3,100,93,75,95,"-1",5
61,12,3,100,82,78,100,"-1",0
61,21,3,100,29,35,100,"-1",0
61,24,3,8,8,14,8,"1",0
61,25,3,10,12,14,15,"1",-5
61,26,3,100,98,29,100,"-1",0
61,27,3,60,83,45,25,"-1",35
61,28,3,50,50,20,15,"-1",35
61,29,3,12,12,66,15,"1",-3
61,30,3,0,17,48,15,"1",-15
61,33,3,0,20,15,0,"1",0
61,34,3,52,50,80,60,"1",-8
61,37,3,80,45,30,80,"-1",0
61,38,3,71,71,71,100,"0",-29
61,42,3,10,13,13,12,"1",-2
61,43,3,100,42,81,12,"-1",88
61,44,3,0,17,19,11,"1",-11
61,46,3,0,18,45,0,"1",0
61,48,3,0,23,18,0,"1",0
61,49,3,0,10,11,0,"1",0
62,2,3,40,20,20,20,"-1",20
62,3,3,0,25,29,0,"1",0
62,9,3,10,20,29,10,"1",0
62,12,3,0,25,78,10,"1",-10
62,16,3,20,50,26,60,"1",-40
62,24,3,0,25,14,10,"1",-10
62,28,3,10,15,20,13,"1",-3
62,30,3,0,25,48,0,"1",0
62,33,3,50,25,15,10,"-1",40
62,36,3,0,10,26,20,"1",-20
62,40,3,10,10,21,0,"1",10
62,42,3,0,70,13,0,"1",0
62,44,3,0,10,19,20,"1",-20
62,48,3,100,15,18,75,"-1",25
62,49,3,100,25,11,100,"-1",0
62,50,3,0,5,38,0,"1",0
62,51,3,0,25,26,10,"1",-10
63,2,3,80,40,20,80,"-1",0
63,3,3,5,25,29,15,"1",-10
63,6,3,0,40,29,0,"1",0
63,8,3,5,10,75,5,"1",0
63,9,3,5,20,29,5,"1",0
63,12,3,0,100,78,0,"1",0
63,14,3,0,40,41,0,"1",0
63,15,3,0,10,60,0,"1",0
63,16,3,0,15,26,0,"1",0
63,17,3,0,15,43,0,"1",0
63,18,3,0,20,82,5,"1",-5
63,21,3,0,2,35,0,"1",0
63,22,3,70,80,60,60,"-1",10
63,24,3,15,15,14,15,"-1",0
63,26,3,50,70,29,70,"-1",-20
63,27,3,30,35,45,50,"1",-20
63,28,3,15,15,20,15,"1",0
63,29,3,80,80,66,80,"-1",0
63,31,3,100,30,19,5,"-1",95
63,32,3,100,30,33,5,"-1",95
63,33,3,5,10,15,5,"1",0
63,34,3,0,10,80,10,"1",-10
63,36,3,10,15,26,10,"1",0
63,42,3,0,50,13,5,"1",-5
63,46,3,15,25,45,10,"1",5
63,47,3,5,40,20,10,"1",-5
63,48,3,100,50,18,80,"-1",20
63,50,3,5,70,38,20,"1",-15
64,1,3,10,10,26,40,"1",-30
64,4,3,65,65,78,78,"1",-13
64,6,3,50,80,29,40,"-1",10
64,11,3,5,14,31,5,"1",0
64,12,3,78,78,78,90,"0",-12
64,13,3,5,20,22,4,"1",1
64,15,3,29,29,60,45,"1",-16
64,19,3,12,29,21,5,"1",7
64,20,3,5,29,40,10,"1",-5
64,24,3,10,10,14,30,"1",-20
64,25,3,0,29,14,1,"1",-1
64,28,3,20,20,20,30,"0",-10
64,30,3,0,15,48,0,"1",0
64,31,3,70,70,19,5,"-1",65
64,33,3,1,29,15,70,"1",-69
64,34,3,60,60,80,60,"1",0
64,39,3,1,70,43,6,"1",-5
64,40,3,5,15,21,1,"1",4
64,42,3,5,45,13,5,"1",0
64,43,3,33,33,81,20,"1",13
64,44,3,30,50,19,45,"-1",-15
64,47,3,10,29,20,5,"1",5
64,48,3,10,41,18,5,"1",5
64,51,3,70,70,26,34,"-1",36
65,4,3,100,76,78,100,"-1",0
65,12,3,65,95,78,45,"1",20
65,24,3,30,15,14,25,"-1",5
65,26,3,100,95,29,100,"-1",0
65,28,3,45,45,20,24,"-1",21
65,30,3,100,15,48,80,"-1",20
65,33,3,100,70,15,80,"-1",20
65,36,3,30,20,26,45,"-1",-15
65,37,3,65,45,30,12,"-1",53
65,41,3,75,65,17,50,"-1",25
65,42,3,1,15,13,0,"1",1
65,44,3,1,5,19,23,"1",-22
66,1,3,50,20,26,50,"-1",0
66,3,3,12,20,29,10,"1",2
66,4,3,99,80,78,99,"-1",0
66,7,3,0,35,45,0,"1",0
66,24,3,10,10,14,15,"1",-5
66,26,3,99,90,29,99,"-1",0
66,27,3,99,75,45,85,"-1",14
66,28,3,26,30,20,25,"-1",1
66,30,3,99,50,48,99,"-1",0
66,31,3,99,50,19,99,"-1",0
66,33,3,21,12,15,50,"-1",-29
66,34,3,10,10,80,20,"1",-10
66,37,3,50,50,30,50,"-1",0
66,38,3,99,90,71,99,"-1",0
66,40,3,99,80,21,99,"-1",0
66,41,3,5,69,17,25,"1",-20
66,42,3,1,10,13,5,"1",-4
66,44,3,50,65,19,50,"-1",0
66,46,3,0,26,45,1,"1",-1
66,47,3,0,10,20,10,"1",-10
66,48,3,10,15,18,10,"1",0
66,50,3,50,50,38,25,"-1",25
66,51,3,65,60,26,50,"-1",15
67,24,3,20,20,14,40,"-1",-20
67,25,3,0,30,14,0,"1",0
67,27,3,80,70,45,70,"-1",10
67,28,3,30,30,20,30,"-1",0
67,30,3,0,40,48,0,"1",0
67,33,3,40,30,15,10,"-1",30
67,34,3,70,60,80,60,"1",10
67,37,3,30,40,30,30,"0",0
67,38,3,80,80,71,80,"-1",0
67,41,3,100,70,17,80,"-1",20
67,51,3,40,50,26,50,"-1",-10
68,3,3,10,30,29,0,"1",10
68,13,3,0,40,22,0,"1",0
68,24,3,60,50,14,30,"-1",30
68,26,3,100,95,29,100,"-1",0
68,28,3,50,50,20,30,"-1",20
68,31,3,0,60,19,80,"1",-80
68,33,3,100,55,15,100,"-1",0
68,34,3,0,10,80,0,"1",0
68,37,3,70,80,30,40,"-1",30
68,41,3,0,50,17,0,"1",0
68,42,3,60,80,13,60,"-1",0
68,43,3,10,10,81,60,"1",-50
68,44,3,0,45,19,20,"1",-20
68,50,3,0,45,38,0,"1",0
69,8,3,100,100,75,100,"-1",0
69,26,3,100,80,29,100,"-1",0
69,28,3,45,45,20,30,"-1",15
69,30,3,2,4,48,10,"1",-8
69,31,3,0,20,19,0,"1",0
69,33,3,100,70,15,0,"-1",100
69,34,3,100,100,80,50,"-1",50
69,36,3,90,90,26,50,"-1",40
69,40,3,0,8,21,0,"1",0
69,41,3,0,50,17,0,"1",0
69,42,3,0,50,13,0,"1",0
69,44,3,0,30,19,0,"1",0
69,47,3,100,5,20,100,"-1",0
69,48,3,100,20,18,100,"-1",0
69,49,3,0,20,11,0,"1",0
69,50,3,10,25,38,10,"1",0
70,3,3,10,30,29,5,"1",5
70,4,3,95,90,78,90,"-1",5
70,6,3,25,10,29,20,"1",5
70,10,3,25,20,56,10,"1",15
70,11,3,5,10,31,10,"1",-5
70,12,3,10,30,78,10,"1",0
70,16,3,10,15,26,15,"1",-5
70,21,3,50,70,35,65,"-1",-15
70,24,3,5,5,14,10,"1",-5
70,25,3,95,50,14,90,"-1",5
70,28,3,25,25,20,10,"-1",15
70,29,3,5,20,66,10,"1",-5
70,30,3,10,20,48,10,"1",0
70,31,3,99,50,19,0,"-1",99
70,32,3,100,50,33,100,"-1",0
70,33,3,95,55,15,95,"-1",0
70,34,3,0,30,80,0,"1",0
70,36,3,10,85,26,10,"1",0
70,37,3,15,70,30,15,"1",0
70,39,3,0,30,43,0,"1",0
70,40,3,85,50,21,80,"-1",5
70,41,3,0,50,17,0,"1",0
70,42,3,5,60,13,0,"1",5
70,43,3,95,30,81,5,"-1",90
70,44,3,5,10,19,10,"1",-5
70,45,3,75,40,19,65,"-1",10
70,49,3,0,5,11,0,"1",0
70,50,3,10,20,38,10,"1",0
70,51,3,50,35,26,50,"-1",0
71,4,3,100,99,78,100,"-1",0
71,13,3,0,23,22,0,"1",0
71,24,3,16,17,14,17,"-1",-1
71,26,3,45,39,29,56,"-1",-11
71,28,3,28,28,20,18,"-1",10
71,32,3,100,76,33,100,"-1",0
71,33,3,100,33,15,100,"-1",0
71,34,3,8,10,80,8,"1",0
71,36,3,0,27,26,0,"1",0
71,37,3,78,55,30,78,"-1",0
71,41,3,0,18,17,0,"1",0
71,42,3,45,59,13,68,"-1",-23
71,44,3,5,6,19,19,"1",-14
71,49,3,0,25,11,0,"1",0
72,1,3,50,42,26,10,"-1",40
72,6,3,10,15,29,10,"1",0
72,11,3,10,25,31,15,"1",-5
72,12,3,100,100,78,85,"-1",15
72,13,3,17,5,22,2,"1",15
72,20,3,70,30,40,40,"-1",30
72,21,3,45,45,35,19,"-1",26
72,24,3,56,56,14,30,"-1",26
72,25,3,30,56,14,20,"-1",10
72,27,3,10,10,45,10,"1",0
72,28,3,75,70,20,30,"-1",45
72,30,3,10,29,48,5,"1",5
72,31,3,70,16,19,10,"-1",60
72,32,3,31,16,33,10,"1",21
72,34,3,60,60,80,80,"1",-20
72,35,3,10,65,17,20,"1",-10
72,39,3,5,36,43,5,"1",0
72,40,3,10,60,21,10,"1",0
72,41,3,89,45,17,60,"-1",29
72,42,3,2,5,13,60,"1",-58
72,47,3,2,29,20,5,"1",-3
72,49,3,36,50,11,10,"-1",26
72,51,3,85,35,26,80,"-1",5
73,4,3,100,90,78,99,"-1",1
73,6,3,1,31,29,10,"1",-9
73,8,3,100,75,75,99,"-1",1
73,14,3,1,15,41,10,"1",-9
73,24,3,35,35,14,16,"-1",19
73,25,3,1,11,14,10,"1",-9
73,26,3,100,60,29,99,"-1",1
73,28,3,26,26,20,20,"-1",6
73,31,3,1,43,19,50,"1",-49
73,33,3,100,80,15,10,"-1",90
73,34,3,10,50,80,20,"1",-10
73,36,3,99,78,26,99,"-1",0
73,41,3,10,32,17,10,"1",0
73,42,3,10,35,13,30,"1",-20
73,44,3,1,19,19,10,"1",-9
73,48,3,10,10,18,10,"1",0
73,50,3,1,25,38,1,"1",0
73,51,3,5,35,26,1,"1",4
74,12,3,99,70,78,99,"-1",0
74,20,3,5,10,40,22,"1",-17
74,24,3,12,20,14,12,"1",0
74,28,3,60,55,20,30,"-1",30
74,33,3,90,80,15,75,"-1",15
74,34,3,80,66,80,65,"0",15
74,38,3,100,100,71,99,"-1",1
74,41,3,54,55,17,40,"-1",14
74,42,3,10,80,13,20,"1",-10
74,44,3,30,12,19,12,"-1",18
75,1,3,50,45,26,50,"-1",0
75,6,3,60,40,29,45,"-1",15
75,7,3,50,50,45,50,"-1",0
75,15,3,90,60,60,80,"-1",10
75,21,3,70,50,35,70,"-1",0
75,24,3,38,40,14,25,"-1",13
75,26,3,90,80,29,80,"-1",10
75,28,3,25,25,20,35,"-1",-10
75,30,3,10,25,48,10,"1",0
75,31,3,100,78,19,0,"-1",100
75,33,3,10,14,15,15,"1",-5
75,34,3,40,45,80,24,"1",16
75,37,3,20,60,30,30,"1",-10
75,41,3,45,50,17,20,"-1",25
75,42,3,50,55,13,5,"-1",45
75,43,3,70,40,81,30,"1",40
75,44,3,10,15,19,20,"1",-10
75,47,3,10,12,20,20,"1",-10
75,51,3,10,30,26,20,"1",-10
76,1,3,10,10,26,50,"1",-40
76,7,3,20,65,45,20,"1",0
76,8,3,50,85,75,50,"1",0
76,9,3,2,20,29,0,"1",2
76,10,3,50,85,56,50,"1",0
76,11,3,10,20,31,0,"1",10
76,12,3,100,99,78,100,"-1",0
76,18,3,99,99,82,80,"-1",19
76,20,3,0,40,40,4,"1",-4
76,24,3,30,30,14,5,"-1",25
76,25,3,20,70,14,5,"-1",15
76,26,3,100,100,29,100,"-1",0
76,28,3,20,20,20,5,"0",15
76,29,3,90,90,66,80,"-1",10
76,30,3,85,85,48,40,"-1",45
76,31,3,100,60,19,10,"-1",90
76,33,3,0,0,15,10,"1",-10
76,34,3,85,85,80,80,"-1",5
76,37,3,95,95,30,50,"-1",45
76,40,3,100,80,21,100,"-1",0
76,41,3,20,90,17,50,"-1",-30
76,42,3,60,95,13,80,"-1",-20
76,44,3,5,60,19,5,"1",0
76,45,3,5,40,19,10,"1",-5
76,46,3,0,80,45,0,"1",0
76,47,3,5,25,20,20,"1",-15
76,48,3,75,75,18,80,"-1",-5
76,49,3,20,65,11,2,"-1",18
76,50,3,0,5,38,0,"1",0
77,6,3,65,25,29,87,"-1",-22
77,10,3,21,43,56,5,"1",16
77,24,3,15,32,14,13,"-1",2
77,25,3,5,14,14,10,"1",-5
77,28,3,11,13,20,21,"1",-10
77,29,3,71,87,66,90,"-1",-19
77,31,3,76,85,19,33,"-1",43
77,39,3,0,78,43,0,"1",0
77,41,3,45,61,17,48,"-1",-3
77,42,3,10,30,13,1,"1",9
77,43,3,35,75,81,57,"1",-22
77,49,3,2,5,11,5,"1",-3
78,21,3,25,20,35,10,"1",15
78,25,3,10,25,14,10,"1",0
78,27,3,25,30,45,45,"1",-20
78,28,3,50,45,20,20,"-1",30
78,30,3,2,10,48,5,"1",-3
78,33,3,30,20,15,10,"-1",20
78,34,3,5,5,80,10,"1",-5
78,35,3,0,20,17,5,"1",-5
78,38,3,70,70,71,90,"1",-20
78,41,3,10,15,17,10,"1",0
78,43,3,25,25,81,10,"1",15
78,44,3,10,10,19,10,"1",0
78,48,3,2,20,18,5,"1",-3
78,51,3,80,65,26,80,"-1",0
79,1,3,10,30,26,26,"1",-16
79,6,3,57,40,29,30,"-1",27
79,24,3,60,50,14,15,"-1",45
79,25,3,40,80,14,47,"-1",-7
79,27,3,100,95,45,60,"-1",40
79,28,3,17,45,20,20,"1",-3
79,29,3,48,65,66,61,"1",-13
79,33,3,10,58,15,25,"1",-15
79,34,3,70,70,80,80,"1",-10
79,35,3,30,60,17,25,"-1",5
79,40,3,40,63,21,20,"-1",20
79,41,3,100,80,17,17,"-1",83
79,42,3,10,35,13,10,"1",0
79,44,3,30,50,19,30,"-1",0
79,45,3,50,70,19,30,"-1",20
79,47,3,20,40,20,20,"0",0
79,48,3,40,50,18,10,"-1",30
79,49,3,15,60,11,11,"-1",4
79,51,3,45,60,26,43,"-1",2
80,1,3,70,50,26,30,"-1",40
80,26,3,100,89,29,100,"-1",0
80,28,3,60,50,20,10,"-1",50
80,29,3,65,55,66,70,"1",-5
80,30,3,5,40,48,15,"1",-10
80,33,3,20,30,15,45,"-1",-25
80,39,3,20,30,43,48,"1",-28
80,41,3,70,55,17,75,"-1",-5
80,42,3,88,67,13,80,"-1",8
80,44,3,20,30,19,17,"-1",3
80,47,3,50,20,20,65,"-1",-15
80,48,3,60,50,18,74,"-1",-14
80,49,3,15,20,11,25,"-1",-10
80,51,3,60,40,26,50,"-1",10
81,8,3,95,90,75,95,"-1",0
81,12,3,100,75,78,80,"-1",20
81,24,3,8,8,14,18,"1",-10
81,26,3,99,78,29,100,"-1",-1
81,28,3,20,17,20,17,"0",3
81,30,3,12,40,48,50,"1",-38
81,33,3,21,87,15,25,"-1",-4
81,34,3,90,81,80,90,"-1",0
81,39,3,15,13,43,30,"1",-15
81,40,3,13,50,21,21,"1",-8
81,41,3,5,5,17,50,"1",-45
81,42,3,50,50,13,50,"-1",0
81,44,3,45,60,19,35,"-1",10
81,47,3,50,28,20,50,"-1",0
82,2,3,90,70,20,12,"-1",78
82,7,3,12,25,45,24,"1",-12
82,15,3,12,20,60,23,"1",-11
82,17,3,65,9,43,45,"-1",20
82,20,3,78,56,40,56,"-1",22
82,21,3,80,21,35,15,"-1",65
82,26,3,100,70,29,90,"-1",10
82,27,3,78,60,45,67,"-1",11
82,28,3,25,16,20,78,"-1",-53
82,29,3,70,65,66,100,"-1",-30
82,30,3,70,45,48,88,"-1",-18
82,31,3,23,15,19,12,"-1",11
82,32,3,70,54,33,78,"-1",-8
82,33,3,12,20,15,78,"1",-66
82,34,3,80,65,80,89,"0",-9
82,36,3,12,18,26,45,"1",-33
82,38,3,100,80,71,100,"-1",0
82,39,3,12,20,43,10,"1",2
82,41,3,98,80,17,91,"-1",7
82,42,3,60,45,13,67,"-1",-7
82,44,3,79,49,19,89,"-1",-10
82,47,3,56,40,20,23,"-1",33
82,51,3,70,45,26,68,"-1",2
83,4,3,100,40,78,100,"-1",0
83,6,3,15,25,29,60,"1",-45
83,7,3,0,40,45,0,"1",0
83,11,3,5,25,31,10,"1",-5
83,13,3,0,18,22,0,"1",0
83,14,3,10,45,41,20,"1",-10
83,24,3,5,7,14,15,"1",-10
83,25,3,10,20,14,10,"1",0
83,26,3,100,90,29,95,"-1",5
83,27,3,5,10,45,50,"1",-45
83,28,3,50,40,20,20,"-1",30
83,30,3,95,25,48,80,"-1",15
83,33,3,0,60,15,50,"1",-50
83,34,3,1,10,80,50,"1",-49
83,37,3,95,90,30,50,"-1",45
83,41,3,0,25,17,10,"1",-10
83,42,3,0,45,13,10,"1",-10
83,43,3,0,10,81,60,"1",-60
83,44,3,1,10,19,3,"1",-2
83,48,3,100,33,18,100,"-1",0
83,49,3,0,5,11,0,"1",0
83,50,3,0,30,38,0,"1",0
83,51,3,60,40,26,70,"-1",-10
84,12,3,100,90,78,100,"-1",0
84,20,3,45,20,40,80,"-1",-35
84,24,3,10,5,14,15,"1",-5
84,26,3,100,70,29,100,"-1",0
84,27,3,50,65,45,80,"-1",-30
84,28,3,30,40,20,20,"-1",10
84,30,3,0,20,48,5,"1",-5
84,33,3,20,30,15,85,"-1",-65
84,34,3,5,25,80,45,"1",-40
84,35,3,10,40,17,5,"1",5
84,36,3,10,45,26,20,"1",-10
84,42,3,80,70,13,60,"-1",20
84,44,3,10,20,19,10,"1",0
84,49,3,25,9,11,15,"-1",10
84,50,3,0,40,38,0,"1",0
85,1,3,2,15,26,0,"1",2
85,2,3,0,0,20,0,"1",0
85,3,3,0,48,29,0,"1",0
85,4,3,100,75,78,99,"-1",1
85,5,3,75,56,56,75,"-1",0
85,6,3,55,60,29,17,"-1",38
85,7,3,99,90,45,99,"-1",0
85,8,3,50,50,75,75,"1",-25
85,9,3,2,5,29,4,"1",-2
85,10,3,75,75,56,75,"-1",0
85,11,3,2,25,31,0,"1",2
85,12,3,99,75,78,99,"-1",0
85,13,3,0,25,22,0,"1",0
85,14,3,2,45,41,2,"1",0
85,15,3,5,5,60,5,"1",0
85,16,3,5,25,26,5,"1",0
85,17,3,2,18,43,2,"1",0
85,18,3,50,50,82,78,"1",-28
85,19,3,1,15,21,0,"1",1
85,20,3,0,25,40,0,"1",0
85,21,3,75,75,35,25,"-1",50
85,22,3,2,10,60,66,"1",-64
85,23,3,50,75,71,55,"1",-5
85,24,3,35,35,14,56,"-1",-21
85,25,3,75,30,14,55,"-1",20
85,26,3,99,78,29,99,"-1",0
85,27,3,2,56,45,55,"1",-53
85,28,3,39,36,20,15,"-1",24
85,29,3,99,99,66,74,"-1",25
85,30,3,5,17,48,5,"1",0
85,31,3,2,25,19,56,"1",-54
85,32,3,78,75,33,0,"-1",78
85,33,3,75,56,15,99,"-1",-24
85,34,3,5,15,80,5,"1",0
85,35,3,0,5,17,0,"1",0
85,36,3,5,5,26,5,"1",0
85,37,3,5,10,30,15,"1",-10
85,38,3,5,54,71,5,"1",0
85,39,3,2,35,43,0,"1",2
85,40,3,75,75,21,25,"-1",50
85,41,3,2,35,17,0,"1",2
85,42,3,2,15,13,2,"1",0
85,43,3,2,2,81,75,"1",-73
85,44,3,2,10,19,55,"1",-53
85,45,3,50,50,19,5,"-1",45
85,46,3,0,45,45,0,"1",0
85,47,3,57,79,20,25,"-1",32
85,48,3,5,5,18,0,"1",5
85,49,3,0,15,11,0,"1",0
85,50,3,0,5,38,0,"1",0
85,51,3,0,45,26,0,"1",0
86,2,3,30,30,20,20,"-1",10
86,3,3,5,60,29,10,"1",-5
86,4,3,50,80,78,20,"1",30
86,5,3,20,20,56,30,"1",-10
86,6,3,50,50,29,60,"-1",-10
86,7,3,0,50,45,0,"1",0
86,8,3,10,30,75,15,"1",-5
86,9,3,5,10,29,5,"1",0
86,11,3,1,20,31,15,"1",-14
86,12,3,90,90,78,100,"-1",-10
86,13,3,50,2,22,15,"-1",35
86,14,3,5,50,41,10,"1",-5
86,15,3,20,50,60,30,"1",-10
86,18,3,50,70,82,40,"1",10
86,19,3,10,20,21,20,"1",-10
86,21,3,90,50,35,70,"-1",20
86,22,3,100,100,60,100,"-1",0
86,24,3,1,30,14,15,"1",-14
86,25,3,25,25,14,20,"-1",5
86,26,3,100,80,29,99,"-1",1
86,28,3,16,15,20,15,"1",1
86,30,3,10,10,48,15,"1",-5
86,32,3,90,20,33,99,"-1",-9
86,33,3,100,25,15,100,"-1",0
86,34,3,40,60,80,60,"1",-20
86,36,3,25,25,26,25,"1",0
86,37,3,90,50,30,70,"-1",20
86,39,3,50,50,43,45,"-1",5
86,40,3,0,10,21,0,"1",0
86,41,3,0,27,17,2,"1",-2
86,42,3,10,50,13,10,"1",0
86,44,3,1,1,19,15,"1",-14
86,45,3,6,4,19,10,"1",-4
86,47,3,10,50,20,5,"1",5
86,49,3,0,20,11,10,"1",-10
86,50,3,0,5,38,5,"1",-5
86,51,3,10,50,26,10,"1",0
87,8,3,50,70,75,40,"1",10
87,12,3,0,40,78,0,"1",0
87,25,3,5,25,14,5,"1",0
87,28,3,18,18,20,15,"1",3
87,30,3,0,15,48,0,"1",0
87,31,3,80,30,19,15,"-1",65
87,33,3,60,40,15,95,"-1",-35
87,34,3,0,25,80,10,"1",-10
87,36,3,50,50,26,25,"-1",25
87,37,3,10,60,30,10,"1",0
87,39,3,90,50,43,100,"-1",-10
87,41,3,2,50,17,5,"1",-3
87,42,3,5,30,13,5,"1",0
87,44,3,0,10,19,5,"1",-5
87,48,3,20,50,18,20,"-1",0
87,50,3,0,40,38,0,"1",0
88,24,3,5,5,14,15,"1",-10
88,26,3,20,80,29,20,"1",0
88,28,3,15,15,20,30,"1",-15
88,33,3,70,30,15,80,"-1",-10
88,37,3,60,70,30,50,"-1",10
88,39,3,0,40,43,0,"1",0
88,41,3,0,20,17,5,"1",-5
88,42,3,20,60,13,15,"-1",5
88,44,3,40,20,19,25,"-1",15
88,47,3,0,5,20,0,"1",0
88,48,3,20,60,18,10,"-1",10
88,49,3,5,30,11,5,"1",0
89,7,3,30,40,45,20,"1",10
89,8,3,80,60,75,90,"-1",-10
89,9,3,20,30,29,10,"1",10
89,12,3,100,100,78,80,"-1",20
89,19,3,50,50,21,50,"-1",0
89,24,3,40,40,14,10,"-1",30
89,25,3,30,35,14,30,"-1",0
89,26,3,90,40,29,80,"-1",10
89,27,3,80,50,45,80,"-1",0
89,28,3,10,10,20,10,"1",0
89,29,3,99,80,66,70,"-1",29
89,30,3,90,20,48,10,"-1",80
89,33,3,40,20,15,80,"-1",-40
89,34,3,10,10,80,50,"1",-40
89,41,3,20,30,17,20,"-1",0
89,42,3,80,60,13,60,"-1",20
89,44,3,0,10,19,1,"1",-1
89,45,3,1,30,19,10,"1",-9
89,47,3,20,40,20,80,"0",-60
89,48,3,60,50,18,70,"-1",-10
89,49,3,1,10,11,1,"1",0
89,51,3,50,60,26,50,"-1",0
90,12,3,25,25,78,80,"1",-55
90,22,3,80,80,60,80,"-1",0
90,24,3,10,10,14,20,"1",-10
90,26,3,89,78,29,100,"-1",-11
90,27,3,60,75,45,40,"-1",20
90,28,3,20,20,20,20,"0",0
90,32,3,20,20,33,20,"1",0
90,33,3,80,90,15,35,"-1",45
90,41,3,30,70,17,40,"-1",-10
90,43,3,80,32,81,30,"1",50
90,44,3,20,20,19,20,"-1",0
90,51,3,50,20,26,80,"-1",-30
91,7,3,40,50,45,70,"1",-30
91,8,3,20,60,75,30,"1",-10
91,12,3,50,50,78,60,"1",-10
91,21,3,30,30,35,60,"1",-30
91,22,3,100,100,60,70,"-1",30
91,24,3,5,5,14,8,"1",-3
91,25,3,0,25,14,1,"1",-1
91,28,3,10,10,20,10,"1",0
91,29,3,99,80,66,80,"-1",19
91,30,3,0,15,48,0,"1",0
91,33,3,100,60,15,99,"-1",1
91,34,3,5,10,80,20,"1",-15
91,36,3,60,60,26,40,"-1",20
91,42,3,20,80,13,10,"-1",10
91,44,3,5,10,19,10,"1",-5
91,47,3,100,30,20,100,"-1",0
91,49,3,0,15,11,0,"1",0
91,51,3,20,30,26,15,"1",5
92,5,3,60,55,56,45,"-1",15
92,7,3,60,30,45,60,"-1",0
92,8,3,100,90,75,100,"-1",0
92,12,3,100,40,78,100,"-1",0
92,15,3,37,30,60,25,"1",12
92,21,3,75,75,35,35,"-1",40
92,24,3,5,5,14,10,"1",-5
92,25,3,3,20,14,10,"1",-7
92,26,3,10,72,29,5,"1",5
92,28,3,50,45,20,10,"-1",40
92,30,3,0,17,48,2,"1",-2
92,37,3,50,45,30,50,"-1",0
92,40,3,100,75,21,100,"-1",0
92,43,3,10,12,81,5,"1",5
92,44,3,7,10,19,15,"1",-8
92,47,3,5,30,20,5,"1",0
92,51,3,0,18,26,0,"1",0
93,3,3,40,4,29,0,"-1",40
93,25,3,0,10,14,0,"1",0
93,27,3,3,5,45,5,"1",-2
93,28,3,45,45,20,45,"-1",0
93,29,3,70,85,66,10,"-1",60
93,30,3,0,30,48,2,"1",-2
93,32,3,20,35,33,25,"1",-5
93,33,3,10,40,15,15,"1",-5
93,34,3,2,5,80,40,"1",-38
93,38,3,100,99,71,100,"-1",0
93,39,3,0,35,43,0,"1",0
93,40,3,35,75,21,25,"-1",10
93,41,3,1,45,17,15,"1",-14
93,49,3,0,25,11,0,"1",0
93,50,3,0,8,38,1,"1",-1
93,51,3,0,16,26,0,"1",0
94,4,3,100,80,78,100,"-1",0
94,24,3,70,35,14,20,"-1",50
94,27,3,0,25,45,15,"1",-15
94,28,3,40,40,20,50,"-1",-10
94,31,3,100,55,19,5,"-1",95
94,33,3,62,42,15,35,"-1",27
94,34,3,0,12,80,0,"1",0
94,40,3,100,65,21,100,"-1",0
94,41,3,5,40,17,10,"1",-5
94,42,3,50,80,13,15,"-1",35
94,44,3,25,20,19,30,"-1",-5
95,3,3,0,30,29,0,"1",0
95,8,3,45,60,75,25,"1",20
95,12,3,100,100,78,65,"-1",35
95,16,3,25,10,26,25,"1",0
95,24,3,5,5,14,5,"1",0
95,25,3,10,20,14,10,"1",0
95,26,3,25,80,29,45,"1",-20
95,28,3,60,60,20,10,"-1",50
95,30,3,5,15,48,10,"1",-5
95,34,3,0,10,80,0,"1",0
95,37,3,65,65,30,60,"-1",5
95,41,3,0,71,17,0,"1",0
95,42,3,10,25,13,10,"1",0
95,44,3,0,5,19,0,"1",0
95,48,3,25,30,18,25,"-1",0
95,50,3,0,25,38,0,"1",0
96,4,3,19,50,78,46,"1",-27
96,5,3,10,25,56,56,"1",-46
96,6,3,78,23,29,12,"-1",66
96,8,3,60,50,75,50,"1",10
96,9,3,50,30,29,72,"-1",-22
96,10,3,60,37,56,10,"-1",50
96,12,3,100,68,78,50,"-1",50
96,14,3,100,70,41,49,"-1",51
96,20,3,100,53,40,70,"-1",30
96,24,3,3,3,14,13,"1",-10
96,28,3,60,50,20,3,"-1",57
96,30,3,0,10,48,30,"1",-30
96,37,3,25,24,30,70,"1",-45
96,39,3,20,30,43,30,"1",-10
96,42,3,50,85,13,10,"-1",40
96,44,3,33,35,19,20,"-1",13
96,47,3,20,25,20,34,"0",-14
96,48,3,0,4,18,21,"1",-21
97,11,3,2,20,31,3,"1",-1
97,24,3,8,15,14,15,"1",-7
97,25,3,75,35,14,70,"-1",5
97,31,3,25,65,19,50,"-1",-25
97,33,3,25,25,15,35,"-1",-10
97,34,3,60,60,80,70,"1",-10
97,35,3,50,50,17,5,"-1",45
97,41,3,20,80,17,10,"-1",10
97,44,3,35,35,19,15,"-1",20
97,45,3,60,50,19,40,"-1",20
97,48,3,25,15,18,25,"-1",0
97,51,3,20,30,26,10,"1",10
98,6,3,50,20,29,60,"-1",-10
98,7,3,100,50,45,100,"-1",0
98,10,3,75,80,56,50,"-1",25
98,12,3,100,99,78,100,"-1",0
98,21,3,30,50,35,30,"1",0
98,24,3,5,10,14,10,"1",-5
98,25,3,0,30,14,20,"1",-20
98,26,3,100,60,29,70,"-1",30
98,28,3,10,5,20,10,"1",0
98,30,3,0,5,48,0,"1",0
98,33,3,0,10,15,0,"1",0
98,34,3,50,50,80,30,"1",20
98,39,3,0,60,43,50,"1",-50
98,41,3,100,60,17,100,"-1",0
98,42,3,100,60,13,100,"-1",0
98,44,3,0,3,19,0,"1",0
98,45,3,20,10,19,30,"-1",-10
98,47,3,0,10,20,0,"1",0
98,48,3,99,20,18,100,"-1",-1
98,50,3,0,3,38,0,"1",0
98,51,3,0,30,26,0,"1",0
99,6,3,5,5,29,2,"1",3
99,8,3,1,25,75,65,"1",-64
99,24,3,15,15,14,14,"-1",1
99,25,3,2,10,14,1,"1",1
99,26,3,95,90,29,99,"-1",-4
99,28,3,18,18,20,15,"1",3
99,30,3,1,12,48,1,"1",0
99,33,3,100,80,15,90,"-1",10
99,34,3,1,5,80,1,"1",0
99,35,3,1,25,17,0,"1",1
99,38,3,100,95,71,99,"-1",1
99,41,3,1,18,17,0,"1",1
99,42,3,70,50,13,50,"-1",20
99,48,3,50,20,18,20,"-1",30
100,1,3,10,20,26,10,"1",0
100,21,3,60,50,35,50,"-1",10
100,24,3,5,5,14,15,"1",-10
100,25,3,100,45,14,100,"-1",0
100,27,3,50,25,45,80,"-1",-30
100,28,3,15,15,20,15,"1",0
100,30,3,100,35,48,100,"-1",0
100,33,3,80,75,15,20,"-1",60
100,34,3,90,80,80,90,"-1",0
100,37,3,70,85,30,30,"-1",40
100,39,3,100,40,43,99,"-1",1
100,40,3,95,80,21,95,"-1",0
100,41,3,90,55,17,95,"-1",-5
100,42,3,10,10,13,20,"1",-10
100,43,3,5,65,81,50,"1",-45
100,44,3,5,5,19,20,"1",-15
100,47,3,10,20,20,10,"1",0
