"Participant","Event","Valence","E1","eBR","BR","E2","direction","update"
1,7,3,0,25,45,12,"1",-12
1,8,3,99,87,75,89,"-1",10
1,20,3,12,12,40,12,"1",0
1,23,3,90,70,71,90,"-1",0
1,24,3,1,2,14,14,"1",-13
1,27,3,100,57,45,100,"-1",0
1,28,3,24,50,20,20,"-1",4
1,30,3,0,12,48,0,"1",0
1,33,3,0,34,15,0,"1",0
1,35,3,10,45,17,20,"1",-10
1,43,3,0,12,81,5,"1",-5
1,50,3,0,12,38,0,"1",0
2,3,3,0,25,29,0,"1",0
2,4,3,100,90,78,90,"-1",10
2,8,3,90,80,75,80,"-1",10
2,12,3,100,80,78,100,"-1",0
2,24,3,50,45,14,20,"-1",30
2,26,3,90,80,29,80,"-1",10
2,27,3,20,25,45,45,"1",-25
2,28,3,15,10,20,20,"1",-5
2,29,3,85,80,66,60,"-1",25
2,30,3,100,45,48,100,"-1",0
2,33,3,90,45,15,20,"-1",70
2,34,3,85,65,80,85,"-1",0
2,39,3,10,10,43,10,"1",0
2,41,3,35,25,17,35,"-1",0
2,42,3,100,45,13,100,"-1",0
2,43,3,20,25,81,75,"1",-55
2,44,3,0,15,19,5,"1",-5
2,45,3,60,25,19,20,"-1",40
2,47,3,19,19,20,20,"1",-1
2,48,3,60,40,18,30,"-1",30
2,49,3,0,12,11,5,"1",-5
2,50,3,50,45,38,35,"-1",15
2,51,3,50,65,26,20,"-1",30
3,8,3,20,65,75,50,"1",-30
3,24,3,15,23,14,15,"-1",0
3,25,3,15,45,14,10,"-1",5
3,28,3,21,21,20,21,"-1",0
3,30,3,5,24,48,30,"1",-25
3,34,3,12,45,80,65,"1",-53
3,38,3,95,86,71,85,"-1",10
3,39,3,32,16,43,35,"1",-3
3,41,3,5,35,17,5,"1",0
3,42,3,5,40,13,10,"1",-5
3,44,3,10,43,19,15,"1",-5
3,45,3,1,15,19,5,"1",-4
3,50,3,10,30,38,25,"1",-15
3,51,3,5,15,26,15,"1",-10
4,16,3,40,40,26,40,"-1",0
4,17,3,70,40,43,60,"-1",10
4,21,3,100,80,35,100,"-1",0
4,24,3,12,12,14,14,"1",-2
4,28,3,60,60,20,50,"-1",10
4,31,3,10,20,19,10,"1",0
4,36,3,90,90,26,40,"-1",50
4,41,3,100,35,17,100,"-1",0
4,44,3,3,8,19,8,"1",-5
5,8,3,50,90,75,50,"1",0
5,12,3,100,80,78,100,"-1",0
5,24,3,4,4,14,4,"1",0
5,26,3,0,90,29,0,"1",0
5,27,3,60,25,45,60,"-1",0
5,28,3,15,15,20,15,"1",0
5,30,3,0,11,48,0,"1",0
5,34,3,70,24,80,80,"1",-10
5,37,3,0,30,30,0,"1",0
5,41,3,100,50,17,100,"-1",0
5,42,3,9,15,13,10,"1",-1
5,43,3,10,77,81,10,"1",0
5,44,3,10,20,19,10,"1",0
5,45,3,0,20,19,0,"1",0
5,47,3,100,60,20,100,"-1",0
5,48,3,0,30,18,0,"1",0
6,4,3,95,95,78,95,"-1",0
6,7,3,0,20,45,0,"1",0
6,8,3,70,70,75,75,"1",-5
6,10,3,10,50,56,10,"1",0
6,12,3,100,95,78,100,"-1",0
6,24,3,10,10,14,14,"1",-4
6,26,3,95,85,29,85,"-1",10
6,28,3,14,14,20,20,"1",-6
6,29,3,10,20,66,20,"1",-10
6,33,3,100,50,15,100,"-1",0
6,34,3,70,60,80,75,"1",-5
6,38,3,99,80,71,99,"-1",0
6,39,3,99,50,43,60,"-1",39
6,42,3,0,30,13,0,"1",0
6,44,3,10,10,19,19,"1",-9
6,47,3,35,35,20,20,"-1",15
6,48,3,100,70,18,100,"-1",0
6,49,3,10,25,11,11,"1",-1
6,50,3,0,40,38,0,"1",0
7,3,3,0,30,29,0,"1",0
7,6,3,20,40,29,30,"1",-10
7,10,3,60,60,56,60,"-1",0
7,12,3,100,90,78,100,"-1",0
7,13,3,0,20,22,10,"1",-10
7,24,3,50,40,14,10,"-1",40
7,28,3,18,18,20,20,"1",-2
7,34,3,80,80,80,80,"0",0
7,35,3,20,30,17,20,"-1",0
7,42,3,10,10,13,10,"1",0
7,44,3,90,30,19,90,"-1",0
7,47,3,30,20,20,20,"-1",10
7,50,3,20,30,38,20,"1",0
8,12,3,0,10,78,10,"1",-10
8,13,3,0,33,22,0,"1",0
8,24,3,15,15,14,14,"-1",1
8,27,3,50,75,45,40,"-1",10
8,28,3,20,40,20,20,"0",0
8,31,3,99,80,19,80,"-1",19
8,35,3,50,50,17,50,"-1",0
8,39,3,75,90,43,60,"-1",15
8,45,3,10,18,19,10,"1",0
8,47,3,0,15,20,0,"1",0
8,49,3,10,10,11,11,"1",-1
8,50,3,0,50,38,0,"1",0
8,51,3,0,40,26,0,"1",0
9,7,3,0,35,45,0,"1",0
9,8,3,53,53,75,75,"1",-22
9,13,3,30,0,22,0,"-1",30
9,24,3,0,20,14,0,"1",0
9,26,3,100,100,29,100,"-1",0
9,27,3,80,75,45,65,"-1",15
9,28,3,0,30,20,0,"1",0
9,34,3,30,40,80,80,"1",-50
9,38,3,100,100,71,89,"-1",11
9,42,3,100,50,13,100,"-1",0
9,44,3,0,20,19,0,"1",0
9,47,3,0,25,20,5,"1",-5
9,48,3,100,40,18,100,"-1",0
9,49,3,0,2,11,0,"1",0
9,51,3,5,20,26,20,"1",-15
10,8,3,45,67,75,45,"1",0
10,9,3,1,10,29,1,"1",0
10,10,3,56,35,56,55,"0",1
10,12,3,100,95,78,98,"-1",2
10,13,3,1,23,22,1,"1",0
10,24,3,13,15,14,13,"1",0
10,26,3,1,43,29,1,"1",0
10,28,3,12,18,20,12,"1",0
10,30,3,50,32,48,50,"-1",0
10,33,3,90,90,15,35,"-1",55
10,34,3,2,21,80,2,"1",0
10,41,3,1,25,17,1,"1",0
10,42,3,9,15,13,8,"1",1
10,43,3,2,5,81,56,"1",-54
10,44,3,15,35,19,12,"1",3
10,47,3,34,35,20,57,"-1",-23
10,48,3,1,35,18,1,"1",0
10,49,3,1,8,11,1,"1",0
10,50,3,1,15,38,1,"1",0
10,51,3,57,34,26,54,"-1",3
11,1,3,80,15,26,80,"-1",0
11,3,3,0,35,29,0,"1",0
11,5,3,100,40,56,100,"-1",0
11,7,3,0,35,45,0,"1",0
11,10,3,60,30,56,60,"-1",0
11,12,3,100,80,78,100,"-1",0
11,13,3,0,20,22,0,"1",0
11,16,3,99,65,26,99,"-1",0
11,17,3,80,50,43,80,"-1",0
11,21,3,100,75,35,100,"-1",0
11,24,3,30,30,14,20,"-1",10
11,25,3,0,20,14,0,"1",0
11,26,3,100,70,29,100,"-1",0
11,27,3,30,60,45,30,"1",0
11,28,3,35,35,20,25,"-1",10
11,30,3,0,20,48,0,"1",0
11,33,3,0,10,15,0,"1",0
11,35,3,15,40,17,20,"1",-5
11,38,3,100,80,71,100,"-1",0
11,39,3,0,25,43,0,"1",0
11,41,3,0,15,17,0,"1",0
11,42,3,0,30,13,0,"1",0
11,43,3,0,15,81,0,"1",0
11,44,3,20,20,19,19,"-1",1
11,45,3,1,10,19,1,"1",0
11,47,3,15,15,20,20,"1",-5
11,48,3,100,40,18,100,"-1",0
11,49,3,0,15,11,0,"1",0
11,50,3,0,30,38,1,"1",-1
11,51,3,0,30,26,0,"1",0
12,1,3,50,20,26,40,"-1",10
12,21,3,60,60,35,60,"-1",0
12,26,3,100,80,29,100,"-1",0
12,28,3,50,50,20,20,"-1",30
12,30,3,5,15,48,5,"1",0
12,33,3,0,5,15,0,"1",0
12,34,3,85,85,80,80,"-1",5
12,36,3,50,50,26,26,"-1",24
12,37,3,90,60,30,90,"-1",0
12,42,3,5,60,13,8,"1",-3
12,44,3,2,6,19,10,"1",-8
12,49,3,0,40,11,0,"1",0
12,50,3,10,30,38,15,"1",-5
12,51,3,50,35,26,26,"-1",24
13,8,3,70,68,75,79,"1",-9
13,9,3,2,10,29,2,"1",0
13,12,3,75,75,78,75,"1",0
13,24,3,20,20,14,14,"-1",6
13,26,3,98,75,29,98,"-1",0
13,27,3,30,25,45,45,"1",-15
13,28,3,50,50,20,20,"-1",30
13,33,3,10,22,15,10,"1",0
13,41,3,96,85,17,75,"-1",21
13,42,3,97,95,13,97,"-1",0
13,43,3,1,2,81,1,"1",0
13,44,3,50,50,19,15,"-1",35
13,45,3,15,24,19,15,"1",0
13,47,3,0,15,20,5,"1",-5
13,49,3,0,10,11,0,"1",0
13,51,3,5,35,26,5,"1",0
14,7,3,0,40,45,0,"1",0
14,8,3,100,100,75,100,"-1",0
14,10,3,5,30,56,5,"1",0
14,12,3,100,90,78,100,"-1",0
14,16,3,25,0,26,0,"1",25
14,24,3,15,15,14,14,"-1",1
14,28,3,15,15,20,20,"1",-5
14,30,3,0,15,48,0,"1",0
14,33,3,0,33,15,0,"1",0
14,34,3,0,10,80,0,"1",0
14,39,3,100,50,43,100,"-1",0
14,40,3,90,90,21,90,"-1",0
14,41,3,100,80,17,100,"-1",0
14,42,3,0,25,13,0,"1",0
14,43,3,0,30,81,0,"1",0
14,44,3,20,20,19,19,"-1",1
14,45,3,0,5,19,5,"1",-5
14,46,3,100,60,45,100,"-1",0
14,47,3,0,12,20,0,"1",0
14,48,3,30,30,18,18,"-1",12
14,50,3,0,15,38,0,"1",0
14,51,3,0,50,26,0,"1",0
15,4,3,60,60,78,78,"1",-18
15,10,3,30,40,56,40,"1",-10
15,12,3,70,70,78,78,"1",-8
15,14,3,10,15,41,30,"1",-20
15,16,3,40,60,26,60,"-1",-20
15,24,3,3,3,14,14,"1",-11
15,26,3,90,70,29,90,"-1",0
15,27,3,70,60,45,60,"-1",10
15,28,3,40,40,20,20,"-1",20
15,33,3,20,20,15,15,"-1",5
15,34,3,5,3,80,10,"1",-5
15,36,3,60,60,26,26,"-1",34
15,42,3,20,20,13,20,"-1",0
15,44,3,10,10,19,19,"1",-9
15,45,3,30,15,19,30,"-1",0
15,49,3,20,30,11,11,"-1",9
15,51,3,40,40,26,26,"-1",14
16,1,3,15,13,26,15,"1",0
16,12,3,40,35,78,40,"1",0
16,16,3,10,15,26,10,"1",0
16,24,3,65,65,14,65,"-1",0
16,25,3,10,25,14,25,"1",-15
16,28,3,5,11,20,5,"1",0
16,29,3,50,50,66,50,"1",0
16,31,3,10,25,19,5,"1",5
16,33,3,10,25,15,5,"1",5
16,34,3,5,16,80,10,"1",-5
16,35,3,35,35,17,25,"-1",10
16,36,3,20,75,26,25,"1",-5
16,38,3,80,85,71,70,"-1",10
16,41,3,10,35,17,5,"1",5
16,42,3,10,15,13,10,"1",0
16,43,3,10,25,81,25,"1",-15
16,44,3,10,15,19,10,"1",0
16,47,3,10,10,20,10,"1",0
16,50,3,0,65,38,0,"1",0
16,51,3,10,45,26,10,"1",0
17,8,3,5,20,75,10,"1",-5
17,9,3,10,20,29,10,"1",0
17,10,3,10,40,56,10,"1",0
17,24,3,20,20,14,14,"-1",6
17,27,3,80,80,45,70,"-1",10
17,28,3,20,20,20,20,"0",0
17,30,3,10,20,48,20,"1",-10
17,32,3,0,20,33,0,"1",0
17,33,3,90,70,15,90,"-1",0
17,38,3,100,95,71,100,"-1",0
17,40,3,0,30,21,0,"1",0
17,42,3,5,10,13,5,"1",0
17,43,3,100,70,81,100,"-1",0
17,44,3,0,30,19,0,"1",0
17,45,3,20,40,19,10,"-1",10
18,8,3,15,40,75,25,"1",-10
18,10,3,0,50,56,0,"1",0
18,12,3,100,95,78,100,"-1",0
18,24,3,50,25,14,28,"-1",22
18,26,3,100,90,29,100,"-1",0
18,28,3,40,40,20,30,"-1",10
18,33,3,50,25,15,50,"-1",0
18,34,3,40,40,80,60,"1",-20
18,42,3,5,60,13,5,"1",0
18,44,3,15,15,19,19,"1",-4
18,49,3,1,4,11,2,"1",-1
18,50,3,0,30,38,0,"1",0
18,51,3,100,50,26,100,"-1",0
19,1,3,50,50,26,39,"-1",11
19,3,3,0,20,29,0,"1",0
19,5,3,100,70,56,90,"-1",10
19,8,3,40,60,75,40,"1",0
19,10,3,60,70,56,60,"-1",0
19,24,3,0,10,14,0,"1",0
19,25,3,5,5,14,5,"1",0
19,27,3,8,45,45,8,"1",0
19,28,3,33,33,20,20,"-1",13
19,31,3,100,50,19,3,"-1",97
19,32,3,100,70,33,100,"-1",0
19,34,3,80,76,80,80,"0",0
19,39,3,50,40,43,54,"-1",-4
19,41,3,6,22,17,6,"1",0
19,42,3,80,80,13,80,"-1",0
19,43,3,70,50,81,70,"1",0
19,44,3,10,30,19,10,"1",0
19,49,3,0,15,11,0,"1",0
19,50,3,0,15,38,0,"1",0
20,8,3,50,82,75,50,"1",0
20,12,3,100,95,78,95,"-1",5
20,17,3,99,75,43,76,"-1",23
20,24,3,10,7,14,10,"1",0
20,25,3,0,15,14,0,"1",0
20,26,3,100,79,29,100,"-1",0
20,28,3,19,19,20,20,"1",-1
20,30,3,0,20,48,1,"1",-1
20,33,3,100,72,15,100,"-1",0
20,34,3,70,86,80,90,"1",-20
20,38,3,100,87,71,100,"-1",0
20,41,3,100,25,17,100,"-1",0
20,43,3,0,76,81,0,"1",0
20,44,3,37,37,19,19,"-1",18
20,45,3,50,38,19,25,"-1",25
20,47,3,67,63,20,14,"-1",53
20,48,3,100,50,18,100,"-1",0
20,50,3,35,35,38,35,"1",0
20,51,3,50,15,26,50,"-1",0
21,3,3,40,60,29,40,"-1",0
21,4,3,100,50,78,100,"-1",0
21,7,3,0,20,45,0,"1",0
21,10,3,20,70,56,20,"1",0
21,24,3,50,30,14,10,"-1",40
21,25,3,60,60,14,50,"-1",10
21,27,3,20,20,45,50,"1",-30
21,28,3,20,14,20,20,"0",0
21,31,3,20,50,19,20,"-1",0
21,33,3,100,70,15,100,"-1",0
21,34,3,0,60,80,0,"1",0
21,37,3,10,50,30,20,"1",-10
21,40,3,0,60,21,0,"1",0
21,41,3,10,25,17,10,"1",0
21,42,3,50,60,13,50,"-1",0
21,43,3,0,50,81,30,"1",-30
21,44,3,60,40,19,60,"-1",0
21,47,3,0,30,20,0,"1",0
21,48,3,90,80,18,80,"-1",10
21,49,3,0,20,11,5,"1",-5
22,12,3,80,80,78,80,"-1",0
22,15,3,80,70,60,70,"-1",10
22,24,3,5,5,14,14,"1",-9
22,26,3,100,100,29,100,"-1",0
22,27,3,20,20,45,40,"1",-20
22,28,3,30,30,20,20,"-1",10
22,31,3,20,15,19,20,"-1",0
22,32,3,100,30,33,90,"-1",10
22,33,3,0,20,15,0,"1",0
22,35,3,0,5,17,0,"1",0
22,39,3,40,50,43,40,"1",0
22,40,3,100,60,21,100,"-1",0
22,41,3,20,15,17,17,"-1",3
22,42,3,100,70,13,100,"-1",0
22,44,3,10,10,19,5,"1",5
22,45,3,20,20,19,20,"-1",0
22,47,3,0,20,20,0,"1",0
22,51,3,20,50,26,20,"1",0
23,3,3,0,28,29,0,"1",0
23,6,3,5,15,29,5,"1",0
23,8,3,99,87,75,99,"-1",0
23,11,3,5,24,31,5,"1",0
23,21,3,95,78,35,95,"-1",0
23,24,3,17,17,14,17,"-1",0
23,26,3,100,86,29,100,"-1",0
23,28,3,19,23,20,20,"1",-1
23,33,3,20,20,15,10,"-1",10
23,36,3,80,88,26,50,"-1",30
23,37,3,25,58,30,30,"1",-5
23,38,3,95,95,71,95,"-1",0
23,40,3,99,78,21,99,"-1",0
23,42,3,95,86,13,99,"-1",-4
23,44,3,0,17,19,1,"1",-1
23,48,3,100,63,18,100,"-1",0
23,49,3,0,22,11,1,"1",-1
23,51,3,50,88,26,50,"-1",0
24,2,3,20,30,20,20,"0",0
24,7,3,15,45,45,20,"1",-5
24,12,3,100,100,78,80,"-1",20
24,15,3,0,34,60,30,"1",-30
24,20,3,100,45,40,50,"-1",50
24,24,3,19,19,14,10,"-1",9
24,26,3,100,100,29,100,"-1",0
24,28,3,19,19,20,19,"1",0
24,34,3,60,50,80,60,"1",0
24,36,3,100,65,26,40,"-1",60
24,41,3,80,80,17,30,"-1",50
24,42,3,20,20,13,10,"-1",10
24,44,3,33,33,19,25,"-1",8
24,45,3,15,19,19,10,"1",5
24,48,3,10,15,18,15,"1",-5
24,49,3,10,30,11,5,"1",5
24,50,3,75,65,38,100,"-1",-25
24,51,3,70,50,26,40,"-1",30
25,6,3,2,30,29,5,"1",-3
25,13,3,0,20,22,0,"1",0
25,24,3,1,2,14,1,"1",0
25,28,3,15,15,20,15,"1",0
25,33,3,90,90,15,90,"-1",0
25,34,3,5,23,80,5,"1",0
25,36,3,30,60,26,26,"-1",4
25,37,3,80,80,30,30,"-1",50
25,41,3,2,40,17,2,"1",0
25,42,3,10,20,13,10,"1",0
25,43,3,0,22,81,0,"1",0
25,44,3,5,9,19,5,"1",0
25,49,3,0,15,11,0,"1",0
25,51,3,0,23,26,0,"1",0
26,4,3,100,99,78,100,"-1",0
26,9,3,0,13,29,0,"1",0
26,13,3,45,50,22,10,"-1",35
26,20,3,1,60,40,5,"1",-4
26,24,3,5,25,14,5,"1",0
26,25,3,0,50,14,0,"1",0
26,26,3,100,98,29,90,"-1",10
26,27,3,100,70,45,75,"-1",25
26,28,3,50,50,20,10,"-1",40
26,29,3,99,50,66,99,"-1",0
26,32,3,10,45,33,10,"1",0
26,33,3,30,50,15,30,"-1",0
26,42,3,99,75,13,50,"-1",49
26,44,3,0,35,19,1,"1",-1
26,47,3,10,30,20,5,"1",5
26,48,3,0,15,18,0,"1",0
26,49,3,5,43,11,5,"1",0
26,50,3,0,35,38,0,"1",0
26,51,3,1,25,26,5,"1",-4
27,1,3,50,50,26,50,"-1",0
27,8,3,100,60,75,100,"-1",0
27,9,3,1,9,29,3,"1",-2
27,10,3,50,50,56,50,"1",0
27,28,3,10,10,20,15,"1",-5
27,31,3,20,30,19,20,"-1",0
27,33,3,100,50,15,100,"-1",0
27,42,3,10,20,13,10,"1",0
27,44,3,0,30,19,0,"1",0
28,3,3,30,65,29,10,"-1",20
28,7,3,10,55,45,5,"1",5
28,8,3,10,50,75,10,"1",0
28,12,3,100,95,78,100,"-1",0
28,27,3,100,80,45,100,"-1",0
28,28,3,35,35,20,20,"-1",15
28,30,3,0,40,48,0,"1",0
28,34,3,50,80,80,20,"1",30
28,39,3,0,40,43,0,"1",0
28,41,3,50,15,17,50,"-1",0
28,42,3,100,90,13,100,"-1",0
28,45,3,70,70,19,19,"-1",51
28,46,3,20,50,45,20,"1",0
28,48,3,70,15,18,70,"-1",0
28,49,3,0,20,11,0,"1",0
29,3,3,20,36,29,20,"1",0
29,13,3,0,12,22,0,"1",0
29,24,3,20,20,14,15,"-1",5
29,25,3,0,24,14,0,"1",0
29,28,3,50,37,20,20,"-1",30
29,30,3,0,35,48,0,"1",0
29,34,3,30,50,80,70,"1",-40
29,36,3,95,95,26,15,"-1",80
29,41,3,100,40,17,100,"-1",0
29,42,3,100,45,13,100,"-1",0
29,43,3,0,6,81,15,"1",-15
29,45,3,60,30,19,60,"-1",0
29,48,3,10,9,18,10,"1",0
30,5,3,20,10,56,20,"1",0
30,7,3,0,20,45,10,"1",-10
30,8,3,90,55,75,80,"-1",10
30,11,3,0,10,31,0,"1",0
30,21,3,60,60,35,60,"-1",0
30,24,3,2,2,14,10,"1",-8
30,26,3,80,80,29,80,"-1",0
30,28,3,40,50,20,20,"-1",20
30,30,3,0,47,48,0,"1",0
30,31,3,15,23,19,15,"1",0
30,33,3,99,60,15,0,"-1",99
30,41,3,70,60,17,60,"-1",10
30,42,3,0,70,13,0,"1",0
30,44,3,5,25,19,5,"1",0
30,45,3,10,40,19,10,"1",0
30,47,3,15,11,20,20,"1",-5
30,48,3,30,15,18,30,"-1",0
30,50,3,2,40,38,2,"1",0
31,12,3,100,100,78,100,"-1",0
31,14,3,20,40,41,20,"1",0
31,15,3,100,80,60,80,"-1",20
31,16,3,10,10,26,10,"1",0
31,23,3,60,90,71,50,"1",10
31,24,3,30,30,14,14,"-1",16
31,27,3,100,70,45,100,"-1",0
31,28,3,30,40,20,20,"-1",10
31,29,3,40,70,66,40,"1",0
31,32,3,50,30,33,50,"-1",0
31,33,3,100,100,15,60,"-1",40
31,34,3,90,100,80,70,"-1",20
31,36,3,100,80,26,60,"-1",40
31,37,3,70,70,30,50,"-1",20
31,38,3,100,100,71,100,"-1",0
31,42,3,0,40,13,0,"1",0
31,44,3,30,50,19,19,"-1",11
31,47,3,40,40,20,30,"-1",10
31,50,3,0,50,38,0,"1",0
31,51,3,50,50,26,50,"-1",0
32,3,3,25,15,29,15,"1",10
32,4,3,60,75,78,65,"1",-5
32,12,3,20,60,78,30,"1",-10
32,32,3,80,20,33,83,"-1",-3
32,36,3,80,80,26,56,"-1",24
32,47,3,5,25,20,5,"1",0
32,51,3,15,15,26,22,"1",-7
33,8,3,99,80,75,99,"-1",0
33,12,3,99,90,78,99,"-1",0
33,15,3,90,85,60,90,"-1",0
33,16,3,15,5,26,10,"1",5
33,21,3,20,20,35,35,"1",-15
33,24,3,20,20,14,14,"-1",6
33,25,3,50,40,14,50,"-1",0
33,26,3,99,80,29,99,"-1",0
33,28,3,30,30,20,20,"-1",10
33,30,3,50,30,48,50,"-1",0
33,33,3,5,5,15,5,"1",0
33,37,3,10,10,30,10,"1",0
33,41,3,1,80,17,1,"1",0
33,42,3,100,45,13,100,"-1",0
33,43,3,20,50,81,20,"1",0
33,44,3,0,35,19,1,"1",-1
33,45,3,10,5,19,10,"1",0
33,47,3,100,55,20,100,"-1",0
33,48,3,100,5,18,100,"-1",0
33,49,3,100,20,11,100,"-1",0
33,50,3,1,35,38,1,"1",0
33,51,3,1,50,26,1,"1",0
34,20,3,80,45,40,80,"-1",0
34,24,3,8,8,14,14,"1",-6
34,25,3,0,17,14,0,"1",0
34,28,3,66,66,20,20,"-1",46
34,30,3,0,10,48,0,"1",0
34,33,3,0,19,15,0,"1",0
34,39,3,35,55,43,35,"1",0
34,42,3,35,35,13,10,"-1",25
34,44,3,22,22,19,19,"-1",3
34,47,3,20,30,20,20,"0",0
34,49,3,0,35,11,0,"1",0
34,51,3,50,50,26,50,"-1",0
35,10,3,80,80,56,80,"-1",0
35,12,3,0,45,78,0,"1",0
35,13,3,12,0,22,0,"1",12
35,24,3,32,32,14,14,"-1",18
35,26,3,70,75,29,70,"-1",0
35,28,3,45,45,20,20,"-1",25
35,29,3,85,85,66,85,"-1",0
35,30,3,0,15,48,0,"1",0
35,33,3,100,32,15,100,"-1",0
35,34,3,0,5,80,5,"1",-5
35,36,3,0,60,26,26,"1",-26
35,39,3,65,60,43,65,"-1",0
35,42,3,0,25,13,0,"1",0
35,43,3,0,20,81,0,"1",0
35,44,3,0,4,19,0,"1",0
35,45,3,0,21,19,0,"1",0
35,47,3,0,40,20,0,"1",0
35,48,3,0,24,18,0,"1",0
35,49,3,0,8,11,0,"1",0
35,50,3,0,5,38,0,"1",0
35,51,3,0,54,26,0,"1",0
36,3,3,0,38,29,0,"1",0
36,6,3,95,20,29,95,"-1",0
36,7,3,0,25,45,10,"1",-10
36,8,3,100,85,75,100,"-1",0
36,10,3,80,35,56,80,"-1",0
36,12,3,100,80,78,100,"-1",0
36,13,3,0,17,22,0,"1",0
36,24,3,3,3,14,10,"1",-7
36,26,3,100,70,29,100,"-1",0
36,28,3,19,19,20,20,"1",-1
36,30,3,100,40,48,100,"-1",0
36,31,3,100,70,19,60,"-1",40
36,32,3,10,10,33,10,"1",0
36,33,3,0,48,15,12,"1",-12
36,37,3,90,40,30,90,"-1",0
36,39,3,0,68,43,0,"1",0
36,40,3,0,15,21,0,"1",0
36,41,3,100,70,17,100,"-1",0
36,42,3,99,37,13,99,"-1",0
36,43,3,0,13,81,15,"1",-15
36,44,3,20,20,19,19,"-1",1
36,45,3,95,50,19,95,"-1",0
36,47,3,10,20,20,15,"1",-5
36,48,3,100,30,18,100,"-1",0
36,49,3,60,20,11,25,"-1",35
36,51,3,1,12,26,1,"1",0
37,5,3,40,40,56,56,"1",-16
37,8,3,75,75,75,75,"0",0
37,12,3,70,70,78,78,"1",-8
37,20,3,15,15,40,30,"1",-15
37,24,3,5,5,14,14,"1",-9
37,27,3,80,75,45,60,"-1",20
37,28,3,10,10,20,20,"1",-10
37,33,3,70,70,15,15,"-1",55
37,34,3,40,40,80,80,"1",-40
37,35,3,15,20,17,17,"1",-2
37,38,3,95,95,71,90,"-1",5
37,39,3,30,50,43,40,"1",-10
37,40,3,90,90,21,45,"-1",45
37,41,3,40,40,17,17,"-1",23
37,42,3,75,75,13,45,"-1",30
37,43,3,25,25,81,75,"1",-50
37,44,3,8,8,19,19,"1",-11
37,47,3,15,15,20,20,"1",-5
37,50,3,30,40,38,35,"1",-5
37,51,3,25,25,26,26,"1",-1
38,6,3,95,90,29,90,"-1",5
38,9,3,10,10,29,10,"1",0
38,10,3,20,40,56,20,"1",0
38,16,3,25,40,26,15,"1",10
38,20,3,20,70,40,20,"1",0
38,22,3,100,100,60,100,"-1",0
38,24,3,10,10,14,14,"1",-4
38,25,3,70,70,14,30,"-1",40
38,26,3,70,90,29,70,"-1",0
38,27,3,100,98,45,98,"-1",2
38,28,3,20,20,20,20,"0",0
38,30,3,0,6,48,0,"1",0
38,32,3,50,20,33,50,"-1",0
38,33,3,1,10,15,1,"1",0
38,34,3,5,10,80,5,"1",0
38,38,3,90,80,71,90,"-1",0
38,39,3,0,40,43,0,"1",0
38,40,3,80,80,21,21,"-1",59
38,41,3,20,30,17,8,"-1",12
38,42,3,5,30,13,5,"1",0
38,43,3,5,30,81,15,"1",-10
38,44,3,30,30,19,19,"-1",11
38,49,3,0,5,11,0,"1",0
38,51,3,80,30,26,80,"-1",0
39,4,3,100,100,78,100,"-1",0
39,12,3,0,25,78,0,"1",0
39,26,3,100,80,29,100,"-1",0
39,28,3,12,12,20,20,"1",-8
39,31,3,0,50,19,10,"1",-10
39,33,3,90,70,15,20,"-1",70
39,34,3,15,15,80,80,"1",-65
39,36,3,80,80,26,26,"-1",54
39,39,3,10,40,43,15,"1",-5
39,41,3,100,90,17,100,"-1",0
39,42,3,0,10,13,10,"1",-10
39,44,3,20,20,19,19,"-1",1
39,49,3,0,30,11,0,"1",0
39,50,3,0,40,38,0,"1",0
40,4,3,100,97,78,100,"-1",0
40,8,3,100,73,75,100,"-1",0
40,9,3,36,36,29,29,"-1",7
40,15,3,87,87,60,60,"-1",27
40,16,3,32,75,26,62,"-1",-30
40,20,3,75,60,40,60,"-1",15
40,21,3,100,96,35,100,"-1",0
40,24,3,49,49,14,14,"-1",35
40,25,3,5,32,14,5,"1",0
40,26,3,100,97,29,100,"-1",0
40,27,3,2,23,45,3,"1",-1
40,28,3,67,67,20,20,"-1",47
40,29,3,87,87,66,66,"-1",21
40,30,3,0,48,48,0,"1",0
40,33,3,43,52,15,12,"-1",31
40,34,3,20,20,80,20,"1",0
40,36,3,92,92,26,26,"-1",66
40,38,3,100,95,71,95,"-1",5
40,40,3,0,67,21,0,"1",0
40,41,3,100,85,17,100,"-1",0
40,42,3,100,79,13,100,"-1",0
40,43,3,56,68,81,56,"1",0
40,44,3,70,15,19,70,"-1",0
40,47,3,61,61,20,20,"-1",41
40,50,3,43,76,38,25,"-1",18
40,51,3,45,45,26,26,"-1",19
41,24,3,4,4,14,10,"1",-6
41,25,3,3,18,14,6,"1",-3
41,28,3,19,19,20,20,"1",-1
41,41,3,80,50,17,60,"-1",20
41,42,3,85,65,13,40,"-1",45
41,44,3,30,30,19,20,"-1",10
41,47,3,40,32,20,30,"-1",10
41,50,3,2,40,38,2,"1",0
41,51,3,40,40,26,20,"-1",20
42,24,3,16,16,14,14,"-1",2
42,25,3,17,17,14,14,"-1",3
42,28,3,16,16,20,20,"1",-4
42,39,3,30,50,43,43,"1",-13
42,41,3,0,82,17,0,"1",0
42,43,3,0,27,81,0,"1",0
42,44,3,60,60,19,19,"-1",41
42,47,3,0,26,20,0,"1",0
42,49,3,0,17,11,0,"1",0
42,51,3,100,30,26,100,"-1",0
43,12,3,30,30,78,78,"1",-48
43,14,3,60,50,41,60,"-1",0
43,22,3,100,100,60,60,"-1",40
43,24,3,25,25,14,14,"-1",11
43,28,3,15,15,20,20,"1",-5
43,36,3,20,50,26,26,"1",-6
43,37,3,80,60,30,30,"-1",50
43,42,3,10,50,13,13,"1",-3
43,44,3,35,35,19,19,"-1",16
43,47,3,0,40,20,0,"1",0
43,48,3,100,50,18,100,"-1",0
43,49,3,0,25,11,0,"1",0
43,51,3,0,50,26,0,"1",0
44,16,3,50,40,26,30,"-1",20
44,24,3,14,17,14,14,"0",0
44,28,3,40,40,20,20,"-1",20
44,33,3,65,67,15,15,"-1",50
44,34,3,60,72,80,70,"1",-10
44,35,3,20,18,17,16,"-1",4
44,39,3,45,47,43,45,"-1",0
44,40,3,50,40,21,25,"-1",25
44,42,3,15,19,13,13,"-1",2
44,43,3,40,40,81,80,"1",-40
44,44,3,12,16,19,15,"1",-3
44,47,3,30,60,20,20,"-1",10
44,49,3,0,39,11,0,"1",0
44,50,3,0,10,38,0,"1",0
45,4,3,70,62,78,70,"1",0
45,10,3,70,61,56,65,"-1",5
45,15,3,45,37,60,50,"1",-5
45,16,3,26,42,26,21,"0",5
45,20,3,90,60,40,90,"-1",0
45,21,3,80,60,35,50,"-1",30
45,24,3,10,13,14,12,"1",-2
45,26,3,90,80,29,50,"-1",40
45,28,3,60,65,20,20,"-1",40
45,33,3,20,30,15,10,"-1",10
45,34,3,50,67,80,67,"1",-17
45,39,3,10,45,43,15,"1",-5
45,41,3,70,60,17,40,"-1",30
45,42,3,10,78,13,2,"1",8
45,44,3,20,43,19,20,"-1",0
45,47,3,10,24,20,10,"1",0
45,48,3,10,20,18,10,"1",0
45,49,3,5,30,11,2,"1",3
45,50,3,10,57,38,15,"1",-5
45,51,3,20,42,26,20,"1",0
46,12,3,25,50,78,25,"1",0
46,24,3,5,5,14,14,"1",-9
46,25,3,5,15,14,5,"1",0
46,28,3,25,25,20,20,"-1",5
46,30,3,2,5,48,5,"1",-3
46,36,3,70,70,26,26,"-1",44
46,39,3,20,15,43,40,"1",-20
46,42,3,10,25,13,10,"1",0
46,44,3,25,25,19,19,"-1",6
46,47,3,40,40,20,20,"-1",20
46,50,3,0,15,38,0,"1",0
46,51,3,0,5,26,0,"1",0
47,8,3,100,90,75,95,"-1",5
47,10,3,70,70,56,70,"-1",0
47,12,3,0,75,78,0,"1",0
47,16,3,5,5,26,5,"1",0
47,20,3,20,20,40,20,"1",0
47,21,3,80,65,35,80,"-1",0
47,24,3,5,5,14,5,"1",0
47,25,3,10,13,14,10,"1",0
47,26,3,100,80,29,100,"-1",0
47,27,3,90,65,45,90,"-1",0
47,28,3,10,10,20,15,"1",-5
47,30,3,2,10,48,2,"1",0
47,31,3,5,40,19,5,"1",0
47,33,3,70,30,15,70,"-1",0
47,34,3,90,80,80,90,"-1",0
47,36,3,25,25,26,26,"1",-1
47,37,3,25,50,30,25,"1",0
47,39,3,25,15,43,25,"1",0
47,40,3,0,10,21,0,"1",0
47,41,3,50,50,17,50,"-1",0
47,42,3,10,50,13,5,"1",5
47,44,3,5,5,19,5,"1",0
47,47,3,20,20,20,20,"0",0
47,48,3,15,10,18,15,"1",0
47,50,3,0,45,38,0,"1",0
47,51,3,25,55,26,25,"1",0
48,7,3,85,75,45,95,"-1",-10
48,8,3,25,75,75,20,"1",5
48,9,3,1,10,29,1,"1",0
48,16,3,15,20,26,15,"1",0
48,20,3,18,15,40,15,"1",3
48,24,3,2,2,14,2,"1",0
48,26,3,98,82,29,92,"-1",6
48,28,3,5,5,20,10,"1",-5
48,30,3,0,12,48,2,"1",-2
48,31,3,25,75,19,20,"-1",5
48,43,3,50,50,81,50,"1",0
48,44,3,10,15,19,25,"1",-15
48,51,3,0,50,26,0,"1",0
49,12,3,100,100,78,100,"-1",0
49,16,3,85,85,26,74,"-1",11
49,24,3,20,20,14,14,"-1",6
49,28,3,40,40,20,20,"-1",20
49,29,3,75,75,66,66,"-1",9
49,36,3,70,70,26,26,"-1",44
49,40,3,0,25,21,10,"1",-10
49,42,3,100,100,13,100,"-1",0
49,44,3,0,20,19,20,"1",-20
49,48,3,100,30,18,100,"-1",0
50,24,3,2,11,14,5,"1",-3
50,28,3,13,23,20,20,"1",-7
50,35,3,24,86,17,3,"-1",21
50,44,3,15,15,19,15,"1",0
50,49,3,1,12,11,1,"1",0
50,50,3,0,24,38,0,"1",0
50,51,3,1,9,26,1,"1",0
51,24,3,15,10,14,10,"-1",5
51,26,3,99,89,29,99,"-1",0
51,28,3,90,90,20,30,"-1",60
51,31,3,60,65,19,35,"-1",25
51,33,3,65,20,15,50,"-1",15
51,34,3,30,45,80,55,"1",-25
51,42,3,10,25,13,10,"1",0
51,44,3,30,15,19,20,"-1",10
51,46,3,0,75,45,0,"1",0
51,47,3,5,10,20,5,"1",0
51,48,3,70,60,18,30,"-1",40
51,50,3,0,40,38,0,"1",0
52,3,3,20,40,29,45,"1",-25
52,11,3,100,50,31,100,"-1",0
52,13,3,0,20,22,5,"1",-5
52,31,3,50,30,19,40,"-1",10
52,35,3,0,10,17,10,"1",-10
52,41,3,100,80,17,80,"-1",20
52,42,3,90,93,13,95,"-1",-5
52,51,3,0,20,26,0,"1",0
53,3,3,25,0,29,0,"1",25
53,4,3,25,60,78,40,"1",-15
53,6,3,35,30,29,35,"-1",0
53,10,3,25,25,56,25,"1",0
53,11,3,5,25,31,5,"1",0
53,12,3,90,90,78,80,"-1",10
53,13,3,5,0,22,0,"1",5
53,24,3,5,5,14,14,"1",-9
53,25,3,20,40,14,14,"-1",6
53,26,3,90,30,29,90,"-1",0
53,28,3,40,40,20,20,"-1",20
53,30,3,5,28,48,5,"1",0
53,32,3,100,55,33,100,"-1",0
53,33,3,68,68,15,40,"-1",28
53,34,3,15,15,80,20,"1",-5
53,37,3,35,35,30,30,"-1",5
53,39,3,5,20,43,5,"1",0
53,40,3,0,2,21,10,"1",-10
53,43,3,20,20,81,81,"1",-61
53,44,3,5,5,19,19,"1",-14
53,46,3,80,65,45,80,"-1",0
53,48,3,25,25,18,18,"-1",7
53,49,3,80,18,11,80,"-1",0
53,50,3,20,20,38,38,"1",-18
53,51,3,50,50,26,26,"-1",24
54,1,3,0,20,26,10,"1",-10
54,3,3,90,60,29,80,"-1",10
54,23,3,10,70,71,10,"1",0
54,24,3,5,10,14,10,"1",-5
54,25,3,2,13,14,3,"1",-1
54,28,3,40,50,20,10,"-1",30
54,33,3,80,30,15,70,"-1",10
54,34,3,10,40,80,60,"1",-50
54,35,3,10,15,17,10,"1",0
54,39,3,10,70,43,30,"1",-20
54,42,3,0,20,13,10,"1",-10
54,44,3,0,20,19,10,"1",-10
54,45,3,80,40,19,10,"-1",70
54,47,3,10,30,20,10,"1",0
54,48,3,100,60,18,30,"-1",70
54,50,3,0,20,38,20,"1",-20
55,1,3,1,2,26,10,"1",-9
55,12,3,90,89,78,89,"-1",1
55,24,3,5,20,14,5,"1",0
55,25,3,2,5,14,3,"1",-1
55,28,3,20,45,20,30,"0",-10
55,33,3,88,78,15,95,"-1",-7
55,34,3,10,15,80,65,"1",-55
55,39,3,42,20,43,58,"1",-16
55,42,3,10,45,13,5,"1",5
55,44,3,4,12,19,3,"1",1
55,45,3,37,35,19,8,"-1",29
55,47,3,2,15,20,5,"1",-3
55,48,3,100,70,18,100,"-1",0
55,51,3,99,70,26,100,"-1",-1
56,8,3,10,31,75,40,"1",-30
56,9,3,2,5,29,2,"1",0
56,10,3,50,33,56,50,"1",0
56,14,3,25,35,41,20,"1",5
56,22,3,80,75,60,60,"-1",20
56,27,3,80,80,45,60,"-1",20
56,28,3,25,25,20,20,"-1",5
56,29,3,10,10,66,15,"1",-5
56,31,3,50,50,19,50,"-1",0
56,33,3,50,50,15,50,"-1",0
56,35,3,5,10,17,10,"1",-5
56,36,3,85,84,26,80,"-1",5
56,40,3,0,24,21,0,"1",0
56,41,3,50,50,17,10,"-1",40
56,42,3,0,50,13,0,"1",0
56,43,3,20,20,81,50,"1",-30
56,44,3,20,20,19,20,"-1",0
56,50,3,15,20,38,15,"1",0
56,51,3,85,40,26,60,"-1",25
57,24,3,3,3,14,14,"1",-11
57,26,3,100,90,29,100,"-1",0
57,28,3,40,40,20,20,"-1",20
57,30,3,0,30,48,0,"1",0
57,34,3,10,50,80,30,"1",-20
57,36,3,80,80,26,35,"-1",45
57,37,3,80,80,30,40,"-1",40
57,41,3,20,80,17,7,"-1",13
57,42,3,10,30,13,5,"1",5
57,44,3,5,5,19,20,"1",-15
57,47,3,5,5,20,10,"1",-5
57,48,3,50,17,18,40,"-1",10
57,50,3,20,40,38,20,"1",0
58,16,3,32,25,26,24,"-1",8
58,18,3,45,86,82,72,"1",-27
58,24,3,58,45,14,18,"-1",40
58,26,3,100,99,29,100,"-1",0
58,28,3,12,13,20,20,"1",-8
58,30,3,9,25,48,9,"1",0
58,31,3,12,12,19,25,"1",-13
58,33,3,15,15,15,15,"0",0
58,34,3,9,12,80,9,"1",0
58,39,3,65,47,43,45,"-1",20
58,41,3,68,75,17,25,"-1",43
58,42,3,10,12,13,10,"1",0
58,44,3,15,29,19,15,"1",0
58,45,3,48,85,19,48,"-1",0
58,47,3,10,42,20,10,"1",0
58,49,3,34,24,11,24,"-1",10
58,50,3,0,27,38,0,"1",0
58,51,3,45,76,26,45,"-1",0
59,6,3,40,50,29,30,"-1",10
59,24,3,40,60,14,14,"-1",26
59,25,3,6,30,14,8,"1",-2
59,26,3,97,65,29,97,"-1",0
59,28,3,70,34,20,60,"-1",10
59,29,3,99,70,66,80,"-1",19
59,30,3,4,21,48,9,"1",-5
59,32,3,88,44,33,88,"-1",0
59,34,3,50,60,80,60,"1",-10
59,35,3,56,11,17,31,"-1",25
59,38,3,88,90,71,80,"-1",8
59,41,3,88,99,17,78,"-1",10
59,42,3,88,67,13,77,"-1",11
59,44,3,4,30,19,8,"1",-4
59,47,3,4,9,20,10,"1",-6
59,48,3,6,32,18,14,"1",-8
59,51,3,20,40,26,20,"1",0
60,6,3,60,60,29,29,"-1",31
60,8,3,80,80,75,75,"-1",5
60,12,3,60,60,78,60,"1",0
60,24,3,20,10,14,20,"-1",0
60,26,3,80,80,29,29,"-1",51
60,28,3,80,60,20,80,"-1",0
60,31,3,20,20,19,19,"-1",1
60,34,3,1,5,80,1,"1",0
60,37,3,80,80,30,30,"-1",50
60,41,3,0,60,17,0,"1",0
60,42,3,10,60,13,5,"1",5
60,43,3,20,30,81,80,"1",-60
60,44,3,10,10,19,19,"1",-9
60,47,3,5,70,20,10,"1",-5
60,50,3,5,40,38,5,"1",0
60,51,3,50,40,26,50,"-1",0
61,3,3,50,10,29,10,"-1",40
61,7,3,100,40,45,100,"-1",0
61,24,3,5,5,14,20,"1",-15
61,26,3,100,98,29,100,"-1",0
61,28,3,10,10,20,20,"1",-10
61,33,3,10,40,15,30,"1",-20
61,34,3,70,70,80,80,"1",-10
61,37,3,70,70,30,30,"-1",40
61,38,3,95,95,71,71,"-1",24
61,41,3,20,70,17,10,"-1",10
61,42,3,70,30,13,20,"-1",50
61,44,3,5,15,19,5,"1",0
61,49,3,15,35,11,5,"-1",10
61,50,3,10,30,38,10,"1",0
61,51,3,0,20,26,0,"1",0
62,8,3,100,100,75,100,"-1",0
62,9,3,0,8,29,0,"1",0
62,12,3,5,65,78,5,"1",0
62,13,3,0,15,22,0,"1",0
62,21,3,100,85,35,85,"-1",15
62,24,3,12,19,14,14,"1",-2
62,26,3,100,74,29,100,"-1",0
62,28,3,14,14,20,20,"1",-6
62,34,3,0,12,80,0,"1",0
62,36,3,100,85,26,50,"-1",50
62,37,3,0,42,30,0,"1",0
62,42,3,5,15,13,2,"1",3
62,43,3,0,28,81,0,"1",0
62,44,3,50,50,19,19,"-1",31
62,48,3,0,27,18,10,"1",-10
62,50,3,0,7,38,0,"1",0
63,9,3,41,63,29,13,"-1",28
63,20,3,86,56,40,86,"-1",0
63,24,3,5,12,14,8,"1",-3
63,25,3,59,36,14,37,"-1",22
63,26,3,12,68,29,5,"1",7
63,27,3,32,55,45,32,"1",0
63,28,3,45,45,20,20,"-1",25
63,33,3,78,35,15,65,"-1",13
63,39,3,10,32,43,10,"1",0
63,41,3,42,63,17,32,"-1",10
63,42,3,89,56,13,86,"-1",3
63,44,3,5,13,19,5,"1",0
63,45,3,14,25,19,14,"1",0
63,47,3,21,68,20,10,"-1",11
63,49,3,0,12,11,0,"1",0
64,1,3,1,5,26,4,"1",-3
64,2,3,30,39,20,9,"-1",21
64,4,3,20,50,78,30,"1",-10
64,9,3,3,10,29,18,"1",-15
64,10,3,70,80,56,65,"-1",5
64,11,3,5,17,31,7,"1",-2
64,12,3,75,54,78,65,"1",10
64,13,3,4,10,22,4,"1",0
64,19,3,15,4,21,69,"1",-54
64,22,3,4,10,60,40,"1",-36
64,24,3,1,10,14,2,"1",-1
64,25,3,0,59,14,0,"1",0
64,26,3,40,60,29,10,"-1",30
64,27,3,56,50,45,50,"-1",6
64,28,3,3,34,20,23,"1",-20
64,29,3,50,45,66,34,"1",16
64,30,3,10,16,48,12,"1",-2
64,32,3,4,45,33,12,"1",-8
64,33,3,10,25,15,5,"1",5
64,35,3,3,2,17,1,"1",2
64,36,3,70,50,26,35,"-1",35
64,37,3,38,30,30,1,"-1",37
64,38,3,85,65,71,63,"-1",22
64,39,3,10,15,43,10,"1",0
64,40,3,70,70,21,10,"-1",60
64,41,3,54,78,17,54,"-1",0
64,43,3,1,5,81,17,"1",-16
64,44,3,5,10,19,7,"1",-2
64,45,3,0,19,19,2,"1",-2
64,46,3,6,13,45,7,"1",-1
64,47,3,30,25,20,15,"-1",15
64,49,3,1,20,11,1,"1",0
64,50,3,4,40,38,6,"1",-2
64,51,3,2,15,26,3,"1",-1
65,3,3,0,39,29,0,"1",0
65,12,3,1,90,78,2,"1",-1
65,24,3,1,1,14,10,"1",-9
65,27,3,88,34,45,99,"-1",-11
65,28,3,78,78,20,34,"-1",44
65,29,3,70,70,66,65,"-1",5
65,30,3,0,15,48,0,"1",0
65,33,3,70,30,15,15,"-1",55
65,34,3,0,30,80,60,"1",-60
65,36,3,60,45,26,30,"-1",30
65,42,3,50,40,13,19,"-1",31
65,44,3,60,45,19,45,"-1",15
65,47,3,0,10,20,10,"1",-10
65,49,3,0,17,11,0,"1",0
65,50,3,0,30,38,0,"1",0
66,29,3,20,30,66,50,"1",-30
66,34,3,20,15,80,30,"1",-10
66,40,3,10,30,21,30,"1",-20
66,44,3,30,30,19,30,"-1",0
66,51,3,70,80,26,60,"-1",10
67,12,3,70,50,78,75,"1",-5
67,24,3,2,3,14,11,"1",-9
67,28,3,18,16,20,20,"1",-2
67,34,3,65,70,80,75,"1",-10
67,42,3,45,45,13,15,"-1",30
67,44,3,18,17,19,18,"1",0
68,21,3,100,70,35,95,"-1",5
68,23,3,80,60,71,71,"-1",9
68,24,3,15,15,14,14,"-1",1
68,26,3,30,90,29,30,"-1",0
68,27,3,23,23,45,45,"1",-22
68,28,3,19,19,20,20,"1",-1
68,33,3,36,26,15,15,"-1",21
68,34,3,90,90,80,80,"-1",10
68,36,3,35,35,26,26,"-1",9
68,40,3,3,42,21,3,"1",0
68,41,3,5,45,17,5,"1",0
68,42,3,90,70,13,90,"-1",0
68,44,3,36,36,19,25,"-1",11
69,8,3,65,90,75,60,"1",5
69,9,3,0,10,29,0,"1",0
69,11,3,5,15,31,5,"1",0
69,12,3,100,80,78,100,"-1",0
69,13,3,0,5,22,0,"1",0
69,24,3,65,50,14,45,"-1",20
69,26,3,100,90,29,50,"-1",50
69,28,3,50,50,20,20,"-1",30
69,31,3,25,35,19,15,"-1",10
69,33,3,5,15,15,5,"1",0
69,34,3,0,10,80,50,"1",-50
69,36,3,25,15,26,25,"1",0
69,41,3,10,75,17,5,"1",5
69,42,3,0,65,13,0,"1",0
69,43,3,80,55,81,80,"1",0
69,44,3,0,45,19,0,"1",0
69,45,3,0,60,19,0,"1",0
69,50,3,0,60,38,0,"1",0
69,51,3,0,75,26,0,"1",0
70,8,3,50,50,75,75,"1",-25
70,10,3,45,45,56,56,"1",-11
70,12,3,95,95,78,78,"-1",17
70,19,3,0,50,21,0,"1",0
70,24,3,5,5,14,14,"1",-9
70,26,3,95,95,29,95,"-1",0
70,28,3,19,19,20,20,"1",-1
70,32,3,0,56,33,0,"1",0
70,33,3,5,5,15,15,"1",-10
70,34,3,0,19,80,0,"1",0
70,38,3,85,85,71,71,"-1",14
70,39,3,50,75,43,25,"-1",25
70,40,3,0,55,21,0,"1",0
70,41,3,0,50,17,0,"1",0
70,42,3,0,50,13,0,"1",0
70,43,3,75,75,81,81,"1",-6
70,44,3,60,60,19,19,"-1",41
70,47,3,1,50,20,1,"1",0
70,48,3,0,50,18,0,"1",0
70,50,3,0,35,38,0,"1",0
70,51,3,0,50,26,0,"1",0
71,4,3,100,89,78,100,"-1",0
71,6,3,10,15,29,10,"1",0
71,7,3,100,80,45,100,"-1",0
71,8,3,5,25,75,5,"1",0
71,10,3,25,85,56,15,"1",10
71,24,3,10,10,14,10,"1",0
71,28,3,40,40,20,20,"-1",20
71,32,3,0,20,33,0,"1",0
71,33,3,100,20,15,100,"-1",0
71,40,3,75,75,21,75,"-1",0
71,41,3,100,47,17,100,"-1",0
71,42,3,100,40,13,100,"-1",0
71,44,3,25,45,19,15,"-1",10
71,47,3,0,10,20,0,"1",0
71,49,3,0,12,11,0,"1",0
71,50,3,0,45,38,0,"1",0
71,51,3,0,5,26,0,"1",0
72,4,3,100,80,78,100,"-1",0
72,8,3,10,75,75,5,"1",5
72,24,3,5,14,14,5,"1",0
72,25,3,1,15,14,1,"1",0
72,26,3,5,80,29,5,"1",0
72,28,3,75,60,20,65,"-1",10
72,30,3,0,20,48,0,"1",0
72,31,3,10,5,19,10,"1",0
72,44,3,2,19,19,2,"1",0
72,46,3,0,45,45,0,"1",0
72,47,3,5,60,20,2,"1",3
72,49,3,0,3,11,0,"1",0
73,8,3,90,90,75,80,"-1",10
73,24,3,10,10,14,14,"1",-4
73,26,3,100,90,29,100,"-1",0
73,27,3,40,45,45,40,"1",0
73,28,3,65,65,20,20,"-1",45
73,29,3,80,75,66,60,"-1",20
73,31,3,70,65,19,30,"-1",40
73,33,3,40,40,15,15,"-1",25
73,34,3,5,10,80,50,"1",-45
73,41,3,70,55,17,20,"-1",50
73,42,3,10,15,13,10,"1",0
73,44,3,0,10,19,5,"1",-5
73,45,3,15,15,19,15,"1",0
73,48,3,50,50,18,25,"-1",25
73,50,3,0,15,38,0,"1",0
74,1,3,20,5,26,20,"1",0
74,5,3,50,50,56,50,"1",0
74,12,3,100,95,78,100,"-1",0
74,14,3,2,25,41,2,"1",0
74,15,3,20,50,60,20,"1",0
74,16,3,5,15,26,5,"1",0
74,20,3,100,50,40,100,"-1",0
74,21,3,30,20,35,30,"1",0
74,23,3,75,95,71,70,"-1",5
74,24,3,5,2,14,5,"1",0
74,26,3,100,40,29,100,"-1",0
74,27,3,100,85,45,100,"-1",0
74,28,3,15,15,20,15,"1",0
74,33,3,10,40,15,10,"1",0
74,34,3,1,1,80,1,"1",0
74,36,3,60,60,26,60,"-1",0
74,38,3,95,95,71,95,"-1",0
74,41,3,90,90,17,90,"-1",0
74,42,3,100,90,13,100,"-1",0
74,43,3,0,10,81,0,"1",0
74,44,3,10,8,19,10,"1",0
74,47,3,3,3,20,3,"1",0
75,15,3,25,25,60,40,"1",-15
75,21,3,20,25,35,20,"1",0
75,24,3,5,5,14,14,"1",-9
75,27,3,50,50,45,50,"-1",0
75,28,3,19,19,20,20,"1",-1
75,30,3,0,15,48,15,"1",-15
75,31,3,100,75,19,100,"-1",0
75,33,3,0,10,15,0,"1",0
75,34,3,0,0,80,0,"1",0
75,35,3,0,10,17,0,"1",0
75,39,3,0,30,43,0,"1",0
75,41,3,0,25,17,0,"1",0
75,42,3,25,50,13,25,"-1",0
75,43,3,90,95,81,90,"-1",0
75,44,3,10,10,19,19,"1",-9
75,47,3,10,10,20,20,"1",-10
75,49,3,0,10,11,0,"1",0
75,50,3,20,35,38,20,"1",0
75,51,3,50,50,26,50,"-1",0
76,10,3,34,40,56,34,"1",0
76,12,3,95,95,78,78,"-1",17
76,15,3,10,25,60,20,"1",-10
76,24,3,20,12,14,10,"-1",10
76,28,3,67,60,20,20,"-1",47
76,29,3,80,80,66,70,"-1",10
76,34,3,1,3,80,3,"1",-2
76,35,3,1,24,17,15,"1",-14
76,36,3,60,60,26,20,"-1",40
76,37,3,90,90,30,90,"-1",0
76,39,3,10,28,43,12,"1",-2
76,41,3,78,85,17,60,"-1",18
76,42,3,24,35,13,12,"-1",12
76,48,3,5,12,18,13,"1",-8
76,49,3,1,5,11,2,"1",-1
76,50,3,1,5,38,1,"1",0
77,4,3,70,65,78,65,"1",5
77,8,3,80,87,75,80,"-1",0
77,12,3,50,70,78,50,"1",0
77,26,3,100,74,29,100,"-1",0
77,27,3,25,14,45,50,"1",-25
77,28,3,10,20,20,20,"1",-10
77,33,3,100,43,15,100,"-1",0
77,34,3,9,13,80,15,"1",-6
77,40,3,14,31,21,12,"1",2
77,42,3,20,46,13,10,"-1",10
77,43,3,6,54,81,10,"1",-4
77,44,3,10,8,19,19,"1",-9
77,48,3,100,13,18,100,"-1",0
77,50,3,0,19,38,0,"1",0
78,6,3,20,25,29,25,"1",-5
78,7,3,0,45,45,0,"1",0
78,12,3,50,50,78,50,"1",0
78,14,3,10,15,41,15,"1",-5
78,24,3,10,10,14,10,"1",0
78,25,3,0,20,14,0,"1",0
78,26,3,60,30,29,30,"-1",30
78,28,3,50,50,20,20,"-1",30
78,31,3,10,12,19,10,"1",0
78,33,3,100,60,15,15,"-1",85
78,34,3,10,15,80,15,"1",-5
78,37,3,50,50,30,30,"-1",20
78,41,3,2,10,17,2,"1",0
78,42,3,12,25,13,12,"1",0
78,43,3,60,70,81,60,"1",0
78,44,3,0,35,19,0,"1",0
78,46,3,0,20,45,0,"1",0
78,47,3,0,10,20,0,"1",0
78,49,3,0,22,11,0,"1",0
78,51,3,0,20,26,0,"1",0
79,1,3,0,0,26,28,"1",-28
79,8,3,25,26,75,60,"1",-35
79,24,3,33,33,14,15,"-1",18
79,25,3,0,35,14,0,"1",0
79,27,3,85,90,45,75,"-1",10
79,28,3,34,34,20,20,"-1",14
79,30,3,0,32,48,52,"1",-52
79,33,3,0,0,15,0,"1",0
79,34,3,35,45,80,76,"1",-41
79,39,3,64,58,43,45,"-1",19
79,40,3,0,65,21,0,"1",0
79,41,3,99,25,17,75,"-1",24
79,42,3,90,75,13,76,"-1",14
79,43,3,4,5,81,90,"1",-86
79,44,3,35,35,19,35,"-1",0
80,3,3,0,50,29,0,"1",0
80,6,3,40,30,29,45,"-1",-5
80,7,3,50,65,45,50,"-1",0
80,12,3,100,99,78,99,"-1",1
80,24,3,30,50,14,25,"-1",5
80,25,3,80,50,14,20,"-1",60
80,27,3,15,80,45,20,"1",-5
80,28,3,30,40,20,20,"-1",10
80,30,3,15,30,48,15,"1",0
80,32,3,0,0,33,0,"1",0
80,33,3,75,5,15,50,"-1",25
80,35,3,95,80,17,95,"-1",0
80,36,3,5,5,26,15,"1",-10
80,39,3,95,50,43,95,"-1",0
80,41,3,15,20,17,5,"1",10
80,42,3,100,100,13,13,"-1",87
80,44,3,5,20,19,20,"1",-15
80,45,3,90,50,19,50,"-1",40
80,46,3,0,50,45,0,"1",0
80,47,3,0,5,20,0,"1",0
80,48,3,0,1,18,1,"1",-1
80,49,3,0,2,11,0,"1",0
80,50,3,0,20,38,0,"1",0
80,51,3,0,10,26,0,"1",0
81,4,3,99,99,78,99,"-1",0
81,7,3,99,99,45,99,"-1",0
81,8,3,10,90,75,10,"1",0
81,12,3,99,20,78,99,"-1",0
81,24,3,40,40,14,40,"-1",0
81,28,3,10,10,20,10,"1",0
81,30,3,0,5,48,0,"1",0
81,34,3,0,0,80,0,"1",0
81,37,3,99,60,30,99,"-1",0
81,42,3,99,60,13,99,"-1",0
81,44,3,0,10,19,0,"1",0
81,45,3,0,5,19,0,"1",0
81,49,3,50,30,11,50,"-1",0
81,50,3,0,10,38,0,"1",0
81,51,3,0,10,26,0,"1",0
82,8,3,80,75,75,80,"-1",0
82,24,3,50,40,14,10,"-1",40
82,27,3,2,3,45,20,"1",-18
82,28,3,50,45,20,20,"-1",30
82,33,3,10,25,15,10,"1",0
82,34,3,1,2,80,2,"1",-1
82,36,3,10,60,26,10,"1",0
82,39,3,85,65,43,75,"-1",10
82,41,3,10,40,17,20,"1",-10
82,42,3,50,60,13,20,"-1",30
82,43,3,70,75,81,85,"1",-15
82,44,3,10,10,19,10,"1",0
82,51,3,50,50,26,25,"-1",25
83,8,3,75,95,75,60,"0",15
83,24,3,5,20,14,3,"1",2
83,25,3,40,35,14,20,"-1",20
83,26,3,85,65,29,80,"-1",5
83,28,3,45,75,20,35,"-1",10
83,42,3,35,20,13,30,"-1",5
83,44,3,5,25,19,5,"1",0
83,49,3,2,25,11,1,"1",1
83,50,3,2,32,38,2,"1",0
84,3,3,1,1,29,1,"1",0
84,12,3,90,90,78,90,"-1",0
84,21,3,70,50,35,70,"-1",0
84,24,3,10,10,14,14,"1",-4
84,28,3,10,10,20,20,"1",-10
84,30,3,20,10,48,40,"1",-20
84,33,3,90,50,15,90,"-1",0
84,38,3,99,90,71,99,"-1",0
84,39,3,0,50,43,0,"1",0
84,41,3,50,50,17,30,"-1",20
84,42,3,60,15,13,20,"-1",40
84,44,3,10,10,19,19,"1",-9
84,50,3,5,5,38,5,"1",0
84,51,3,50,50,26,26,"-1",24
85,4,3,70,10,78,90,"1",-20
85,20,3,60,60,40,50,"-1",10
85,24,3,20,20,14,14,"-1",6
85,25,3,30,50,14,20,"-1",10
85,27,3,25,30,45,30,"1",-5
85,28,3,70,70,20,40,"-1",30
85,29,3,60,60,66,60,"1",0
85,32,3,100,60,33,100,"-1",0
85,33,3,20,15,15,20,"-1",0
85,42,3,80,80,13,20,"-1",60
85,44,3,20,30,19,19,"-1",1
85,48,3,20,30,18,20,"-1",0
85,49,3,5,30,11,4,"1",1
85,50,3,10,50,38,15,"1",-5
86,3,3,40,0,29,0,"-1",40
86,7,3,0,30,45,0,"1",0
86,8,3,0,0,75,0,"1",0
86,10,3,0,30,56,0,"1",0
86,12,3,100,71,78,100,"-1",0
86,13,3,30,0,22,0,"-1",30
86,23,3,0,20,71,0,"1",0
86,24,3,0,30,14,0,"1",0
86,27,3,0,5,45,0,"1",0
86,28,3,50,50,20,20,"-1",30
86,29,3,99,99,66,99,"-1",0
86,33,3,99,20,15,99,"-1",0
86,34,3,0,70,80,0,"1",0
86,35,3,50,50,17,50,"-1",0
86,42,3,0,12,13,0,"1",0
86,44,3,0,12,19,0,"1",0
86,45,3,0,60,19,0,"1",0
86,46,3,99,50,45,99,"-1",0
86,47,3,99,67,20,99,"-1",0
86,51,3,0,70,26,0,"1",0
87,12,3,100,100,78,100,"-1",0
87,15,3,60,35,60,60,"0",0
87,21,3,70,65,35,40,"-1",30
87,24,3,6,6,14,14,"1",-8
87,26,3,100,87,29,100,"-1",0
87,28,3,21,21,20,20,"-1",1
87,33,3,100,45,15,100,"-1",0
87,34,3,100,55,80,100,"-1",0
87,38,3,86,86,71,71,"-1",15
87,39,3,67,33,43,67,"-1",0
87,44,3,10,10,19,19,"1",-9
87,45,3,10,14,19,10,"1",0
87,51,3,10,23,26,10,"1",0
88,7,3,30,45,45,40,"1",-10
88,8,3,20,55,75,25,"1",-5
88,12,3,100,100,78,100,"-1",0
88,24,3,5,5,14,10,"1",-5
88,26,3,80,78,29,80,"-1",0
88,27,3,45,40,45,45,"0",0
88,28,3,22,22,20,20,"-1",2
88,30,3,35,30,48,50,"1",-15
88,33,3,20,55,15,22,"-1",-2
88,34,3,65,55,80,70,"1",-5
88,35,3,44,60,17,25,"-1",19
88,39,3,25,33,43,38,"1",-13
88,41,3,40,70,17,25,"-1",15
88,42,3,60,70,13,50,"-1",10
88,43,3,40,60,81,70,"1",-30
88,44,3,20,15,19,20,"-1",0
88,45,3,40,55,19,25,"-1",15
88,48,3,50,25,18,25,"-1",25
88,50,3,15,25,38,28,"1",-13
88,51,3,15,70,26,20,"1",-5
89,8,3,60,60,75,60,"1",0
89,12,3,85,85,78,78,"-1",7
89,21,3,90,90,35,90,"-1",0
89,24,3,30,30,14,14,"-1",16
89,26,3,100,90,29,90,"-1",10
89,28,3,30,30,20,20,"-1",10
89,33,3,45,45,15,35,"-1",10
89,38,3,85,85,71,85,"-1",0
89,39,3,70,60,43,60,"-1",10
89,42,3,10,40,13,10,"1",0
89,44,3,0,23,19,0,"1",0
89,51,3,0,45,26,0,"1",0
90,12,3,95,80,78,85,"-1",10
90,24,3,20,20,14,15,"-1",5
90,26,3,95,95,29,95,"-1",0
90,28,3,65,75,20,40,"-1",25
90,29,3,20,45,66,30,"1",-10
90,33,3,50,20,15,35,"-1",15
90,34,3,75,75,80,75,"1",0
90,38,3,100,90,71,95,"-1",5
90,39,3,65,55,43,60,"-1",5
90,42,3,55,85,13,40,"-1",15
90,43,3,5,15,81,10,"1",-5
90,44,3,40,30,19,10,"-1",30
90,51,3,30,40,26,30,"-1",0
91,3,3,25,0,29,0,"1",25
91,4,3,50,50,78,78,"1",-28
91,9,3,5,5,29,5,"1",0
91,10,3,60,60,56,56,"-1",4
91,11,3,30,40,31,30,"1",0
91,12,3,1,10,78,5,"1",-4
91,15,3,30,20,60,40,"1",-10
91,21,3,60,60,35,40,"-1",20
91,24,3,30,30,14,14,"-1",16
91,25,3,10,25,14,5,"1",5
91,26,3,20,75,29,15,"1",5
91,28,3,5,5,20,20,"1",-15
91,32,3,80,50,33,80,"-1",0
91,34,3,50,50,80,60,"1",-10
91,35,3,50,50,17,40,"-1",10
91,38,3,100,100,71,100,"-1",0
91,40,3,0,50,21,0,"1",0
91,41,3,2,75,17,2,"1",0
91,43,3,50,30,81,50,"1",0
91,44,3,10,40,19,19,"1",-9
91,46,3,0,40,45,0,"1",0
91,47,3,0,10,20,0,"1",0
91,49,3,0,5,11,0,"1",0
92,6,3,30,35,29,30,"-1",0
92,12,3,0,60,78,0,"1",0
92,16,3,20,40,26,30,"1",-10
92,24,3,2,2,14,14,"1",-12
92,26,3,100,80,29,100,"-1",0
92,28,3,50,50,20,20,"-1",30
92,29,3,90,90,66,66,"-1",24
92,33,3,15,50,15,5,"0",10
92,34,3,35,25,80,80,"1",-45
92,36,3,90,90,26,26,"-1",64
92,39,3,2,30,43,2,"1",0
92,42,3,100,70,13,100,"-1",0
92,44,3,1,5,19,3,"1",-2
92,47,3,25,25,20,20,"-1",5
92,49,3,5,20,11,8,"1",-3
93,4,3,100,70,78,100,"-1",0
93,8,3,100,43,75,100,"-1",0
93,21,3,20,20,35,20,"1",0
93,24,3,11,11,14,14,"1",-3
93,26,3,100,80,29,100,"-1",0
93,27,3,30,30,45,30,"1",0
93,28,3,50,50,20,20,"-1",30
93,30,3,100,23,48,100,"-1",0
93,34,3,0,30,80,0,"1",0
93,37,3,50,50,30,50,"-1",0
93,38,3,0,14,71,0,"1",0
93,39,3,0,11,43,0,"1",0
93,41,3,100,40,17,100,"-1",0
93,42,3,100,30,13,100,"-1",0
93,44,3,10,10,19,19,"1",-9
93,48,3,100,30,18,100,"-1",0
93,51,3,50,50,26,26,"-1",24
94,3,3,24,0,29,0,"1",24
94,7,3,0,30,45,0,"1",0
94,8,3,50,80,75,75,"1",-25
94,9,3,10,25,29,10,"1",0
94,10,3,10,35,56,10,"1",0
94,12,3,100,80,78,100,"-1",0
94,13,3,10,0,22,0,"1",10
94,16,3,25,10,26,10,"1",15
94,24,3,10,10,14,10,"1",0
94,28,3,20,20,20,20,"0",0
94,33,3,50,40,15,40,"-1",10
94,34,3,20,30,80,20,"1",0
94,41,3,0,35,17,0,"1",0
94,42,3,50,60,13,50,"-1",0
94,43,3,0,25,81,0,"1",0
94,44,3,20,20,19,20,"-1",0
94,45,3,5,15,19,10,"1",-5
94,48,3,20,40,18,10,"-1",10
94,49,3,0,10,11,1,"1",-1
94,50,3,50,60,38,50,"-1",0
95,3,3,0,50,29,0,"1",0
95,4,3,100,60,78,70,"-1",30
95,12,3,100,80,78,80,"-1",20
95,24,3,20,20,14,20,"-1",0
95,26,3,100,70,29,100,"-1",0
95,28,3,20,20,20,20,"0",0
95,33,3,100,20,15,20,"-1",80
95,35,3,50,50,17,20,"-1",30
95,39,3,30,30,43,30,"1",0
95,40,3,30,30,21,30,"-1",0
95,42,3,0,40,13,0,"1",0
95,43,3,20,30,81,70,"1",-50
95,44,3,20,20,19,20,"-1",0
95,45,3,50,50,19,10,"-1",40
95,48,3,0,15,18,10,"1",-10
95,51,3,0,50,26,0,"1",0
96,8,3,85,85,75,75,"-1",10
96,9,3,1,13,29,1,"1",0
96,24,3,15,15,14,14,"-1",1
96,26,3,99,99,29,99,"-1",0
96,28,3,17,17,20,20,"1",-3
96,30,3,30,10,48,48,"1",-18
96,33,3,100,90,15,90,"-1",10
96,34,3,90,90,80,80,"-1",10
96,41,3,90,60,17,40,"-1",50
96,42,3,20,20,13,13,"-1",7
96,43,3,0,30,81,1,"1",-1
96,44,3,10,10,19,19,"1",-9
96,45,3,5,5,19,19,"1",-14
97,6,3,5,5,29,5,"1",0
97,12,3,100,100,78,78,"-1",22
97,15,3,90,90,60,90,"-1",0
97,18,3,80,80,82,82,"1",-2
97,24,3,33,33,14,14,"-1",19
97,25,3,0,5,14,0,"1",0
97,26,3,100,100,29,100,"-1",0
97,27,3,100,100,45,100,"-1",0
97,28,3,20,20,20,20,"0",0
97,29,3,90,90,66,66,"-1",24
97,30,3,0,5,48,0,"1",0
97,33,3,40,50,15,50,"-1",-10
97,34,3,5,70,80,5,"1",0
97,35,3,99,50,17,99,"-1",0
97,41,3,80,80,17,80,"-1",0
97,42,3,90,90,13,90,"-1",0
97,44,3,20,20,19,19,"-1",1
97,47,3,0,20,20,0,"1",0
97,48,3,0,20,18,5,"1",-5
97,51,3,80,50,26,80,"-1",0
98,32,3,34,30,33,33,"-1",1
98,36,3,30,45,26,20,"-1",10
98,44,3,2,5,19,10,"1",-8
99,1,3,20,12,26,20,"1",0
99,6,3,60,60,29,50,"-1",10
99,7,3,100,78,45,100,"-1",0
99,12,3,89,89,78,89,"-1",0
99,14,3,80,75,41,70,"-1",10
99,15,3,60,76,60,60,"0",0
99,16,3,25,23,26,23,"1",2
99,20,3,65,65,40,65,"-1",0
99,23,3,95,95,71,95,"-1",0
99,24,3,18,18,14,16,"-1",2
99,26,3,100,91,29,100,"-1",0
99,28,3,12,12,20,20,"1",-8
99,29,3,80,75,66,80,"-1",0
99,36,3,93,93,26,50,"-1",43
99,39,3,100,58,43,100,"-1",0
99,41,3,70,68,17,40,"-1",30
99,42,3,50,70,13,50,"-1",0
99,44,3,11,11,19,19,"1",-8
99,48,3,60,60,18,40,"-1",20
99,49,3,10,40,11,10,"1",0
99,50,3,0,55,38,0,"1",0
99,51,3,12,36,26,12,"1",0
100,24,3,15,15,14,15,"-1",0
100,28,3,60,60,20,20,"-1",40
100,34,3,2,5,80,2,"1",0
100,42,3,90,80,13,90,"-1",0
100,44,3,10,15,19,15,"1",-5
100,45,3,10,20,19,10,"1",0
100,49,3,2,5,11,2,"1",0
100,50,3,0,10,38,0,"1",0
