"Participant","Event","Valence","E1","eBR","BR","E2","direction","update"
1,3,3,30,50,29,20,"-1",10
1,24,3,15,15,14,10,"-1",5
1,27,3,80,80,45,70,"-1",10
1,28,3,20,20,20,20,"0",0
1,33,3,70,20,15,60,"-1",10
1,34,3,20,30,80,70,"1",-50
1,35,3,50,50,17,50,"-1",0
1,39,3,30,60,43,20,"1",10
1,40,3,5,30,21,10,"1",-5
1,41,3,80,70,17,60,"-1",20
1,42,3,10,30,13,40,"1",-30
1,44,3,20,20,19,20,"-1",0
1,47,3,90,60,20,90,"-1",0
1,50,3,40,30,38,40,"-1",0
2,3,3,45,0,29,23,"-1",22
2,4,3,99,99,78,99,"-1",0
2,6,3,45,67,29,34,"-1",11
2,7,3,20,80,45,2,"1",18
2,12,3,89,89,78,99,"-1",-10
2,21,3,100,90,35,99,"-1",1
2,25,3,67,45,14,34,"-1",33
2,27,3,68,56,45,78,"-1",-10
2,32,3,24,23,33,89,"1",-65
2,34,3,1,1,80,1,"1",0
2,35,3,90,70,17,2,"-1",88
2,40,3,99,67,21,99,"-1",0
2,41,3,99,80,17,99,"-1",0
2,47,3,1,35,20,2,"1",-1
2,51,3,2,54,26,12,"1",-10
3,12,3,50,85,78,65,"1",-15
3,24,3,23,23,14,25,"-1",-2
3,26,3,100,85,29,100,"-1",0
3,27,3,60,85,45,50,"-1",10
3,28,3,15,15,20,15,"1",0
3,29,3,65,85,66,50,"1",15
3,33,3,100,35,15,0,"-1",100
3,34,3,23,23,80,75,"1",-52
3,35,3,0,75,17,0,"1",0
3,38,3,100,100,71,50,"-1",50
3,41,3,100,65,17,100,"-1",0
3,42,3,5,20,13,15,"1",-10
3,43,3,90,85,81,100,"-1",-10
3,44,3,100,25,19,25,"-1",75
3,47,3,10,20,20,10,"1",0
3,49,3,0,10,11,0,"1",0
4,3,3,0,15,29,0,"1",0
4,5,3,75,50,56,50,"-1",25
4,6,3,85,62,29,80,"-1",5
4,7,3,0,30,45,0,"1",0
4,13,3,0,12,22,0,"1",0
4,24,3,15,7,14,14,"-1",1
4,28,3,10,10,20,20,"1",-10
4,36,3,75,82,26,60,"-1",15
4,39,3,50,40,43,85,"-1",-35
4,42,3,25,35,13,20,"-1",5
4,44,3,10,10,19,20,"1",-10
4,45,3,50,45,19,50,"-1",0
4,47,3,0,20,20,0,"1",0
4,49,3,15,20,11,10,"-1",5
5,8,3,100,100,75,62,"-1",38
5,12,3,90,90,78,76,"-1",14
5,24,3,12,20,14,4,"1",8
5,28,3,40,43,20,7,"-1",33
5,44,3,8,13,19,1,"1",7
5,48,3,2,8,18,16,"1",-14
5,50,3,5,65,38,17,"1",-12
5,51,3,5,37,26,16,"1",-11
6,7,3,70,55,45,25,"-1",45
6,9,3,15,50,29,10,"1",5
6,12,3,75,75,78,75,"1",0
6,16,3,25,5,26,15,"1",10
6,24,3,10,10,14,10,"1",0
6,26,3,90,75,29,99,"-1",-9
6,28,3,20,20,20,10,"0",10
6,29,3,99,40,66,99,"-1",0
6,31,3,80,75,19,50,"-1",30
6,32,3,2,20,33,80,"1",-78
6,33,3,1,25,15,1,"1",0
6,36,3,90,90,26,10,"-1",80
6,37,3,50,75,30,30,"-1",20
6,38,3,25,15,71,75,"1",-50
6,39,3,90,70,43,99,"-1",-9
6,41,3,70,40,17,50,"-1",20
6,42,3,1,30,13,20,"1",-19
6,44,3,15,15,19,10,"1",5
6,47,3,20,10,20,15,"0",5
6,51,3,60,50,26,20,"-1",40
7,3,3,0,40,29,0,"1",0
7,28,3,45,45,20,30,"-1",15
7,30,3,0,35,48,0,"1",0
7,31,3,50,50,19,70,"-1",-20
7,32,3,80,20,33,80,"-1",0
7,33,3,80,65,15,30,"-1",50
7,35,3,40,50,17,50,"-1",-10
7,41,3,80,30,17,50,"-1",30
7,42,3,20,25,13,65,"-1",-45
7,44,3,50,50,19,60,"-1",-10
7,47,3,0,20,20,0,"1",0
7,50,3,0,15,38,0,"1",0
8,15,3,95,66,60,90,"-1",5
8,16,3,10,30,26,20,"1",-10
8,21,3,15,40,35,30,"1",-15
8,24,3,10,15,14,10,"1",0
8,26,3,0,75,29,10,"1",-10
8,28,3,60,60,20,30,"-1",30
8,36,3,60,70,26,15,"-1",45
8,37,3,90,70,30,40,"-1",50
8,41,3,100,88,17,100,"-1",0
8,42,3,100,50,13,15,"-1",85
8,44,3,20,30,19,20,"-1",0
8,45,3,20,40,19,20,"-1",0
8,47,3,20,60,20,20,"0",0
8,48,3,100,30,18,80,"-1",20
9,24,3,10,18,14,10,"1",0
9,26,3,100,85,29,85,"-1",15
9,27,3,3,30,45,10,"1",-7
9,28,3,10,10,20,20,"1",-10
9,29,3,60,70,66,50,"1",10
9,33,3,5,20,15,20,"1",-15
9,34,3,60,65,80,60,"1",0
9,35,3,60,30,17,30,"-1",30
9,36,3,20,30,26,20,"1",0
9,37,3,70,80,30,30,"-1",40
9,38,3,30,40,71,20,"1",10
9,42,3,20,40,13,5,"-1",15
9,44,3,3,11,19,10,"1",-7
9,47,3,1,30,20,1,"1",0
9,48,3,99,29,18,80,"-1",19
9,51,3,10,35,26,10,"1",0
10,1,3,40,40,26,26,"-1",14
10,4,3,100,75,78,75,"-1",25
10,24,3,30,30,14,20,"-1",10
10,26,3,100,75,29,100,"-1",0
10,27,3,45,30,45,40,"0",5
10,28,3,23,23,20,20,"-1",3
10,29,3,50,40,66,56,"1",-6
10,31,3,75,50,19,60,"-1",15
10,33,3,30,30,15,25,"-1",5
10,35,3,0,30,17,10,"1",-10
10,36,3,20,20,26,20,"1",0
10,38,3,95,95,71,95,"-1",0
10,41,3,75,40,17,75,"-1",0
10,42,3,100,15,13,95,"-1",5
10,43,3,75,50,81,80,"1",-5
10,44,3,10,10,19,20,"1",-10
10,47,3,10,20,20,10,"1",0
10,51,3,35,50,26,20,"-1",15
11,8,3,50,60,75,40,"1",10
11,12,3,70,70,78,50,"1",20
11,24,3,15,20,14,20,"-1",-5
11,26,3,95,80,29,25,"-1",70
11,28,3,80,70,20,50,"-1",30
11,30,3,10,20,48,45,"1",-35
11,31,3,10,15,19,80,"1",-70
11,33,3,10,15,15,40,"1",-30
11,34,3,80,65,80,75,"0",5
11,41,3,60,50,17,80,"-1",-20
11,42,3,80,75,13,50,"-1",30
11,44,3,5,25,19,19,"1",-14
11,45,3,60,40,19,25,"-1",35
11,48,3,5,10,18,20,"1",-15
11,49,3,3,5,11,5,"1",-2
12,3,3,40,10,29,5,"-1",35
12,6,3,60,50,29,50,"-1",10
12,8,3,99,75,75,99,"-1",0
12,9,3,30,30,29,50,"-1",-20
12,12,3,100,100,78,100,"-1",0
12,13,3,10,2,22,5,"1",5
12,16,3,15,10,26,10,"1",5
12,20,3,10,20,40,10,"1",0
12,24,3,10,10,14,20,"1",-10
12,25,3,75,50,14,20,"-1",55
12,27,3,15,30,45,10,"1",5
12,28,3,10,10,20,14,"1",-4
12,30,3,10,10,48,10,"1",0
12,31,3,60,60,19,50,"-1",10
12,32,3,75,25,33,75,"-1",0
12,33,3,10,50,15,15,"1",-5
12,34,3,10,10,80,10,"1",0
12,35,3,1,25,17,1,"1",0
12,37,3,60,60,30,20,"-1",40
12,39,3,0,30,43,1,"1",-1
12,40,3,2,10,21,10,"1",-8
12,41,3,0,40,17,10,"1",-10
12,42,3,2,25,13,10,"1",-8
12,43,3,100,75,81,100,"-1",0
12,44,3,60,40,19,20,"-1",40
12,47,3,50,50,20,50,"-1",0
12,48,3,50,25,18,25,"-1",25
12,49,3,1,10,11,10,"1",-9
13,10,3,90,70,56,75,"-1",15
13,24,3,3,29,14,0,"1",3
13,25,3,2,5,14,9,"1",-7
13,26,3,0,75,29,0,"1",0
13,28,3,17,50,20,25,"1",-8
13,30,3,0,34,48,0,"1",0
13,33,3,30,60,15,20,"-1",10
13,34,3,55,45,80,80,"1",-25
13,37,3,29,29,30,30,"1",-1
13,38,3,70,80,71,85,"1",-15
13,39,3,0,70,43,0,"1",0
13,41,3,45,67,17,35,"-1",10
13,43,3,100,100,81,100,"-1",0
13,44,3,1,12,19,20,"1",-19
13,45,3,5,10,19,1,"1",4
13,47,3,1,38,20,20,"1",-19
13,48,3,50,30,18,25,"-1",25
13,49,3,0,13,11,0,"1",0
13,51,3,50,50,26,26,"-1",24
14,3,3,10,30,29,10,"1",0
14,7,3,0,40,45,0,"1",0
14,9,3,20,20,29,20,"1",0
14,12,3,100,89,78,80,"-1",20
14,21,3,80,80,35,70,"-1",10
14,24,3,4,5,14,30,"1",-26
14,28,3,60,60,20,20,"-1",40
14,29,3,99,80,66,80,"-1",19
14,31,3,10,50,19,88,"1",-78
14,34,3,50,50,80,50,"1",0
14,36,3,70,70,26,50,"-1",20
14,38,3,100,85,71,86,"-1",14
14,41,3,90,20,17,50,"-1",40
14,42,3,100,60,13,89,"-1",11
14,44,3,26,30,19,10,"-1",16
14,47,3,30,50,20,25,"-1",5
14,50,3,20,40,38,40,"1",-20
14,51,3,60,60,26,16,"-1",44
15,7,3,0,30,45,0,"1",0
15,23,3,100,100,71,100,"-1",0
15,24,3,10,10,14,10,"1",0
15,26,3,90,90,29,100,"-1",-10
15,28,3,40,40,20,40,"-1",0
15,29,3,78,78,66,80,"-1",-2
15,33,3,100,25,15,100,"-1",0
15,34,3,5,10,80,40,"1",-35
15,36,3,87,87,26,15,"-1",72
15,41,3,0,80,17,0,"1",0
15,44,3,11,40,19,10,"1",1
15,48,3,12,12,18,10,"1",2
15,49,3,5,15,11,5,"1",0
16,3,3,25,0,29,0,"1",25
16,7,3,50,50,45,50,"-1",0
16,8,3,25,75,75,25,"1",0
16,9,3,50,35,29,50,"-1",0
16,12,3,90,60,78,90,"-1",0
16,24,3,15,15,14,15,"-1",0
16,25,3,0,35,14,10,"1",-10
16,26,3,100,90,29,100,"-1",0
16,27,3,60,60,45,30,"-1",30
16,28,3,25,25,20,15,"-1",10
16,30,3,0,33,48,0,"1",0
16,31,3,50,50,19,25,"-1",25
16,32,3,0,50,33,90,"1",-90
16,33,3,80,50,15,30,"-1",50
16,34,3,10,10,80,20,"1",-10
16,35,3,50,35,17,50,"-1",0
16,36,3,0,50,26,0,"1",0
16,41,3,15,25,17,25,"1",-10
16,42,3,10,25,13,20,"1",-10
16,44,3,5,15,19,25,"1",-20
16,45,3,0,15,19,0,"1",0
16,46,3,0,35,45,0,"1",0
16,48,3,25,35,18,25,"-1",0
16,51,3,10,50,26,10,"1",0
17,3,3,23,7,29,7,"1",16
17,7,3,32,65,45,76,"1",-44
17,8,3,50,53,75,76,"1",-26
17,10,3,79,89,56,34,"-1",45
17,24,3,46,56,14,23,"-1",23
17,25,3,13,59,14,14,"1",-1
17,28,3,66,66,20,72,"-1",-6
17,30,3,7,21,48,12,"1",-5
17,31,3,25,32,19,87,"-1",-62
17,41,3,80,85,17,65,"-1",15
17,42,3,90,85,13,74,"-1",16
17,43,3,90,84,81,90,"-1",0
17,44,3,9,9,19,12,"1",-3
17,47,3,4,5,20,4,"1",0
17,49,3,0,5,11,0,"1",0
18,6,3,10,15,29,15,"1",-5
18,21,3,89,79,35,79,"-1",10
18,24,3,29,29,14,20,"-1",9
18,25,3,17,12,14,60,"-1",-43
18,28,3,37,37,20,25,"-1",12
18,34,3,0,25,80,20,"1",-20
18,35,3,12,7,17,10,"1",2
18,42,3,15,23,13,25,"-1",-10
18,44,3,15,19,19,10,"1",5
18,48,3,100,55,18,100,"-1",0
19,8,3,56,90,75,65,"1",-9
19,21,3,70,64,35,78,"-1",-8
19,24,3,19,20,14,11,"-1",8
19,25,3,44,42,14,54,"-1",-10
19,28,3,65,67,20,34,"-1",31
19,33,3,90,90,15,65,"-1",25
19,34,3,45,54,80,56,"1",-11
19,36,3,40,76,26,56,"-1",-16
19,37,3,67,48,30,57,"-1",10
19,42,3,99,79,13,78,"-1",21
19,44,3,3,10,19,10,"1",-7
19,47,3,11,36,20,21,"1",-10
19,49,3,20,30,11,11,"-1",9
19,50,3,10,20,38,11,"1",-1
19,51,3,57,45,26,24,"-1",33
20,7,3,50,45,45,45,"-1",5
20,8,3,100,80,75,90,"-1",10
20,10,3,80,80,56,50,"-1",30
20,12,3,100,100,78,100,"-1",0
20,24,3,9,12,14,20,"1",-11
20,26,3,100,100,29,100,"-1",0
20,27,3,0,20,45,20,"1",-20
20,28,3,10,10,20,20,"1",-10
20,29,3,90,90,66,60,"-1",30
20,31,3,0,34,19,100,"1",-100
20,33,3,100,90,15,10,"-1",90
20,36,3,85,80,26,50,"-1",35
20,41,3,50,30,17,50,"-1",0
20,43,3,80,40,81,10,"1",70
20,44,3,20,20,19,19,"-1",1
20,47,3,0,10,20,10,"1",-10
20,49,3,0,20,11,10,"1",-10
20,50,3,0,10,38,0,"1",0
21,8,3,100,70,75,100,"-1",0
21,12,3,100,100,78,100,"-1",0
21,24,3,15,15,14,19,"-1",-4
21,27,3,13,20,45,20,"1",-7
21,28,3,20,20,20,20,"0",0
21,34,3,60,60,80,40,"1",20
21,38,3,100,90,71,100,"-1",0
21,39,3,60,70,43,60,"-1",0
21,42,3,0,40,13,0,"1",0
21,44,3,20,20,19,20,"-1",0
21,48,3,20,24,18,30,"-1",-10
21,50,3,0,70,38,0,"1",0
21,51,3,0,60,26,0,"1",0
22,1,3,68,35,26,60,"-1",8
22,8,3,60,70,75,70,"1",-10
22,26,3,40,40,29,20,"-1",20
22,27,3,25,25,45,50,"1",-25
22,30,3,5,10,48,10,"1",-5
22,33,3,2,2,15,27,"1",-25
22,42,3,55,70,13,20,"-1",35
22,43,3,60,43,81,90,"1",-30
22,45,3,6,12,19,12,"1",-6
22,48,3,0,12,18,0,"1",0
22,51,3,50,26,26,50,"-1",0
23,8,3,80,80,75,80,"-1",0
23,10,3,50,60,56,50,"1",0
23,24,3,100,20,14,20,"-1",80
23,25,3,20,30,14,50,"-1",-30
23,28,3,16,16,20,20,"1",-4
23,30,3,100,50,48,50,"-1",50
23,36,3,50,50,26,80,"-1",-30
23,44,3,20,20,19,20,"-1",0
23,47,3,30,30,20,30,"-1",0
23,48,3,50,30,18,50,"-1",0
23,49,3,30,20,11,50,"-1",-20
23,51,3,50,50,26,30,"-1",20
24,8,3,99,57,75,99,"-1",0
24,9,3,70,30,29,20,"-1",50
24,12,3,100,66,78,80,"-1",20
24,15,3,70,33,60,60,"-1",10
24,19,3,60,50,21,70,"-1",-10
24,20,3,85,45,40,70,"-1",15
24,21,3,30,45,35,12,"1",18
24,24,3,7,17,14,18,"1",-11
24,27,3,90,85,45,90,"-1",0
24,28,3,90,60,20,40,"-1",50
24,29,3,99,65,66,80,"-1",19
24,33,3,80,40,15,50,"-1",30
24,34,3,30,20,80,30,"1",0
24,35,3,65,35,17,20,"-1",45
24,37,3,13,20,30,20,"1",-7
24,41,3,70,50,17,70,"-1",0
24,42,3,0,30,13,80,"1",-80
24,44,3,0,35,19,30,"1",-30
24,47,3,90,40,20,40,"-1",50
24,51,3,0,33,26,0,"1",0
25,1,3,100,20,26,90,"-1",10
25,2,3,80,40,20,80,"-1",0
25,4,3,100,80,78,100,"-1",0
25,5,3,100,100,56,100,"-1",0
25,8,3,100,89,75,100,"-1",0
25,9,3,10,60,29,20,"1",-10
25,10,3,100,20,56,100,"-1",0
25,11,3,100,10,31,80,"-1",20
25,12,3,100,70,78,100,"-1",0
25,13,3,0,2,22,0,"1",0
25,21,3,60,60,35,60,"-1",0
25,24,3,10,4,14,10,"1",0
25,25,3,100,70,14,100,"-1",0
25,26,3,100,70,29,100,"-1",0
25,29,3,99,99,66,100,"-1",-1
25,30,3,100,20,48,40,"-1",60
25,31,3,100,80,19,0,"-1",100
25,32,3,0,45,33,0,"1",0
25,33,3,100,100,15,100,"-1",0
25,38,3,100,95,71,100,"-1",0
25,39,3,100,12,43,100,"-1",0
25,41,3,40,40,17,40,"-1",0
25,42,3,40,40,13,20,"-1",20
25,43,3,100,80,81,100,"-1",0
25,44,3,10,10,19,10,"1",0
25,45,3,100,20,19,100,"-1",0
25,47,3,10,20,20,10,"1",0
25,48,3,100,30,18,100,"-1",0
25,50,3,0,15,38,0,"1",0
26,15,3,50,50,60,90,"1",-40
26,21,3,100,90,35,100,"-1",0
26,24,3,8,5,14,15,"1",-7
26,25,3,0,10,14,0,"1",0
26,27,3,30,40,45,40,"1",-10
26,28,3,60,60,20,20,"-1",40
26,30,3,0,25,48,0,"1",0
26,31,3,10,30,19,20,"1",-10
26,33,3,5,25,15,10,"1",-5
26,39,3,0,20,43,0,"1",0
26,40,3,0,10,21,0,"1",0
26,41,3,50,5,17,50,"-1",0
26,42,3,5,60,13,5,"1",0
26,43,3,70,40,81,90,"1",-20
26,44,3,10,10,19,15,"1",-5
26,45,3,0,1,19,70,"1",-70
26,47,3,10,25,20,20,"1",-10
26,48,3,5,10,18,20,"1",-15
26,51,3,50,50,26,20,"-1",30
27,3,3,40,0,29,0,"-1",40
27,8,3,100,98,75,100,"-1",0
27,10,3,50,70,56,70,"1",-20
27,15,3,100,90,60,99,"-1",1
27,21,3,80,80,35,100,"-1",-20
27,24,3,12,12,14,11,"1",1
27,25,3,0,70,14,0,"1",0
27,26,3,100,98,29,100,"-1",0
27,28,3,60,60,20,20,"-1",40
27,30,3,0,54,48,0,"1",0
27,34,3,12,12,80,25,"1",-13
27,39,3,90,77,43,20,"-1",70
27,40,3,0,35,21,0,"1",0
27,42,3,10,70,13,20,"1",-10
27,44,3,20,30,19,12,"-1",8
27,45,3,0,12,19,0,"1",0
28,3,3,5,30,29,20,"1",-15
28,4,3,100,90,78,100,"-1",0
28,11,3,50,25,31,10,"-1",40
28,24,3,19,20,14,17,"-1",2
28,25,3,30,45,14,10,"-1",20
28,28,3,20,15,20,18,"0",2
28,30,3,0,8,48,10,"1",-10
28,34,3,90,90,80,70,"-1",20
28,35,3,40,40,17,30,"-1",10
28,37,3,30,30,30,30,"0",0
28,42,3,0,50,13,0,"1",0
28,44,3,14,20,19,20,"1",-6
28,47,3,60,50,20,40,"-1",20
28,48,3,80,60,18,60,"-1",20
28,49,3,50,30,11,10,"-1",40
28,50,3,50,60,38,50,"-1",0
28,51,3,70,60,26,76,"-1",-6
29,1,3,5,5,26,52,"1",-47
29,8,3,50,56,75,48,"1",2
29,15,3,56,60,60,23,"1",33
29,20,3,85,80,40,45,"-1",40
29,28,3,45,50,20,45,"-1",0
29,30,3,45,40,48,80,"1",-35
30,4,3,10,55,78,30,"1",-20
30,8,3,85,85,75,80,"-1",5
30,9,3,25,25,29,10,"1",15
30,12,3,95,95,78,80,"-1",15
30,24,3,14,14,14,19,"0",-5
30,28,3,20,20,20,19,"0",1
30,30,3,15,25,48,25,"1",-10
30,32,3,6,6,33,33,"1",-27
30,33,3,42,42,15,64,"-1",-22
30,34,3,75,75,80,75,"1",0
30,37,3,75,75,30,50,"-1",25
30,38,3,100,100,71,100,"-1",0
30,41,3,80,61,17,64,"-1",16
30,42,3,90,58,13,35,"-1",55
30,44,3,22,22,19,12,"-1",10
30,47,3,13,13,20,10,"1",3
30,48,3,40,43,18,23,"-1",17
30,51,3,39,39,26,20,"-1",19
31,8,3,90,90,75,80,"-1",10
31,12,3,80,80,78,88,"-1",-8
31,13,3,10,0,22,0,"1",10
31,24,3,30,30,14,13,"-1",17
31,25,3,30,44,14,15,"-1",15
31,26,3,100,90,29,80,"-1",20
31,27,3,80,74,45,20,"-1",60
31,28,3,10,10,20,19,"1",-9
31,30,3,5,14,48,25,"1",-20
31,33,3,70,30,15,75,"-1",-5
31,34,3,30,24,80,80,"1",-50
31,37,3,80,80,30,25,"-1",55
31,38,3,95,95,71,85,"-1",10
31,39,3,50,24,43,75,"-1",-25
31,41,3,45,65,17,40,"-1",5
31,43,3,60,50,81,100,"1",-40
31,44,3,17,17,19,17,"1",0
31,45,3,35,15,19,25,"-1",10
31,51,3,70,70,26,75,"-1",-5
32,1,3,50,60,26,42,"-1",8
32,3,3,20,60,29,34,"1",-14
32,18,3,90,80,82,56,"-1",34
32,21,3,80,100,35,26,"-1",54
32,24,3,0,23,14,34,"1",-34
32,27,3,90,100,45,75,"-1",15
32,33,3,10,40,15,45,"1",-35
32,37,3,60,60,30,45,"-1",15
32,38,3,100,100,71,35,"-1",65
32,39,3,0,36,43,19,"1",-19
32,42,3,44,37,13,37,"-1",7
32,43,3,50,50,81,35,"1",15
32,48,3,0,3,18,56,"1",-56
32,49,3,15,40,11,26,"-1",-11
33,4,3,70,50,78,55,"1",15
33,8,3,100,90,75,100,"-1",0
33,24,3,15,15,14,15,"-1",0
33,26,3,100,80,29,100,"-1",0
33,32,3,30,15,33,90,"1",-60
33,33,3,40,50,15,40,"-1",0
33,40,3,5,25,21,10,"1",-5
33,42,3,50,20,13,40,"-1",10
33,43,3,80,50,81,90,"1",-10
33,44,3,20,20,19,20,"-1",0
33,45,3,2,5,19,3,"1",-1
33,47,3,10,60,20,20,"1",-10
33,50,3,40,20,38,40,"-1",0
33,51,3,5,80,26,5,"1",0
34,3,3,0,25,29,5,"1",-5
34,4,3,100,95,78,75,"-1",25
34,8,3,80,68,75,80,"-1",0
34,12,3,100,100,78,80,"-1",20
34,24,3,10,36,14,15,"1",-5
34,25,3,0,25,14,5,"1",-5
34,26,3,100,80,29,85,"-1",15
34,28,3,50,50,20,12,"-1",38
34,29,3,95,85,66,40,"-1",55
34,30,3,45,59,48,75,"1",-30
34,33,3,100,5,15,5,"-1",95
34,34,3,1,7,80,5,"1",-4
34,37,3,75,50,30,15,"-1",60
34,38,3,100,98,71,85,"-1",15
34,41,3,85,95,17,60,"-1",25
34,42,3,10,12,13,15,"1",-5
34,44,3,0,15,19,15,"1",-15
34,47,3,0,25,20,0,"1",0
34,49,3,0,15,11,0,"1",0
34,50,3,0,7,38,0,"1",0
34,51,3,0,25,26,5,"1",-5
35,10,3,30,60,56,30,"1",0
35,16,3,80,45,26,80,"-1",0
35,22,3,80,70,60,30,"-1",50
35,23,3,90,75,71,100,"-1",-10
35,24,3,55,30,14,30,"-1",25
35,27,3,75,75,45,75,"-1",0
35,28,3,35,60,20,20,"-1",15
35,34,3,70,60,80,75,"1",-5
35,36,3,75,40,26,50,"-1",25
35,39,3,0,75,43,0,"1",0
35,42,3,0,60,13,0,"1",0
35,44,3,40,20,19,20,"-1",20
35,48,3,50,40,18,20,"-1",30
35,49,3,0,10,11,0,"1",0
35,50,3,0,70,38,0,"1",0
35,51,3,0,60,26,0,"1",0
36,29,3,90,90,66,79,"-1",11
36,34,3,1,13,80,35,"1",-34
36,48,3,14,24,18,23,"1",-9
36,51,3,35,67,26,36,"-1",-1
37,4,3,100,80,78,100,"-1",0
37,7,3,0,56,45,5,"1",-5
37,14,3,10,10,41,10,"1",0
37,15,3,65,45,60,45,"-1",20
37,21,3,25,25,35,25,"1",0
37,23,3,90,60,71,80,"-1",10
37,24,3,15,15,14,20,"-1",-5
37,26,3,80,65,29,100,"-1",-20
37,27,3,15,30,45,25,"1",-10
37,28,3,23,25,20,25,"-1",-2
37,29,3,35,45,66,60,"1",-25
37,32,3,100,25,33,100,"-1",0
37,33,3,100,40,15,100,"-1",0
37,34,3,4,11,80,0,"1",4
37,36,3,75,75,26,65,"-1",10
37,37,3,85,85,30,69,"-1",16
37,39,3,100,50,43,100,"-1",0
37,40,3,100,55,21,100,"-1",0
37,41,3,100,70,17,80,"-1",20
37,42,3,15,38,13,60,"-1",-45
37,43,3,100,80,81,100,"-1",0
37,44,3,5,5,19,10,"1",-5
37,45,3,15,28,19,5,"1",10
37,47,3,0,22,20,0,"1",0
37,50,3,0,40,38,0,"1",0
37,51,3,60,60,26,60,"-1",0
38,9,3,50,11,29,50,"-1",0
38,25,3,5,66,14,25,"1",-20
38,27,3,1,13,45,5,"1",-4
38,36,3,20,43,26,15,"1",5
38,41,3,100,70,17,100,"-1",0
38,42,3,100,80,13,45,"-1",55
38,43,3,36,45,81,31,"1",5
38,48,3,5,25,18,1,"1",4
38,51,3,50,50,26,50,"-1",0
39,3,3,20,0,29,10,"1",10
39,5,3,10,10,56,30,"1",-20
39,11,3,60,60,31,20,"-1",40
39,13,3,15,10,22,10,"1",5
39,24,3,30,20,14,25,"-1",5
39,28,3,20,15,20,20,"0",0
39,30,3,30,40,48,30,"1",0
39,31,3,100,90,19,10,"-1",90
39,35,3,50,40,17,70,"-1",-20
39,44,3,0,5,19,10,"1",-10
39,46,3,50,40,45,40,"-1",10
39,47,3,20,25,20,20,"0",0
39,48,3,10,60,18,20,"1",-10
39,51,3,90,70,26,80,"-1",10
40,1,3,50,50,26,50,"-1",0
40,3,3,0,75,29,0,"1",0
40,6,3,0,20,29,0,"1",0
40,9,3,15,20,29,0,"1",15
40,10,3,99,99,56,99,"-1",0
40,11,3,0,30,31,0,"1",0
40,12,3,100,100,78,99,"-1",1
40,13,3,0,6,22,0,"1",0
40,15,3,75,75,60,80,"-1",-5
40,16,3,0,0,26,0,"1",0
40,17,3,0,60,43,0,"1",0
40,19,3,0,30,21,0,"1",0
40,20,3,0,50,40,0,"1",0
40,21,3,80,80,35,80,"-1",0
40,24,3,98,98,14,75,"-1",23
40,25,3,0,60,14,0,"1",0
40,26,3,0,98,29,0,"1",0
40,27,3,25,25,45,75,"1",-50
40,28,3,99,99,20,75,"-1",24
40,30,3,0,50,48,0,"1",0
40,31,3,99,50,19,0,"-1",99
40,32,3,15,10,33,20,"1",-5
40,33,3,25,50,15,15,"-1",10
40,35,3,0,80,17,15,"1",-15
40,39,3,0,80,43,0,"1",0
40,41,3,97,97,17,80,"-1",17
40,42,3,99,95,13,80,"-1",19
40,43,3,99,80,81,98,"-1",1
40,44,3,75,50,19,80,"-1",-5
40,46,3,15,80,45,15,"1",0
40,47,3,0,30,20,25,"1",-25
40,48,3,15,15,18,0,"1",15
40,49,3,0,0,11,0,"1",0
40,50,3,0,50,38,0,"1",0
40,51,3,0,45,26,0,"1",0
41,8,3,90,90,75,55,"-1",35
41,12,3,0,98,78,0,"1",0
41,24,3,30,40,14,20,"-1",10
41,26,3,99,89,29,90,"-1",9
41,28,3,30,29,20,19,"-1",11
41,32,3,100,70,33,99,"-1",1
41,33,3,70,80,15,40,"-1",30
41,37,3,10,15,30,20,"1",-10
41,38,3,70,78,71,90,"1",-20
41,41,3,80,40,17,95,"-1",-15
41,42,3,100,88,13,90,"-1",10
41,44,3,10,13,19,17,"1",-7
41,45,3,70,60,19,30,"-1",40
41,47,3,1,12,20,10,"1",-9
41,48,3,25,30,18,45,"-1",-20
41,49,3,15,20,11,9,"-1",6
41,51,3,50,50,26,70,"-1",-20
42,20,3,0,21,40,0,"1",0
42,24,3,14,14,14,15,"0",-1
42,25,3,50,28,14,50,"-1",0
42,28,3,19,19,20,20,"1",-1
42,29,3,30,46,66,25,"1",5
42,30,3,20,23,48,50,"1",-30
42,33,3,70,40,15,20,"-1",50
42,34,3,20,20,80,39,"1",-19
42,37,3,65,65,30,30,"-1",35
42,41,3,0,29,17,36,"1",-36
42,42,3,50,35,13,20,"-1",30
42,43,3,40,45,81,80,"1",-40
42,44,3,20,20,19,21,"-1",-1
42,47,3,50,43,20,16,"-1",34
42,50,3,0,22,38,5,"1",-5
42,51,3,20,45,26,56,"1",-36
43,12,3,99,99,78,100,"-1",-1
43,14,3,89,25,41,87,"-1",2
43,15,3,89,55,60,89,"-1",0
43,21,3,36,55,35,55,"-1",-19
43,24,3,23,45,14,14,"-1",9
43,26,3,88,91,29,89,"-1",-1
43,28,3,19,19,20,23,"1",-4
43,30,3,23,13,48,0,"1",23
43,34,3,3,15,80,0,"1",3
43,37,3,45,45,30,25,"-1",20
43,39,3,85,55,43,89,"-1",-4
43,41,3,25,50,17,0,"-1",25
43,42,3,87,55,13,56,"-1",31
43,44,3,25,25,19,25,"-1",0
44,9,3,20,25,29,20,"1",0
44,12,3,100,80,78,100,"-1",0
44,15,3,70,65,60,60,"-1",10
44,24,3,25,25,14,25,"-1",0
44,25,3,10,10,14,30,"1",-20
44,27,3,70,40,45,40,"-1",30
44,28,3,40,40,20,25,"-1",15
44,29,3,85,80,66,100,"-1",-15
44,30,3,10,20,48,20,"1",-10
44,33,3,40,10,15,40,"-1",0
44,34,3,100,90,80,100,"-1",0
44,39,3,0,20,43,0,"1",0
44,41,3,100,60,17,100,"-1",0
44,42,3,100,100,13,100,"-1",0
44,43,3,30,40,81,70,"1",-40
44,44,3,70,50,19,50,"-1",20
44,47,3,10,10,20,10,"1",0
44,49,3,0,10,11,10,"1",-10
44,50,3,0,25,38,10,"1",-10
44,51,3,50,50,26,50,"-1",0
45,3,3,0,5,29,0,"1",0
45,12,3,100,95,78,100,"-1",0
45,15,3,80,50,60,80,"-1",0
45,16,3,5,40,26,5,"1",0
45,24,3,5,5,14,10,"1",-5
45,25,3,0,20,14,0,"1",0
45,26,3,100,95,29,100,"-1",0
45,28,3,15,15,20,15,"1",0
45,30,3,0,10,48,0,"1",0
45,31,3,100,80,19,85,"-1",15
45,32,3,70,40,33,60,"-1",10
45,33,3,20,35,15,10,"-1",10
45,34,3,75,75,80,85,"1",-10
45,36,3,60,50,26,20,"-1",40
45,38,3,100,85,71,100,"-1",0
45,39,3,40,60,43,30,"1",10
45,41,3,100,80,17,90,"-1",10
45,42,3,100,90,13,100,"-1",0
45,47,3,30,30,20,20,"-1",10
45,48,3,100,30,18,100,"-1",0
45,51,3,40,50,26,35,"-1",5
46,2,3,2,5,20,20,"1",-18
46,12,3,75,100,78,70,"1",5
46,17,3,35,35,43,20,"1",15
46,19,3,0,15,21,12,"1",-12
46,22,3,90,95,60,40,"-1",50
46,27,3,0,0,45,0,"1",0
46,28,3,40,40,20,20,"-1",20
46,29,3,10,25,66,50,"1",-40
46,31,3,70,60,19,30,"-1",40
46,34,3,25,20,80,60,"1",-35
46,43,3,5,5,81,30,"1",-25
46,44,3,5,10,19,20,"1",-15
46,51,3,40,40,26,10,"-1",30
47,1,3,76,45,26,23,"-1",53
47,8,3,99,62,75,89,"-1",10
47,9,3,23,18,29,5,"1",18
47,12,3,90,90,78,56,"-1",34
47,15,3,99,67,60,30,"-1",69
47,21,3,12,12,35,25,"1",-13
47,27,3,0,34,45,80,"1",-80
47,31,3,0,12,19,34,"1",-34
47,33,3,20,54,15,23,"-1",-3
47,34,3,5,8,80,45,"1",-40
47,36,3,11,11,26,23,"1",-12
47,38,3,99,99,71,99,"-1",0
47,41,3,15,47,17,67,"1",-52
47,42,3,17,62,13,34,"-1",-17
47,43,3,75,39,81,87,"1",-12
47,44,3,11,11,19,5,"1",6
47,48,3,78,78,18,23,"-1",55
47,51,3,0,67,26,10,"1",-10
48,3,3,24,0,29,0,"1",24
48,10,3,5,85,56,5,"1",0
48,12,3,0,55,78,0,"1",0
48,13,3,25,0,22,0,"-1",25
48,20,3,0,35,40,0,"1",0
48,24,3,20,20,14,20,"-1",0
48,25,3,0,40,14,0,"1",0
48,28,3,35,35,20,20,"-1",15
48,30,3,0,15,48,0,"1",0
48,31,3,20,50,19,80,"-1",-60
48,34,3,100,85,80,100,"-1",0
48,36,3,0,10,26,0,"1",0
48,39,3,0,70,43,0,"1",0
48,41,3,80,95,17,80,"-1",0
48,42,3,95,75,13,90,"-1",5
48,43,3,20,35,81,10,"1",10
48,44,3,5,50,19,15,"1",-10
48,46,3,0,10,45,0,"1",0
48,47,3,0,5,20,0,"1",0
48,48,3,20,35,18,0,"-1",20
48,49,3,0,2,11,0,"1",0
48,51,3,0,15,26,0,"1",0
49,5,3,40,10,56,50,"1",-10
49,6,3,45,10,29,0,"-1",45
49,7,3,20,10,45,20,"1",0
49,9,3,10,20,29,40,"1",-30
49,11,3,66,56,31,10,"-1",56
49,15,3,0,20,60,20,"1",-20
49,18,3,0,20,82,35,"1",-35
49,19,3,10,20,21,50,"1",-40
49,20,3,20,10,40,20,"1",0
49,21,3,20,30,35,24,"1",-4
49,23,3,30,30,71,40,"1",-10
49,24,3,90,23,14,60,"-1",30
49,25,3,34,23,14,30,"-1",4
49,27,3,10,10,45,46,"1",-36
49,29,3,90,50,66,10,"-1",80
49,31,3,100,50,19,10,"-1",90
49,32,3,45,67,33,10,"-1",35
49,42,3,13,34,13,10,"0",3
49,43,3,13,21,81,10,"1",3
49,44,3,67,65,19,20,"-1",47
49,45,3,13,20,19,10,"1",3
49,49,3,56,50,11,24,"-1",32
49,50,3,20,10,38,30,"1",-10
50,3,3,0,42,29,0,"1",0
50,12,3,100,63,78,100,"-1",0
50,24,3,10,19,14,18,"1",-8
50,25,3,10,45,14,10,"1",0
50,26,3,100,83,29,100,"-1",0
50,27,3,15,38,45,40,"1",-25
50,28,3,70,73,20,15,"-1",55
50,29,3,60,78,66,70,"1",-10
50,30,3,0,37,48,0,"1",0
50,33,3,95,48,15,10,"-1",85
50,34,3,1,6,80,35,"1",-34
50,39,3,0,11,43,0,"1",0
50,41,3,10,62,17,15,"1",-5
50,42,3,10,12,13,5,"1",5
50,43,3,65,88,81,75,"1",-10
50,44,3,5,6,19,5,"1",0
50,47,3,0,2,20,0,"1",0
50,48,3,10,7,18,5,"1",5
50,50,3,0,44,38,0,"1",0
50,51,3,0,71,26,0,"1",0
51,12,3,50,40,78,30,"1",20
51,16,3,1,5,26,1,"1",0
51,24,3,30,30,14,13,"-1",17
51,25,3,15,20,14,20,"-1",-5
51,28,3,20,20,20,20,"0",0
51,30,3,5,20,48,20,"1",-15
51,33,3,90,60,15,40,"-1",50
51,34,3,65,80,80,80,"1",-15
51,37,3,30,30,30,30,"0",0
51,41,3,90,90,17,50,"-1",40
51,43,3,90,75,81,90,"-1",0
51,44,3,20,20,19,20,"-1",0
51,47,3,50,50,20,50,"-1",0
51,49,3,10,10,11,10,"1",0
51,50,3,0,25,38,0,"1",0
52,24,3,20,15,14,14,"-1",6
52,25,3,2,7,14,2,"1",0
52,26,3,100,82,29,100,"-1",0
52,28,3,58,58,20,50,"-1",8
52,30,3,0,14,48,0,"1",0
52,33,3,45,35,15,20,"-1",25
52,34,3,10,15,80,60,"1",-50
52,37,3,90,85,30,100,"-1",-10
52,39,3,100,19,43,100,"-1",0
52,42,3,90,70,13,90,"-1",0
52,43,3,10,55,81,70,"1",-60
52,44,3,2,10,19,15,"1",-13
52,47,3,0,62,20,12,"1",-12
52,49,3,0,25,11,0,"1",0
52,51,3,0,65,26,0,"1",0
53,3,3,10,20,29,10,"1",0
53,8,3,10,30,75,20,"1",-10
53,12,3,50,50,78,50,"1",0
53,15,3,99,50,60,99,"-1",0
53,19,3,0,40,21,0,"1",0
53,20,3,100,50,40,99,"-1",1
53,21,3,100,100,35,99,"-1",1
53,23,3,70,70,71,50,"1",20
53,24,3,10,10,14,10,"1",0
53,26,3,50,50,29,50,"-1",0
53,28,3,30,30,20,50,"-1",-20
53,29,3,90,90,66,99,"-1",-9
53,30,3,0,50,48,99,"1",-99
53,31,3,99,50,19,0,"-1",99
53,33,3,50,50,15,99,"-1",-49
53,34,3,10,10,80,10,"1",0
53,36,3,50,50,26,50,"-1",0
53,38,3,100,100,71,99,"-1",1
53,41,3,50,50,17,0,"-1",50
53,42,3,10,20,13,10,"1",0
53,44,3,100,30,19,99,"-1",1
53,46,3,5,50,45,10,"1",-5
53,47,3,20,20,20,10,"0",10
53,48,3,50,50,18,5,"-1",45
53,49,3,0,10,11,0,"1",0
53,50,3,0,20,38,0,"1",0
53,51,3,0,50,26,0,"1",0
54,3,3,10,75,29,15,"1",-5
54,7,3,85,65,45,90,"-1",-5
54,8,3,85,49,75,85,"-1",0
54,9,3,10,15,29,10,"1",0
54,10,3,30,45,56,45,"1",-15
54,11,3,30,25,31,20,"1",10
54,12,3,90,80,78,90,"-1",0
54,24,3,5,5,14,14,"1",-9
54,25,3,15,25,14,15,"-1",0
54,28,3,25,25,20,20,"-1",5
54,30,3,15,35,48,20,"1",-5
54,33,3,5,35,15,15,"1",-10
54,34,3,90,67,80,90,"-1",0
54,35,3,5,25,17,15,"1",-10
54,41,3,95,65,17,90,"-1",5
54,42,3,95,56,13,85,"-1",10
54,43,3,70,34,81,90,"1",-20
54,44,3,20,20,19,20,"-1",0
54,45,3,85,68,19,75,"-1",10
54,47,3,15,24,20,15,"1",0
54,48,3,70,35,18,65,"-1",5
54,50,3,0,22,38,10,"1",-10
54,51,3,80,35,26,75,"-1",5
55,4,3,60,76,78,70,"1",-10
55,8,3,100,78,75,100,"-1",0
55,24,3,20,35,14,20,"-1",0
55,26,3,100,50,29,100,"-1",0
55,28,3,25,25,20,25,"-1",0
55,30,3,0,20,48,0,"1",0
55,33,3,10,30,15,15,"1",-5
55,37,3,30,40,30,20,"0",10
55,38,3,100,70,71,100,"-1",0
55,39,3,30,50,43,10,"1",20
55,42,3,100,60,13,100,"-1",0
55,44,3,50,20,19,50,"-1",0
55,46,3,100,80,45,100,"-1",0
55,47,3,100,60,20,100,"-1",0
55,49,3,0,30,11,0,"1",0
55,51,3,0,50,26,10,"1",-10
56,3,3,0,37,29,0,"1",0
56,5,3,100,78,56,100,"-1",0
56,6,3,0,45,29,0,"1",0
56,11,3,0,12,31,0,"1",0
56,13,3,0,15,22,0,"1",0
56,15,3,100,43,60,85,"-1",15
56,17,3,0,24,43,0,"1",0
56,19,3,0,15,21,0,"1",0
56,20,3,100,34,40,100,"-1",0
56,21,3,80,25,35,80,"-1",0
56,24,3,25,25,14,25,"-1",0
56,26,3,0,42,29,0,"1",0
56,28,3,45,45,20,20,"-1",25
56,30,3,0,20,48,20,"1",-20
56,31,3,100,35,19,0,"-1",100
56,32,3,50,24,33,50,"-1",0
56,33,3,100,34,15,100,"-1",0
56,35,3,0,24,17,0,"1",0
56,36,3,0,25,26,0,"1",0
56,39,3,0,53,43,0,"1",0
56,40,3,0,20,21,0,"1",0
56,41,3,0,65,17,0,"1",0
56,42,3,0,81,13,0,"1",0
56,43,3,75,48,81,50,"1",25
56,44,3,0,15,19,0,"1",0
56,47,3,0,32,20,0,"1",0
56,48,3,90,65,18,100,"-1",-10
56,49,3,0,10,11,0,"1",0
56,50,3,0,8,38,0,"1",0
56,51,3,0,32,26,0,"1",0
57,1,3,0,25,26,50,"1",-50
57,7,3,50,60,45,50,"-1",0
57,9,3,0,10,29,0,"1",0
57,12,3,100,75,78,100,"-1",0
57,14,3,50,25,41,30,"-1",20
57,18,3,100,45,82,100,"-1",0
57,21,3,100,65,35,20,"-1",80
57,23,3,0,68,71,0,"1",0
57,24,3,25,20,14,15,"-1",10
57,25,3,0,37,14,0,"1",0
57,28,3,18,13,20,15,"1",3
57,32,3,100,40,33,100,"-1",0
57,33,3,100,75,15,100,"-1",0
57,34,3,0,25,80,20,"1",-20
57,35,3,100,35,17,100,"-1",0
57,36,3,0,75,26,0,"1",0
57,37,3,0,40,30,0,"1",0
57,38,3,100,62,71,100,"-1",0
57,39,3,100,60,43,100,"-1",0
57,42,3,0,65,13,10,"1",-10
58,4,3,60,80,78,89,"1",-29
58,7,3,0,10,45,0,"1",0
58,9,3,10,14,29,0,"1",10
58,11,3,0,14,31,9,"1",-9
58,12,3,80,90,78,60,"-1",20
58,19,3,0,80,21,0,"1",0
58,20,3,20,29,40,0,"1",20
58,24,3,0,20,14,0,"1",0
58,25,3,10,30,14,0,"1",10
58,27,3,40,70,45,60,"1",-20
58,28,3,0,30,20,0,"1",0
58,30,3,0,20,48,0,"1",0
58,36,3,0,40,26,0,"1",0
58,40,3,10,80,21,20,"1",-10
58,43,3,100,70,81,80,"-1",20
58,44,3,0,3,19,50,"1",-50
58,45,3,70,60,19,10,"-1",60
58,49,3,0,30,11,0,"1",0
58,51,3,0,40,26,30,"1",-30
59,3,3,0,32,29,0,"1",0
59,6,3,0,26,29,0,"1",0
59,9,3,0,15,29,0,"1",0
59,11,3,0,19,31,0,"1",0
59,12,3,100,80,78,100,"-1",0
59,16,3,0,9,26,0,"1",0
59,20,3,0,13,40,0,"1",0
59,24,3,15,10,14,15,"-1",0
59,27,3,70,55,45,90,"-1",-20
59,28,3,70,70,20,40,"-1",30
59,30,3,0,58,48,90,"1",-90
59,33,3,90,40,15,10,"-1",80
59,39,3,0,70,43,0,"1",0
59,41,3,76,65,17,70,"-1",6
59,42,3,100,85,13,100,"-1",0
59,43,3,35,40,81,100,"1",-65
59,45,3,0,20,19,0,"1",0
59,47,3,0,4,20,0,"1",0
59,48,3,80,80,18,60,"-1",20
59,51,3,100,75,26,100,"-1",0
60,4,3,90,90,78,90,"-1",0
60,6,3,30,30,29,10,"-1",20
60,12,3,10,67,78,12,"1",-2
60,20,3,5,5,40,5,"1",0
60,21,3,45,45,35,50,"-1",-5
60,24,3,25,25,14,25,"-1",0
60,26,3,95,95,29,85,"-1",10
60,27,3,98,98,45,80,"-1",18
60,28,3,19,40,20,15,"1",4
60,31,3,35,12,19,70,"-1",-35
60,33,3,76,76,15,95,"-1",-19
60,34,3,56,56,80,65,"1",-9
60,37,3,45,45,30,30,"-1",15
60,38,3,85,85,71,95,"-1",-10
60,40,3,85,85,21,80,"-1",5
60,42,3,100,89,13,100,"-1",0
60,43,3,10,56,81,35,"1",-25
60,44,3,30,30,19,25,"-1",5
60,47,3,14,14,20,10,"1",4
60,48,3,0,10,18,0,"1",0
60,49,3,0,5,11,0,"1",0
60,50,3,0,3,38,0,"1",0
61,8,3,87,80,75,88,"-1",-1
61,10,3,75,78,56,87,"-1",-12
61,12,3,100,90,78,99,"-1",1
61,14,3,7,34,41,2,"1",5
61,15,3,15,35,60,23,"1",-8
61,16,3,10,26,26,10,"1",0
61,23,3,90,85,71,80,"-1",10
61,24,3,25,30,14,40,"-1",-15
61,28,3,82,80,20,40,"-1",42
61,29,3,88,62,66,75,"-1",13
61,31,3,55,29,19,85,"-1",-30
61,34,3,63,42,80,80,"1",-17
61,35,3,6,18,17,10,"1",-4
61,36,3,92,67,26,52,"-1",40
61,37,3,99,57,30,99,"-1",0
61,41,3,97,53,17,85,"-1",12
61,44,3,85,62,19,75,"-1",10
61,45,3,20,48,19,5,"-1",15
61,50,3,60,45,38,65,"-1",-5
61,51,3,80,10,26,70,"-1",10
62,3,3,20,0,29,0,"1",20
62,7,3,15,50,45,5,"1",10
62,8,3,10,30,75,5,"1",5
62,9,3,1,10,29,5,"1",-4
62,13,3,14,0,22,0,"1",14
62,24,3,5,5,14,20,"1",-15
62,28,3,20,20,20,20,"0",0
62,31,3,80,30,19,70,"-1",10
62,33,3,80,80,15,30,"-1",50
62,34,3,5,15,80,15,"1",-10
62,37,3,40,40,30,20,"-1",20
62,39,3,50,50,43,70,"-1",-20
62,41,3,90,60,17,60,"-1",30
62,42,3,90,90,13,20,"-1",70
62,43,3,50,30,81,80,"1",-30
62,44,3,20,20,19,10,"-1",10
62,45,3,10,10,19,10,"1",0
62,47,3,2,8,20,15,"1",-13
62,48,3,10,10,18,5,"1",5
62,49,3,1,5,11,1,"1",0
62,51,3,35,35,26,25,"-1",10
63,8,3,70,80,75,60,"1",10
63,33,3,30,20,15,0,"-1",30
63,42,3,30,50,13,20,"-1",10
63,45,3,10,40,19,20,"1",-10
63,50,3,0,34,38,0,"1",0
63,51,3,0,60,26,0,"1",0
64,8,3,30,60,75,30,"1",0
64,12,3,0,65,78,0,"1",0
64,15,3,100,90,60,95,"-1",5
64,21,3,85,70,35,95,"-1",-10
64,24,3,25,25,14,15,"-1",10
64,26,3,100,60,29,100,"-1",0
64,28,3,42,40,20,20,"-1",22
64,29,3,80,60,66,70,"-1",10
64,30,3,20,65,48,5,"1",15
64,31,3,60,30,19,30,"-1",30
64,33,3,50,30,15,50,"-1",0
64,34,3,5,60,80,10,"1",-5
64,36,3,30,30,26,29,"-1",1
64,37,3,80,70,30,90,"-1",-10
64,38,3,100,100,71,100,"-1",0
64,39,3,20,60,43,30,"1",-10
64,40,3,0,70,21,0,"1",0
64,41,3,95,90,17,70,"-1",25
64,42,3,20,30,13,5,"-1",15
64,44,3,0,20,19,0,"1",0
64,45,3,60,50,19,11,"-1",49
64,47,3,100,20,20,100,"-1",0
64,49,3,0,40,11,0,"1",0
64,51,3,70,70,26,70,"-1",0
65,3,3,10,20,29,10,"1",0
65,4,3,100,100,78,100,"-1",0
65,6,3,45,60,29,60,"-1",-15
65,7,3,0,50,45,0,"1",0
65,8,3,20,80,75,30,"1",-10
65,12,3,20,30,78,50,"1",-30
65,24,3,15,15,14,14,"-1",1
65,25,3,5,10,14,5,"1",0
65,26,3,70,90,29,70,"-1",0
65,27,3,0,5,45,30,"1",-30
65,28,3,15,15,20,20,"1",-5
65,30,3,10,10,48,5,"1",5
65,31,3,80,90,19,50,"-1",30
65,33,3,90,40,15,90,"-1",0
65,34,3,0,70,80,0,"1",0
65,35,3,50,10,17,90,"-1",-40
65,37,3,90,90,30,40,"-1",50
65,38,3,99,80,71,99,"-1",0
65,39,3,100,35,43,100,"-1",0
65,41,3,0,60,17,0,"1",0
65,42,3,20,10,13,10,"-1",10
65,43,3,100,70,81,100,"-1",0
65,44,3,5,20,19,5,"1",0
65,47,3,0,25,20,0,"1",0
65,49,3,0,15,11,0,"1",0
65,50,3,0,15,38,0,"1",0
65,51,3,0,30,26,0,"1",0
66,3,3,36,36,29,10,"-1",26
66,4,3,50,70,78,53,"1",-3
66,7,3,10,60,45,13,"1",-3
66,8,3,90,90,75,96,"-1",-6
66,9,3,8,13,29,4,"1",4
66,12,3,100,100,78,79,"-1",21
66,13,3,40,10,22,6,"-1",34
66,24,3,10,10,14,20,"1",-10
66,26,3,10,80,29,9,"1",1
66,28,3,37,37,20,20,"-1",17
66,30,3,0,50,48,3,"1",-3
66,33,3,10,10,15,12,"1",-2
66,37,3,60,60,30,76,"-1",-16
66,40,3,99,35,21,98,"-1",1
66,44,3,20,20,19,19,"-1",1
66,45,3,47,67,19,12,"-1",35
66,49,3,12,68,11,11,"-1",1
66,50,3,0,56,38,2,"1",-2
66,51,3,10,40,26,12,"1",-2
67,12,3,100,70,78,80,"-1",20
67,24,3,10,15,14,10,"1",0
67,25,3,10,20,14,10,"1",0
67,26,3,100,80,29,90,"-1",10
67,28,3,15,20,20,20,"1",-5
67,30,3,0,40,48,1,"1",-1
67,34,3,50,60,80,60,"1",-10
67,36,3,50,50,26,50,"-1",0
67,37,3,75,75,30,75,"-1",0
67,39,3,75,70,43,50,"-1",25
67,40,3,100,50,21,99,"-1",1
67,42,3,25,20,13,20,"-1",5
67,43,3,95,70,81,80,"-1",15
67,44,3,5,20,19,5,"1",0
67,48,3,20,30,18,20,"-1",0
67,50,3,1,15,38,5,"1",-4
67,51,3,20,45,26,20,"1",0
68,3,3,1,29,29,0,"1",1
68,8,3,55,50,75,45,"1",10
68,10,3,50,48,56,23,"1",27
68,12,3,100,93,78,100,"-1",0
68,16,3,5,7,26,7,"1",-2
68,25,3,65,25,14,50,"-1",15
68,26,3,80,80,29,80,"-1",0
68,28,3,65,65,20,62,"-1",3
68,31,3,70,65,19,44,"-1",26
68,33,3,0,4,15,9,"1",-9
68,35,3,0,16,17,14,"1",-14
68,36,3,58,34,26,86,"-1",-28
68,37,3,50,31,30,50,"-1",0
68,39,3,10,65,43,12,"1",-2
68,41,3,46,53,17,25,"-1",21
68,42,3,100,33,13,100,"-1",0
68,44,3,20,30,19,17,"-1",3
68,47,3,10,13,20,11,"1",-1
68,48,3,45,55,18,45,"-1",0
68,50,3,0,10,38,0,"1",0
69,4,3,99,76,78,99,"-1",0
69,12,3,45,50,78,56,"1",-11
69,24,3,10,10,14,15,"1",-5
69,25,3,0,45,14,12,"1",-12
69,26,3,99,99,29,99,"-1",0
69,28,3,67,56,20,45,"-1",22
69,30,3,0,5,48,13,"1",-13
69,31,3,7,32,19,78,"1",-71
69,33,3,50,32,15,15,"-1",35
69,34,3,7,12,80,14,"1",-7
69,39,3,0,14,43,0,"1",0
69,42,3,100,94,13,78,"-1",22
69,44,3,2,6,19,5,"1",-3
69,47,3,0,34,20,31,"1",-31
69,49,3,0,10,11,0,"1",0
69,50,3,0,67,38,0,"1",0
69,51,3,0,44,26,0,"1",0
70,8,3,100,90,75,100,"-1",0
70,9,3,0,10,29,0,"1",0
70,11,3,0,10,31,0,"1",0
70,24,3,50,50,14,10,"-1",40
70,26,3,100,90,29,100,"-1",0
70,28,3,60,60,20,10,"-1",50
70,35,3,20,20,17,20,"-1",0
70,36,3,60,60,26,20,"-1",40
70,37,3,0,5,30,20,"1",-20
70,38,3,60,60,71,20,"1",40
70,40,3,50,40,21,40,"-1",10
70,42,3,0,50,13,10,"1",-10
70,44,3,5,5,19,10,"1",-5
70,45,3,10,10,19,10,"1",0
70,49,3,0,10,11,0,"1",0
70,50,3,20,20,38,20,"1",0
70,51,3,50,20,26,50,"-1",0
71,15,3,70,70,60,50,"-1",20
71,20,3,80,80,40,50,"-1",30
71,21,3,50,50,35,70,"-1",-20
71,22,3,20,70,60,0,"1",20
71,24,3,10,30,14,10,"1",0
71,29,3,50,50,66,70,"1",-20
71,31,3,90,70,19,40,"-1",50
71,32,3,30,30,33,50,"1",-20
71,33,3,70,70,15,30,"-1",40
71,34,3,12,12,80,10,"1",2
71,35,3,60,60,17,60,"-1",0
71,39,3,1,80,43,10,"1",-9
71,44,3,10,45,19,10,"1",0
72,1,3,5,10,26,25,"1",-20
72,3,3,25,55,29,20,"1",5
72,4,3,60,40,78,60,"1",0
72,10,3,40,50,56,40,"1",0
72,12,3,20,70,78,20,"1",0
72,13,3,1,10,22,1,"1",0
72,14,3,15,40,41,15,"1",0
72,23,3,13,60,71,20,"1",-7
72,24,3,5,5,14,10,"1",-5
72,26,3,99,67,29,80,"-1",19
72,27,3,45,58,45,70,"0",-25
72,28,3,30,30,20,10,"-1",20
72,30,3,90,40,48,85,"-1",5
72,33,3,1,20,15,5,"1",-4
72,34,3,10,12,80,20,"1",-10
72,36,3,10,30,26,10,"1",0
72,37,3,85,60,30,80,"-1",5
72,39,3,40,50,43,45,"1",-5
72,42,3,15,30,13,20,"-1",-5
72,44,3,10,20,19,15,"1",-5
72,48,3,10,10,18,40,"1",-30
72,50,3,1,30,38,5,"1",-4
72,51,3,1,35,26,2,"1",-1
73,5,3,0,18,56,25,"1",-25
73,24,3,10,10,14,10,"1",0
73,26,3,25,30,29,25,"1",0
73,27,3,50,65,45,40,"-1",10
73,28,3,18,18,20,25,"1",-7
73,29,3,25,30,66,70,"1",-45
73,30,3,0,9,48,0,"1",0
73,37,3,15,25,30,20,"1",-5
73,38,3,10,70,71,25,"1",-15
73,42,3,50,25,13,50,"-1",0
73,44,3,23,19,19,10,"-1",13
73,47,3,100,37,20,100,"-1",0
73,48,3,50,30,18,60,"-1",-10
73,51,3,100,65,26,50,"-1",50
74,3,3,1,61,29,0,"1",1
74,8,3,2,64,75,40,"1",-38
74,9,3,0,27,29,0,"1",0
74,13,3,31,31,22,0,"-1",31
74,15,3,70,83,60,48,"-1",22
74,21,3,80,67,35,59,"-1",21
74,23,3,20,80,71,3,"1",17
74,24,3,18,25,14,7,"-1",11
74,27,3,90,88,45,60,"-1",30
74,28,3,19,45,20,6,"1",13
74,31,3,20,83,19,3,"-1",17
74,34,3,2,18,80,67,"1",-65
74,36,3,0,43,26,0,"1",0
74,37,3,42,87,30,50,"-1",-8
74,44,3,7,36,19,5,"1",2
74,45,3,3,13,19,3,"1",0
74,47,3,20,42,20,10,"0",10
74,49,3,1,14,11,1,"1",0
74,50,3,0,74,38,1,"1",-1
74,51,3,5,43,26,1,"1",4
75,6,3,50,61,29,28,"-1",22
75,8,3,90,78,75,90,"-1",0
75,12,3,78,29,78,78,"0",0
75,13,3,19,2,22,2,"1",17
75,24,3,19,23,14,10,"-1",9
75,26,3,100,72,29,100,"-1",0
75,27,3,46,65,45,45,"-1",1
75,28,3,45,78,20,85,"-1",-40
75,29,3,84,91,66,80,"-1",4
75,33,3,78,56,15,61,"-1",17
75,34,3,76,67,80,78,"1",-2
75,39,3,96,79,43,83,"-1",13
75,41,3,95,84,17,89,"-1",6
75,44,3,8,22,19,12,"1",-4
75,47,3,2,34,20,10,"1",-8
75,48,3,45,25,18,18,"-1",27
75,49,3,10,32,11,8,"1",2
75,50,3,2,31,38,5,"1",-3
75,51,3,50,68,26,50,"-1",0
76,4,3,100,100,78,100,"-1",0
76,6,3,70,47,29,70,"-1",0
76,8,3,100,70,75,100,"-1",0
76,12,3,0,70,78,0,"1",0
76,24,3,0,10,14,20,"1",-20
76,25,3,100,87,14,100,"-1",0
76,26,3,0,68,29,0,"1",0
76,28,3,19,19,20,20,"1",-1
76,37,3,100,70,30,100,"-1",0
76,40,3,50,72,21,50,"-1",0
76,42,3,50,50,13,68,"-1",-18
76,44,3,20,20,19,25,"-1",-5
76,47,3,100,42,20,100,"-1",0
77,5,3,10,27,56,10,"1",0
77,6,3,80,50,29,70,"-1",10
77,7,3,0,50,45,1,"1",-1
77,24,3,40,10,14,15,"-1",25
77,26,3,100,70,29,100,"-1",0
77,28,3,70,60,20,20,"-1",50
77,31,3,100,50,19,80,"-1",20
77,33,3,90,50,15,90,"-1",0
77,39,3,15,30,43,90,"1",-75
77,42,3,0,40,13,0,"1",0
77,44,3,60,50,19,30,"-1",30
77,48,3,5,50,18,5,"1",0
77,49,3,5,10,11,5,"1",0
78,3,3,40,10,29,0,"-1",40
78,4,3,85,50,78,85,"-1",0
78,6,3,14,23,29,15,"1",-1
78,8,3,40,40,75,75,"1",-35
78,11,3,5,20,31,0,"1",5
78,12,3,0,40,78,40,"1",-40
78,13,3,30,0,22,0,"-1",30
78,15,3,50,50,60,60,"1",-10
78,21,3,75,61,35,40,"-1",35
78,22,3,80,75,60,80,"-1",0
78,24,3,8,8,14,14,"1",-6
78,26,3,100,71,29,100,"-1",0
78,28,3,30,30,20,20,"-1",10
78,30,3,0,31,48,0,"1",0
78,32,3,100,25,33,100,"-1",0
78,33,3,10,10,15,20,"1",-10
78,37,3,80,40,30,75,"-1",5
78,40,3,2,37,21,5,"1",-3
78,41,3,0,40,17,0,"1",0
78,42,3,5,39,13,5,"1",0
78,44,3,5,27,19,15,"1",-10
78,47,3,0,20,20,0,"1",0
78,49,3,15,15,11,10,"-1",5
78,50,3,0,75,38,0,"1",0
78,51,3,0,30,26,0,"1",0
79,3,3,0,43,29,0,"1",0
79,4,3,100,77,78,100,"-1",0
79,6,3,0,20,29,0,"1",0
79,8,3,10,35,75,20,"1",-10
79,9,3,0,22,29,0,"1",0
79,11,3,0,21,31,0,"1",0
79,15,3,13,22,60,20,"1",-7
79,16,3,10,7,26,10,"1",0
79,21,3,12,33,35,10,"1",2
79,24,3,8,17,14,8,"1",0
79,25,3,0,23,14,0,"1",0
79,26,3,0,69,29,0,"1",0
79,28,3,10,25,20,23,"1",-13
79,30,3,0,22,48,10,"1",-10
79,33,3,23,22,15,88,"-1",-65
79,34,3,2,6,80,20,"1",-18
79,39,3,0,43,43,0,"1",0
79,40,3,60,35,21,77,"-1",-17
79,41,3,3,10,17,5,"1",-2
79,42,3,0,78,13,0,"1",0
79,44,3,0,23,19,5,"1",-5
79,45,3,0,15,19,0,"1",0
79,49,3,0,14,11,0,"1",0
79,50,3,0,36,38,0,"1",0
79,51,3,30,34,26,10,"-1",20
80,3,3,90,70,29,80,"-1",10
80,4,3,100,80,78,100,"-1",0
80,7,3,10,30,45,8,"1",2
80,8,3,80,60,75,90,"-1",-10
80,9,3,50,33,29,30,"-1",20
80,12,3,100,75,78,100,"-1",0
80,24,3,20,20,14,10,"-1",10
80,25,3,30,29,14,70,"-1",-40
80,26,3,100,70,29,90,"-1",10
80,27,3,0,20,45,0,"1",0
80,28,3,40,30,20,20,"-1",20
80,30,3,0,10,48,0,"1",0
80,32,3,100,20,33,100,"-1",0
80,33,3,100,20,15,90,"-1",10
80,39,3,10,20,43,10,"1",0
80,40,3,0,80,21,0,"1",0
80,41,3,99,50,17,80,"-1",19
80,43,3,13,70,81,40,"1",-27
80,44,3,60,40,19,80,"-1",-20
80,45,3,80,79,19,70,"-1",10
80,48,3,95,5,18,80,"-1",15
80,50,3,80,75,38,80,"-1",0
80,51,3,29,29,26,30,"-1",-1
81,8,3,100,90,75,100,"-1",0
81,12,3,99,90,78,60,"-1",39
81,24,3,33,33,14,10,"-1",23
81,26,3,90,50,29,90,"-1",0
81,28,3,30,30,20,19,"-1",11
81,29,3,80,75,66,70,"-1",10
81,30,3,10,15,48,35,"1",-25
81,32,3,95,45,33,80,"-1",15
81,33,3,40,30,15,25,"-1",15
81,34,3,5,5,80,50,"1",-45
81,37,3,80,75,30,40,"-1",40
81,39,3,89,45,43,90,"-1",-1
81,41,3,70,40,17,50,"-1",20
81,42,3,15,10,13,20,"-1",-5
81,44,3,10,15,19,5,"1",5
81,47,3,15,35,20,5,"1",10
81,48,3,15,25,18,20,"1",-5
81,50,3,0,20,38,15,"1",-15
81,51,3,50,60,26,60,"-1",-10
82,16,3,60,60,26,50,"-1",10
82,19,3,50,30,21,50,"-1",0
82,20,3,0,10,40,5,"1",-5
82,24,3,19,19,14,22,"-1",-3
82,28,3,25,25,20,19,"-1",6
82,30,3,1,3,48,10,"1",-9
82,31,3,100,100,19,80,"-1",20
82,33,3,10,10,15,10,"1",0
82,36,3,75,75,26,80,"-1",-5
82,37,3,100,100,30,100,"-1",0
82,40,3,50,50,21,25,"-1",25
82,41,3,50,50,17,50,"-1",0
82,43,3,60,40,81,60,"1",0
83,10,3,30,70,56,10,"1",20
83,24,3,9,9,14,5,"1",4
83,26,3,100,60,29,100,"-1",0
83,27,3,2,20,45,10,"1",-8
83,28,3,15,15,20,10,"1",5
83,29,3,90,90,66,80,"-1",10
83,32,3,90,30,33,90,"-1",0
83,33,3,90,80,15,80,"-1",10
83,34,3,1,10,80,10,"1",-9
83,37,3,50,50,30,50,"-1",0
83,38,3,60,60,71,70,"1",-10
83,42,3,10,20,13,15,"1",-5
83,44,3,7,7,19,10,"1",-3
83,45,3,30,45,19,15,"-1",15
83,49,3,12,12,11,10,"-1",2
83,50,3,2,15,38,5,"1",-3
83,51,3,15,15,26,10,"1",5
84,3,3,35,34,29,19,"-1",16
84,5,3,27,49,56,45,"1",-18
84,11,3,10,20,31,21,"1",-11
84,17,3,70,60,43,79,"-1",-9
84,18,3,11,52,82,7,"1",4
84,20,3,20,38,40,34,"1",-14
84,23,3,23,63,71,33,"1",-10
84,26,3,0,17,29,1,"1",-1
84,30,3,10,40,48,2,"1",8
84,31,3,54,39,19,12,"-1",42
84,32,3,1,26,33,1,"1",0
84,33,3,70,39,15,23,"-1",47
84,37,3,45,49,30,47,"-1",-2
84,38,3,70,98,71,86,"1",-16
84,44,3,43,12,19,10,"-1",33
84,51,3,48,60,26,50,"-1",-2
85,24,3,5,5,14,15,"1",-10
85,33,3,55,55,15,22,"-1",33
85,34,3,0,0,80,22,"1",-22
85,38,3,99,99,71,99,"-1",0
85,43,3,44,33,81,77,"1",-33
85,44,3,34,25,19,15,"-1",19
86,3,3,15,0,29,5,"1",10
86,4,3,25,70,78,25,"1",0
86,12,3,100,90,78,100,"-1",0
86,13,3,0,15,22,0,"1",0
86,18,3,20,20,82,35,"1",-15
86,19,3,100,55,21,95,"-1",5
86,20,3,65,12,40,65,"-1",0
86,24,3,2,1,14,15,"1",-13
86,25,3,100,15,14,100,"-1",0
86,26,3,100,70,29,100,"-1",0
86,27,3,25,25,45,55,"1",-30
86,28,3,30,30,20,20,"-1",10
86,29,3,80,80,66,80,"-1",0
86,30,3,80,20,48,90,"-1",-10
86,34,3,100,85,80,90,"-1",10
86,37,3,65,55,30,50,"-1",15
86,39,3,10,35,43,20,"1",-10
86,40,3,15,45,21,10,"1",5
86,41,3,0,30,17,0,"1",0
86,42,3,40,30,13,15,"-1",25
86,43,3,100,45,81,100,"-1",0
86,44,3,15,15,19,15,"1",0
86,50,3,5,5,38,10,"1",-5
86,51,3,80,50,26,70,"-1",10
87,12,3,82,44,78,95,"-1",-13
87,13,3,20,0,22,0,"1",20
87,24,3,80,83,14,32,"-1",48
87,25,3,19,42,14,1,"-1",18
87,28,3,34,62,20,30,"-1",4
87,30,3,93,65,48,20,"-1",73
87,34,3,13,72,80,90,"1",-77
87,41,3,75,90,17,34,"-1",41
87,44,3,50,44,19,50,"-1",0
87,49,3,2,62,11,0,"1",2
87,51,3,11,33,26,10,"1",1
88,1,3,70,30,26,50,"-1",20
88,3,3,25,0,29,15,"1",10
88,9,3,10,30,29,34,"1",-24
88,12,3,68,68,78,70,"1",-2
88,13,3,10,0,22,0,"1",10
88,16,3,20,10,26,20,"1",0
88,21,3,19,19,35,30,"1",-11
88,24,3,10,10,14,20,"1",-10
88,26,3,100,75,29,100,"-1",0
88,28,3,35,35,20,20,"-1",15
88,31,3,70,29,19,50,"-1",20
88,33,3,60,60,15,90,"-1",-30
88,34,3,30,30,80,60,"1",-30
88,39,3,90,65,43,80,"-1",10
88,42,3,55,65,13,23,"-1",32
88,43,3,15,17,81,14,"1",1
88,46,3,10,60,45,0,"1",10
88,47,3,0,20,20,0,"1",0
88,48,3,20,5,18,80,"-1",-60
88,49,3,0,15,11,0,"1",0
88,50,3,0,20,38,0,"1",0
88,51,3,0,40,26,0,"1",0
89,7,3,10,30,45,20,"1",-10
89,24,3,16,9,14,19,"-1",-3
89,26,3,100,70,29,100,"-1",0
89,27,3,80,60,45,80,"-1",0
89,28,3,70,60,20,20,"-1",50
89,29,3,60,60,66,30,"1",30
89,30,3,3,8,48,3,"1",0
89,31,3,90,30,19,5,"-1",85
89,33,3,2,6,15,5,"1",-3
89,34,3,10,15,80,70,"1",-60
89,37,3,5,5,30,10,"1",-5
89,41,3,20,30,17,10,"-1",10
89,42,3,40,70,13,5,"-1",35
89,43,3,60,40,81,80,"1",-20
89,44,3,80,50,19,80,"-1",0
89,45,3,20,5,19,29,"-1",-9
89,49,3,5,20,11,0,"1",5
89,50,3,20,20,38,20,"1",0
90,4,3,10,23,78,10,"1",0
90,5,3,5,21,56,0,"1",5
90,9,3,2,6,29,0,"1",2
90,10,3,61,82,56,45,"-1",16
90,12,3,32,20,78,67,"1",-35
90,14,3,87,45,41,75,"-1",12
90,16,3,89,42,26,42,"-1",47
90,24,3,65,50,14,67,"-1",-2
90,26,3,100,82,29,87,"-1",13
90,28,3,28,20,20,28,"-1",0
90,31,3,32,25,19,8,"-1",24
90,32,3,100,22,33,100,"-1",0
90,34,3,45,48,80,80,"1",-35
90,36,3,83,88,26,87,"-1",-4
90,37,3,5,10,30,5,"1",0
90,41,3,67,29,17,45,"-1",22
90,42,3,0,72,13,0,"1",0
90,43,3,100,82,81,100,"-1",0
90,44,3,2,12,19,0,"1",2
90,45,3,87,43,19,87,"-1",0
90,47,3,100,38,20,100,"-1",0
90,48,3,100,38,18,100,"-1",0
90,49,3,0,22,11,0,"1",0
90,50,3,0,38,38,0,"1",0
90,51,3,0,13,26,0,"1",0
91,4,3,11,15,78,70,"1",-59
91,7,3,80,30,45,90,"-1",-10
91,8,3,70,40,75,40,"1",30
91,10,3,60,50,56,30,"-1",30
91,12,3,80,70,78,80,"-1",0
91,24,3,12,8,14,20,"1",-8
91,25,3,80,12,14,50,"-1",30
91,26,3,80,60,29,50,"-1",30
91,27,3,80,75,45,60,"-1",20
91,28,3,12,15,20,15,"1",-3
91,30,3,10,15,48,40,"1",-30
91,33,3,90,30,15,70,"-1",20
91,35,3,10,20,17,40,"1",-30
91,41,3,7,8,17,10,"1",-3
91,42,3,80,60,13,98,"-1",-18
91,43,3,80,70,81,90,"1",-10
91,44,3,40,50,19,20,"-1",20
91,46,3,95,40,45,80,"-1",15
91,47,3,10,12,20,10,"1",0
91,49,3,40,30,11,30,"-1",10
91,50,3,70,40,38,70,"-1",0
91,51,3,15,10,26,80,"1",-65
92,5,3,16,40,56,5,"1",11
92,6,3,13,35,29,23,"1",-10
92,7,3,50,65,45,20,"-1",30
92,8,3,20,35,75,85,"1",-65
92,12,3,50,75,78,75,"1",-25
92,20,3,25,18,40,65,"1",-40
92,24,3,45,45,14,35,"-1",10
92,25,3,13,55,14,3,"1",10
92,26,3,90,45,29,95,"-1",-5
92,27,3,78,75,45,65,"-1",13
92,28,3,33,33,20,22,"-1",11
92,29,3,11,25,66,35,"1",-24
92,33,3,75,43,15,90,"-1",-15
92,34,3,14,63,80,43,"1",-29
92,35,3,20,62,17,19,"-1",1
92,37,3,50,50,30,35,"-1",15
92,38,3,90,85,71,85,"-1",5
92,39,3,2,33,43,0,"1",2
92,42,3,5,45,13,5,"1",0
92,43,3,67,56,81,95,"1",-28
92,44,3,7,11,19,4,"1",3
92,47,3,5,18,20,5,"1",0
92,48,3,1,22,18,1,"1",0
92,49,3,5,18,11,15,"1",-10
92,50,3,1,39,38,5,"1",-4
92,51,3,65,65,26,40,"-1",25
93,8,3,90,76,75,100,"-1",-10
93,12,3,100,100,78,100,"-1",0
93,14,3,50,40,41,40,"-1",10
93,21,3,100,70,35,100,"-1",0
93,24,3,20,20,14,15,"-1",5
93,26,3,100,80,29,100,"-1",0
93,28,3,12,12,20,20,"1",-8
93,29,3,99,99,66,100,"-1",-1
93,30,3,0,15,48,0,"1",0
93,33,3,5,3,15,50,"1",-45
93,36,3,10,10,26,60,"1",-50
93,37,3,60,40,30,20,"-1",40
93,38,3,100,95,71,100,"-1",0
93,41,3,90,65,17,67,"-1",23
93,44,3,15,15,19,20,"1",-5
93,47,3,32,31,20,40,"-1",-8
93,48,3,5,3,18,25,"1",-20
93,51,3,50,50,26,64,"-1",-14
94,3,3,0,38,29,0,"1",0
94,5,3,0,1,56,0,"1",0
94,6,3,10,60,29,50,"1",-40
94,7,3,9,30,45,30,"1",-21
94,8,3,8,58,75,30,"1",-22
94,9,3,0,22,29,0,"1",0
94,11,3,0,27,31,0,"1",0
94,12,3,88,88,78,88,"-1",0
94,13,3,0,24,22,0,"1",0
94,21,3,50,33,35,32,"-1",18
94,24,3,50,50,14,38,"-1",12
94,25,3,0,28,14,0,"1",0
94,26,3,0,72,29,0,"1",0
94,28,3,47,30,20,30,"-1",17
94,34,3,28,39,80,20,"1",8
94,35,3,88,20,17,80,"-1",8
94,36,3,89,85,26,40,"-1",49
94,40,3,100,60,21,100,"-1",0
94,42,3,0,44,13,0,"1",0
94,43,3,48,60,81,59,"1",-11
94,44,3,0,12,19,3,"1",-3
94,45,3,50,72,19,70,"-1",-20
94,48,3,4,40,18,20,"1",-16
94,50,3,0,75,38,0,"1",0
94,51,3,0,30,26,4,"1",-4
95,3,3,30,5,29,5,"-1",25
95,4,3,100,90,78,100,"-1",0
95,20,3,100,30,40,100,"-1",0
95,24,3,5,5,14,10,"1",-5
95,26,3,100,90,29,100,"-1",0
95,27,3,90,90,45,80,"-1",10
95,28,3,10,10,20,20,"1",-10
95,29,3,30,85,66,40,"1",-10
95,33,3,0,5,15,0,"1",0
95,34,3,5,50,80,5,"1",0
95,37,3,80,80,30,50,"-1",30
95,38,3,100,90,71,100,"-1",0
95,40,3,0,80,21,0,"1",0
95,41,3,100,75,17,100,"-1",0
95,42,3,1,10,13,0,"1",1
95,43,3,99,60,81,100,"-1",-1
95,44,3,20,20,19,10,"-1",10
95,50,3,1,20,38,1,"1",0
96,3,3,5,25,29,5,"1",0
96,8,3,100,90,75,100,"-1",0
96,9,3,25,25,29,25,"1",0
96,14,3,70,50,41,40,"-1",30
96,16,3,15,10,26,15,"1",0
96,20,3,0,15,40,0,"1",0
96,24,3,15,15,14,10,"-1",5
96,25,3,10,25,14,10,"1",0
96,27,3,10,10,45,60,"1",-50
96,28,3,15,15,20,20,"1",-5
96,29,3,90,80,66,90,"-1",0
96,30,3,0,15,48,0,"1",0
96,31,3,10,25,19,10,"1",0
96,33,3,0,0,15,0,"1",0
96,34,3,30,30,80,30,"1",0
96,35,3,25,40,17,30,"-1",-5
96,36,3,50,40,26,10,"-1",40
96,37,3,25,25,30,25,"1",0
96,39,3,60,60,43,50,"-1",10
96,41,3,80,75,17,80,"-1",0
96,42,3,15,50,13,25,"-1",-10
96,43,3,100,90,81,100,"-1",0
96,44,3,0,10,19,0,"1",0
96,45,3,25,25,19,20,"-1",5
96,46,3,80,75,45,80,"-1",0
96,47,3,20,20,20,20,"0",0
96,48,3,50,50,18,50,"-1",0
96,49,3,10,20,11,15,"1",-5
96,51,3,25,25,26,10,"1",15
97,3,3,40,0,29,0,"-1",40
97,4,3,10,90,78,5,"1",5
97,9,3,10,30,29,40,"1",-30
97,12,3,95,95,78,95,"-1",0
97,19,3,100,80,21,100,"-1",0
97,22,3,99,99,60,90,"-1",9
97,24,3,10,10,14,14,"1",-4
97,25,3,1,20,14,10,"1",-9
97,26,3,100,90,29,100,"-1",0
97,28,3,8,8,20,23,"1",-15
97,32,3,10,10,33,5,"1",5
97,34,3,0,20,80,0,"1",0
97,37,3,70,70,30,30,"-1",40
97,39,3,80,60,43,90,"-1",-10
97,40,3,90,50,21,80,"-1",10
97,42,3,1,90,13,0,"1",1
97,43,3,90,75,81,80,"-1",10
97,44,3,3,20,19,5,"1",-2
97,45,3,50,50,19,50,"-1",0
97,49,3,0,20,11,0,"1",0
97,51,3,50,33,26,33,"-1",17
98,3,3,8,0,29,0,"1",8
98,7,3,0,66,45,0,"1",0
98,8,3,40,90,75,40,"1",0
98,21,3,76,67,35,85,"-1",-9
98,24,3,11,11,14,12,"1",-1
98,25,3,0,14,14,0,"1",0
98,27,3,100,65,45,100,"-1",0
98,28,3,12,12,20,15,"1",-3
98,30,3,0,15,48,0,"1",0
98,31,3,20,15,19,76,"-1",-56
98,33,3,14,26,15,20,"1",-6
98,34,3,26,35,80,25,"1",1
98,35,3,0,20,17,0,"1",0
98,38,3,95,89,71,85,"-1",10
98,39,3,0,80,43,0,"1",0
98,40,3,0,30,21,0,"1",0
98,44,3,26,30,19,25,"-1",1
98,47,3,15,11,20,16,"1",-1
98,49,3,0,5,11,0,"1",0
98,50,3,0,44,38,0,"1",0
99,1,3,0,9,26,45,"1",-45
99,3,3,24,0,29,0,"1",24
99,12,3,100,95,78,100,"-1",0
99,13,3,7,0,22,0,"1",7
99,24,3,25,20,14,20,"-1",5
99,26,3,100,80,29,100,"-1",0
99,28,3,9,9,20,20,"1",-11
99,33,3,100,19,15,0,"-1",100
99,34,3,100,76,80,100,"-1",0
99,37,3,100,70,30,40,"-1",60
99,40,3,20,60,21,20,"1",0
99,41,3,50,45,17,10,"-1",40
99,42,3,0,75,13,0,"1",0
99,44,3,0,21,19,0,"1",0
99,47,3,12,38,20,75,"1",-63
99,49,3,0,25,11,0,"1",0
99,50,3,0,19,38,0,"1",0
100,1,3,46,35,26,46,"-1",0
100,3,3,0,54,29,5,"1",-5
100,8,3,36,42,75,27,"1",9
100,20,3,67,36,40,76,"-1",-9
100,24,3,20,20,14,37,"-1",-17
100,25,3,0,25,14,0,"1",0
100,26,3,100,85,29,96,"-1",4
100,27,3,32,37,45,32,"1",0
100,28,3,65,67,20,28,"-1",37
100,30,3,5,21,48,7,"1",-2
100,31,3,91,58,19,25,"-1",66
100,33,3,79,73,15,76,"-1",3
100,34,3,10,24,80,19,"1",-9
100,35,3,73,65,17,68,"-1",5
100,36,3,53,43,26,40,"-1",13
100,37,3,67,69,30,48,"-1",19
100,39,3,0,57,43,0,"1",0
100,42,3,54,47,13,50,"-1",4
100,44,3,50,50,19,45,"-1",5
100,46,3,4,63,45,4,"1",0
100,47,3,3,17,20,22,"1",-19
100,49,3,2,5,11,5,"1",-3
100,50,3,0,10,38,9,"1",-9
100,51,3,27,43,26,23,"-1",4
