"Participant","Event","Valence","E1","eBR","BR","E2","direction","update"
1,1,2,10,10,26,20,"1",-10
1,2,2,0,0,20,20,"1",-20
1,3,4,0,10,29,0,"1",0
1,4,3,30,50,78,30,"1",0
1,5,5,30,40,56,30,"1",0
1,6,4,100,40,29,100,"-1",0
1,7,4,50,30,45,50,"-1",0
1,8,3,100,100,75,100,"-1",0
1,9,5,100,30,29,100,"-1",0
1,10,2,10,30,56,0,"1",10
1,11,5,2,5,31,0,"1",2
1,12,3,100,100,78,80,"-1",20
1,13,4,0,5,22,0,"1",0
1,14,2,90,60,41,50,"-1",40
1,15,2,60,60,60,60,"0",0
1,16,2,20,20,26,10,"1",10
1,17,2,60,60,43,50,"-1",10
1,18,2,10,40,82,10,"1",0
1,19,2,0,10,21,0,"1",0
1,20,2,0,10,40,0,"1",0
1,21,2,10,40,35,20,"1",-10
1,22,2,100,100,60,100,"-1",0
1,23,2,50,80,71,50,"1",0
1,24,3,5,5,14,10,"1",-5
1,25,5,100,30,14,100,"-1",0
1,26,3,100,75,29,100,"-1",0
1,27,2,20,20,45,20,"1",0
1,28,3,20,20,20,20,"0",0
1,29,2,30,30,66,20,"1",10
1,30,4,100,30,48,100,"-1",0
1,31,4,70,50,19,20,"-1",50
1,32,4,100,30,33,100,"-1",0
1,33,3,10,10,15,20,"1",-10
1,34,3,100,80,80,100,"-1",0
1,35,2,0,20,17,0,"1",0
1,36,3,50,50,26,50,"-1",0
1,37,3,90,80,30,80,"-1",10
1,38,2,100,100,71,100,"-1",0
1,39,5,90,70,43,80,"-1",10
1,40,2,0,5,21,0,"1",0
1,41,2,5,20,17,20,"1",-15
1,42,2,0,30,13,0,"1",0
1,43,3,60,30,81,60,"1",0
1,44,4,80,20,19,80,"-1",0
1,45,4,5,10,19,10,"1",-5
1,46,4,100,40,45,100,"-1",0
1,47,3,100,20,20,100,"-1",0
1,48,5,100,30,18,100,"-1",0
1,49,2,0,5,11,0,"1",0
1,50,2,0,30,38,0,"1",0
1,51,2,0,10,26,0,"1",0
2,1,5,0,50,26,0,"1",0
2,2,2,99,25,20,15,"-1",84
2,3,4,10,20,29,10,"1",0
2,4,4,99,80,78,99,"-1",0
2,5,4,10,15,56,25,"1",-15
2,6,2,2,6,29,10,"1",-8
2,7,5,0,75,45,0,"1",0
2,8,4,80,44,75,80,"-1",0
2,9,5,75,10,29,50,"-1",25
2,10,4,50,50,56,25,"1",25
2,11,3,10,20,31,10,"1",0
2,12,3,99,99,78,99,"-1",0
2,13,5,0,5,22,10,"1",-10
2,14,2,99,50,41,75,"-1",24
2,15,2,99,80,60,99,"-1",0
2,16,2,75,15,26,75,"-1",0
2,17,2,10,20,43,10,"1",0
2,18,2,75,40,82,25,"1",50
2,19,2,0,50,21,0,"1",0
2,20,3,10,10,40,25,"1",-15
2,21,2,99,60,35,99,"-1",0
2,22,2,99,80,60,99,"-1",0
2,23,2,75,50,71,75,"-1",0
2,24,3,20,20,14,15,"-1",5
2,25,4,20,10,14,20,"-1",0
2,26,4,99,80,29,99,"-1",0
2,27,2,18,18,45,15,"1",3
2,28,3,33,33,20,20,"-1",13
2,29,2,99,80,66,99,"-1",0
2,30,3,15,10,48,15,"1",0
2,31,4,20,75,19,75,"-1",-55
2,32,4,5,60,33,10,"1",-5
2,33,4,99,75,15,80,"-1",19
2,34,2,5,10,80,50,"1",-45
2,35,2,1,10,17,10,"1",-9
2,36,2,80,80,26,10,"-1",70
2,37,5,50,50,30,50,"-1",0
2,38,2,90,90,71,99,"-1",-9
2,39,2,15,20,43,10,"1",5
2,40,5,99,20,21,99,"-1",0
2,41,3,10,5,17,50,"1",-40
2,42,3,20,25,13,25,"-1",-5
2,43,4,20,33,81,50,"1",-30
2,44,3,10,10,19,10,"1",0
2,45,3,0,25,19,0,"1",0
2,46,4,0,15,45,0,"1",0
2,47,4,5,15,20,0,"1",5
2,48,2,10,15,18,10,"1",0
2,49,5,10,20,11,10,"1",0
2,50,2,0,60,38,0,"1",0
2,51,2,10,50,26,0,"1",10
3,1,5,8,3,26,5,"1",3
3,2,5,1,1,20,1,"1",0
3,3,3,0,3,29,0,"1",0
3,4,3,10,3,78,10,"1",0
3,5,5,10,3,56,10,"1",0
3,6,2,1,2,29,2,"1",-1
3,7,4,1,3,45,0,"1",1
3,8,4,8,9,75,8,"1",0
3,9,4,15,2,29,3,"1",12
3,10,4,2,3,56,2,"1",0
3,11,4,5,3,31,5,"1",0
3,12,2,10,10,78,10,"1",0
3,13,5,0,3,22,0,"1",0
3,14,2,0,2,41,0,"1",0
3,15,2,2,2,60,2,"1",0
3,16,2,1,1,26,1,"1",0
3,17,2,2,3,43,2,"1",0
3,18,2,8,6,82,2,"1",6
3,19,2,0,4,21,0,"1",0
3,20,2,0,3,40,0,"1",0
3,21,2,1,3,35,2,"1",-1
3,22,2,8,9,60,8,"1",0
3,23,2,2,3,71,2,"1",0
3,24,4,6,4,14,5,"1",1
3,25,3,0,2,14,1,"1",-1
3,26,4,10,7,29,10,"1",0
3,27,2,0,1,45,1,"1",-1
3,28,3,5,5,20,7,"1",-2
3,29,2,7,8,66,10,"1",-3
3,30,2,0,2,48,0,"1",0
3,31,2,10,2,19,0,"1",10
3,32,5,10,2,33,10,"1",0
3,33,4,7,5,15,10,"1",-3
3,34,3,0,2,80,0,"1",0
3,35,2,0,2,17,0,"1",0
3,36,2,5,7,26,5,"1",0
3,37,3,1,1,30,5,"1",-4
3,38,2,10,80,71,10,"1",0
3,39,2,0,1,43,0,"1",0
3,40,4,10,3,21,10,"1",0
3,41,2,0,2,17,0,"1",0
3,42,4,2,5,13,2,"1",0
3,43,3,0,1,81,0,"1",0
3,44,3,1,3,19,5,"1",-4
3,45,4,2,6,19,0,"1",2
3,46,4,8,4,45,8,"1",0
3,47,3,0,3,20,0,"1",0
3,48,2,5,3,18,5,"1",0
3,49,4,2,4,11,4,"1",-2
3,50,3,0,4,38,0,"1",0
3,51,3,7,4,26,5,"1",2
4,1,3,50,40,26,25,"-1",25
4,2,5,15,10,20,10,"1",5
4,3,3,0,40,29,0,"1",0
4,4,4,100,100,78,100,"-1",0
4,5,5,40,50,56,35,"1",5
4,6,4,100,50,29,100,"-1",0
4,7,4,0,15,45,0,"1",0
4,8,2,45,50,75,45,"1",0
4,9,4,25,20,29,45,"1",-20
4,10,4,85,85,56,70,"-1",15
4,11,4,65,30,31,75,"-1",-10
4,12,2,100,80,78,100,"-1",0
4,13,4,0,10,22,0,"1",0
4,14,2,45,60,41,35,"-1",10
4,15,2,50,40,60,45,"1",5
4,16,2,85,20,26,85,"-1",0
4,17,2,40,50,43,45,"1",-5
4,18,2,100,80,82,100,"-1",0
4,19,2,10,35,21,20,"1",-10
4,20,2,10,0,40,10,"1",0
4,21,3,40,45,35,65,"-1",-25
4,22,2,80,80,60,75,"-1",5
4,23,2,85,70,71,95,"-1",-10
4,24,2,40,40,14,15,"-1",25
4,25,5,100,40,14,100,"-1",0
4,26,3,100,85,29,85,"-1",15
4,27,3,60,60,45,95,"-1",-35
4,28,3,19,25,20,20,"1",-1
4,29,2,90,85,66,85,"-1",5
4,30,4,100,40,48,100,"-1",0
4,31,3,75,85,19,15,"-1",60
4,32,2,85,40,33,65,"-1",20
4,33,3,100,70,15,100,"-1",0
4,34,2,95,95,80,95,"-1",0
4,35,2,50,40,17,15,"-1",35
4,36,2,30,30,26,20,"-1",10
4,37,3,30,30,30,65,"0",-35
4,38,3,100,95,71,100,"-1",0
4,39,3,40,55,43,30,"1",10
4,40,4,0,20,21,0,"1",0
4,41,3,45,33,17,75,"-1",-30
4,42,3,100,95,13,100,"-1",0
4,43,3,5,20,81,35,"1",-30
4,44,3,30,30,19,20,"-1",10
4,45,3,100,60,19,75,"-1",25
4,46,4,60,75,45,45,"-1",15
4,47,4,40,20,20,45,"-1",-5
4,48,2,30,40,18,15,"-1",15
4,49,4,0,10,11,0,"1",0
4,50,3,0,20,38,0,"1",0
4,51,2,5,40,26,5,"1",0
5,1,3,72,42,26,60,"-1",12
5,2,4,10,10,20,15,"1",-5
5,3,3,0,36,29,0,"1",0
5,4,3,95,98,78,80,"-1",15
5,5,4,80,30,56,60,"-1",20
5,6,3,5,10,29,5,"1",0
5,7,3,80,35,45,90,"-1",-10
5,8,3,10,30,75,20,"1",-10
5,9,3,36,22,29,40,"-1",-4
5,10,3,28,67,56,60,"1",-32
5,11,3,5,20,31,5,"1",0
5,12,3,20,36,78,20,"1",0
5,13,2,28,0,22,0,"-1",28
5,14,2,20,30,41,30,"1",-10
5,15,3,46,78,60,30,"1",16
5,16,2,68,56,26,10,"-1",58
5,17,3,0,18,43,10,"1",-10
5,18,2,72,34,82,80,"1",-8
5,19,3,0,32,21,0,"1",0
5,20,3,0,22,40,0,"1",0
5,21,3,20,20,35,20,"1",0
5,22,2,60,45,60,70,"0",-10
5,23,2,75,89,71,50,"-1",25
5,24,3,2,25,14,10,"1",-8
5,25,3,1,36,14,0,"1",1
5,26,3,100,90,29,99,"-1",1
5,27,2,80,50,45,10,"-1",70
5,28,3,54,65,20,10,"-1",44
5,29,2,46,67,66,40,"1",6
5,30,3,0,19,48,0,"1",0
5,31,3,80,50,19,10,"-1",70
5,32,3,80,40,33,80,"-1",0
5,33,3,70,60,15,20,"-1",50
5,34,3,50,20,80,80,"1",-30
5,35,3,50,64,17,20,"-1",30
5,36,4,70,70,26,20,"-1",50
5,37,3,80,65,30,80,"-1",0
5,38,3,95,95,71,80,"-1",15
5,39,3,90,80,43,80,"-1",10
5,40,3,2,36,21,10,"1",-8
5,41,3,70,64,17,80,"-1",-10
5,42,3,78,67,13,70,"-1",8
5,43,3,32,22,81,10,"1",22
5,44,3,1,1,19,50,"1",-49
5,45,3,85,62,19,90,"-1",-5
5,46,3,70,60,45,60,"-1",10
5,47,3,0,20,20,0,"1",0
5,48,3,0,10,18,0,"1",0
5,49,3,0,12,11,0,"1",0
5,50,3,0,36,38,0,"1",0
5,51,2,0,56,26,0,"1",0
6,1,3,50,50,26,50,"-1",0
6,2,2,10,10,20,10,"1",0
6,3,3,20,20,29,10,"1",10
6,4,2,100,95,78,100,"-1",0
6,5,2,50,50,56,50,"1",0
6,6,2,85,85,29,100,"-1",-15
6,7,4,10,10,45,10,"1",0
6,8,3,100,85,75,100,"-1",0
6,9,3,5,10,29,10,"1",-5
6,10,4,99,85,56,100,"-1",-1
6,11,4,20,20,31,20,"1",0
6,12,3,100,100,78,100,"-1",0
6,13,4,50,50,22,10,"-1",40
6,14,2,95,70,41,100,"-1",-5
6,15,2,100,75,60,100,"-1",0
6,16,3,55,45,26,60,"-1",-5
6,17,2,20,20,43,10,"1",10
6,18,2,99,85,82,100,"-1",-1
6,19,2,100,80,21,100,"-1",0
6,20,2,0,45,40,0,"1",0
6,21,3,99,99,35,100,"-1",-1
6,22,2,65,65,60,60,"-1",5
6,23,2,100,100,71,100,"-1",0
6,24,3,10,10,14,10,"1",0
6,25,5,100,60,14,100,"-1",0
6,26,3,100,80,29,100,"-1",0
6,27,3,80,80,45,50,"-1",30
6,28,3,19,19,20,20,"1",-1
6,29,2,99,99,66,100,"-1",-1
6,30,3,100,39,48,100,"-1",0
6,31,3,50,50,19,40,"-1",10
6,32,2,0,69,33,0,"1",0
6,33,3,50,50,15,50,"-1",0
6,34,3,100,100,80,100,"-1",0
6,35,2,0,15,17,0,"1",0
6,36,2,60,60,26,60,"-1",0
6,37,3,67,67,30,50,"-1",17
6,38,2,100,100,71,100,"-1",0
6,39,2,0,60,43,0,"1",0
6,40,3,100,95,21,100,"-1",0
6,41,2,100,80,17,80,"-1",20
6,42,3,28,58,13,20,"-1",8
6,43,2,50,50,81,50,"1",0
6,44,3,19,19,19,15,"0",4
6,45,4,30,30,19,30,"-1",0
6,46,5,0,80,45,100,"1",-100
6,47,3,80,80,20,80,"-1",0
6,48,3,10,50,18,0,"1",10
6,49,3,0,10,11,10,"1",-10
6,50,5,100,50,38,100,"-1",0
6,51,2,0,20,26,0,"1",0
7,1,4,10,40,26,10,"1",0
7,2,4,2,4,20,40,"1",-38
7,3,3,0,12,29,0,"1",0
7,4,4,100,100,78,100,"-1",0
7,5,4,43,38,56,50,"1",-7
7,6,4,47,45,29,25,"-1",22
7,7,4,15,47,45,15,"1",0
7,8,4,5,43,75,1,"1",4
7,9,4,23,43,29,10,"1",13
7,10,4,10,53,56,20,"1",-10
7,11,3,10,42,31,15,"1",-5
7,12,2,3,25,78,10,"1",-7
7,13,4,0,68,22,0,"1",0
7,14,2,75,65,41,75,"-1",0
7,15,4,99,83,60,99,"-1",0
7,16,2,23,19,26,20,"1",3
7,17,2,4,28,43,3,"1",1
7,18,2,50,43,82,70,"1",-20
7,19,2,0,34,21,0,"1",0
7,20,3,0,17,40,0,"1",0
7,21,4,70,60,35,75,"-1",-5
7,22,4,89,95,60,50,"-1",39
7,23,2,17,39,71,23,"1",-6
7,24,3,20,20,14,20,"-1",0
7,25,3,2,36,14,10,"1",-8
7,26,3,0,78,29,4,"1",-4
7,27,2,15,27,45,8,"1",7
7,28,3,19,16,20,20,"1",-1
7,29,2,90,90,66,60,"-1",30
7,30,3,0,23,48,0,"1",0
7,31,4,0,47,19,0,"1",0
7,32,4,100,50,33,0,"-1",100
7,33,3,80,34,15,100,"-1",-20
7,34,3,69,78,80,43,"1",26
7,35,2,78,80,17,10,"-1",68
7,36,4,0,58,26,25,"1",-25
7,37,4,25,25,30,60,"1",-35
7,38,3,60,60,71,81,"1",-21
7,39,3,98,75,43,78,"-1",20
7,40,3,45,45,21,25,"-1",20
7,41,3,83,57,17,0,"-1",83
7,42,4,5,27,13,1,"1",4
7,43,4,50,32,81,86,"1",-36
7,44,3,20,20,19,20,"-1",0
7,45,3,10,25,19,10,"1",0
7,46,5,50,41,45,75,"-1",-25
7,47,4,12,23,20,10,"1",2
7,48,3,25,30,18,21,"-1",4
7,49,4,2,19,11,2,"1",0
7,50,5,0,65,38,0,"1",0
7,51,3,15,4,26,4,"1",11
8,1,4,23,32,26,27,"1",-4
8,2,2,18,21,20,12,"1",6
8,3,3,70,74,29,56,"-1",14
8,4,4,100,85,78,100,"-1",0
8,5,4,80,60,56,87,"-1",-7
8,6,2,25,30,29,20,"1",5
8,7,3,15,75,45,29,"1",-14
8,8,3,50,43,75,70,"1",-20
8,9,5,100,69,29,100,"-1",0
8,10,4,50,75,56,33,"1",17
8,11,4,17,17,31,20,"1",-3
8,12,2,100,90,78,100,"-1",0
8,13,4,18,14,22,13,"1",5
8,14,2,20,30,41,20,"1",0
8,15,2,85,65,60,37,"-1",48
8,16,5,40,80,26,73,"-1",-33
8,17,2,40,33,43,40,"1",0
8,18,2,30,44,82,28,"1",2
8,19,2,42,37,21,74,"-1",-32
8,20,2,0,9,40,3,"1",-3
8,21,2,48,26,35,30,"-1",18
8,22,2,80,80,60,40,"-1",40
8,23,2,90,75,71,99,"-1",-9
8,24,3,4,8,14,1,"1",3
8,25,4,62,24,14,66,"-1",-4
8,26,3,100,89,29,99,"-1",1
8,27,3,88,32,45,100,"-1",-12
8,28,3,23,20,20,28,"-1",-5
8,29,2,40,67,66,34,"1",6
8,30,3,73,40,48,67,"-1",6
8,31,5,20,80,19,18,"-1",2
8,32,5,23,43,33,7,"1",16
8,33,3,10,40,15,20,"1",-10
8,34,4,88,64,80,79,"-1",9
8,35,2,17,62,17,8,"0",9
8,36,2,100,80,26,30,"-1",70
8,37,4,88,62,30,30,"-1",58
8,38,3,92,88,71,91,"-1",1
8,39,2,50,22,43,72,"-1",-22
8,40,3,1,1,21,4,"1",-3
8,41,3,100,64,17,99,"-1",1
8,42,2,5,14,13,12,"1",-7
8,43,3,0,87,81,100,"1",-100
8,44,3,2,17,19,1,"1",1
8,45,4,76,23,19,80,"-1",-4
8,46,5,100,66,45,100,"-1",0
8,47,3,0,9,20,10,"1",-10
8,48,3,20,15,18,20,"-1",0
8,49,4,20,22,11,14,"-1",6
8,50,3,66,33,38,75,"-1",-9
8,51,2,7,29,26,7,"1",0
9,1,2,80,50,26,40,"-1",40
9,2,2,40,30,20,60,"-1",-20
9,3,4,20,40,29,14,"1",6
9,4,3,90,79,78,60,"-1",30
9,5,5,60,70,56,50,"-1",10
9,6,4,80,50,29,26,"-1",54
9,7,4,100,40,45,85,"-1",15
9,8,2,70,60,75,80,"1",-10
9,9,5,25,20,29,25,"1",0
9,10,5,90,70,56,58,"-1",32
9,11,4,25,10,31,25,"1",0
9,12,2,80,80,78,80,"-1",0
9,13,5,50,60,22,30,"-1",20
9,14,2,90,60,41,80,"-1",10
9,15,2,80,40,60,60,"-1",20
9,16,2,20,50,26,56,"1",-36
9,17,2,0,20,43,20,"1",-20
9,18,2,30,10,82,55,"1",-25
9,19,2,24,70,21,25,"-1",-1
9,20,2,0,10,40,15,"1",-15
9,21,2,25,25,35,35,"1",-10
9,22,2,100,80,60,80,"-1",20
9,23,2,60,70,71,80,"1",-20
9,24,3,40,30,14,54,"-1",-14
9,25,4,45,60,14,24,"-1",21
9,26,4,100,70,29,80,"-1",20
9,27,2,32,23,45,80,"1",-48
9,28,3,40,30,20,15,"-1",25
9,29,3,74,70,66,50,"-1",24
9,30,4,25,45,48,70,"1",-45
9,31,2,80,60,19,85,"-1",-5
9,32,2,0,15,33,100,"1",-100
9,33,4,60,30,15,57,"-1",3
9,34,3,100,90,80,60,"-1",40
9,35,2,40,20,17,24,"-1",16
9,36,2,85,50,26,10,"-1",75
9,37,4,80,80,30,75,"-1",5
9,38,2,100,90,71,30,"-1",70
9,39,2,0,57,43,0,"1",0
9,40,4,75,75,21,35,"-1",40
9,41,2,80,60,17,20,"-1",60
9,42,3,80,80,13,35,"-1",45
9,43,2,10,25,81,75,"1",-65
9,44,3,10,60,19,23,"1",-13
9,45,4,10,25,19,30,"1",-20
9,46,4,100,70,45,100,"-1",0
9,47,4,60,60,20,10,"-1",50
9,48,4,10,5,18,40,"1",-30
9,49,5,9,5,11,2,"1",7
9,50,4,0,20,38,0,"1",0
9,51,4,50,50,26,24,"-1",26
10,1,2,50,30,26,50,"-1",0
10,2,2,75,60,20,25,"-1",50
10,3,4,0,25,29,10,"1",-10
10,4,2,100,85,78,100,"-1",0
10,5,5,30,40,56,20,"1",10
10,6,4,0,20,29,15,"1",-15
10,7,4,100,60,45,100,"-1",0
10,8,4,100,85,75,95,"-1",5
10,9,4,5,20,29,15,"1",-10
10,10,4,15,49,56,20,"1",-5
10,11,5,0,15,31,5,"1",-5
10,12,3,100,90,78,100,"-1",0
10,13,5,0,25,22,0,"1",0
10,14,2,25,45,41,35,"1",-10
10,15,2,100,80,60,95,"-1",5
10,16,2,5,15,26,10,"1",-5
10,17,2,100,15,43,85,"-1",15
10,18,2,75,44,82,15,"1",60
10,19,2,100,37,21,95,"-1",5
10,20,2,5,8,40,5,"1",0
10,21,4,100,65,35,100,"-1",0
10,22,2,100,85,60,85,"-1",15
10,23,2,95,90,71,100,"-1",-5
10,24,3,30,30,14,20,"-1",10
10,25,4,20,25,14,30,"-1",-10
10,26,3,100,85,29,100,"-1",0
10,27,4,100,85,45,50,"-1",50
10,28,3,30,35,20,20,"-1",10
10,29,2,99,85,66,45,"-1",54
10,30,4,100,45,48,100,"-1",0
10,31,4,0,15,19,0,"1",0
10,32,5,0,15,33,0,"1",0
10,33,3,100,40,15,30,"-1",70
10,34,3,25,29,80,65,"1",-40
10,35,4,5,30,17,25,"1",-20
10,36,2,0,70,26,5,"1",-5
10,37,4,100,85,30,75,"-1",25
10,38,2,100,95,71,95,"-1",5
10,39,3,100,70,43,95,"-1",5
10,40,4,60,45,21,60,"-1",0
10,41,3,95,90,17,85,"-1",10
10,42,2,20,20,13,15,"-1",5
10,43,3,5,2,81,60,"1",-55
10,44,3,15,20,19,15,"1",0
10,45,2,0,65,19,0,"1",0
10,46,5,100,60,45,100,"-1",0
10,47,5,0,15,20,5,"1",-5
10,48,4,50,50,18,35,"-1",15
10,49,3,0,10,11,0,"1",0
10,50,5,10,8,38,30,"1",-20
10,51,3,100,85,26,60,"-1",40
11,1,4,50,30,26,50,"-1",0
11,2,5,15,30,20,20,"1",-5
11,3,3,10,60,29,5,"1",5
11,4,3,40,60,78,40,"1",0
11,5,5,50,40,56,65,"1",-15
11,6,4,50,30,29,50,"-1",0
11,7,5,70,45,45,80,"-1",-10
11,8,4,100,90,75,100,"-1",0
11,9,4,50,30,29,60,"-1",-10
11,10,4,50,60,56,30,"1",20
11,11,5,20,30,31,30,"1",-10
11,12,3,0,80,78,5,"1",-5
11,13,5,60,10,22,10,"-1",50
11,14,2,35,45,41,30,"1",5
11,15,2,90,70,60,45,"-1",45
11,16,2,35,30,26,30,"-1",5
11,17,2,35,55,43,40,"1",-5
11,18,2,70,70,82,60,"1",10
11,19,2,100,80,21,70,"-1",30
11,20,2,80,60,40,60,"-1",20
11,21,3,85,80,35,70,"-1",15
11,22,2,40,75,60,60,"1",-20
11,23,2,60,80,71,45,"1",15
11,24,3,40,40,14,25,"-1",15
11,25,3,50,40,14,25,"-1",25
11,26,3,100,100,29,100,"-1",0
11,27,3,75,55,45,55,"-1",20
11,28,3,20,20,20,20,"0",0
11,29,2,85,95,66,60,"-1",25
11,30,4,40,20,48,25,"1",15
11,31,5,15,20,19,15,"1",0
11,32,2,5,10,33,15,"1",-10
11,33,3,10,40,15,15,"1",-5
11,34,3,80,80,80,60,"0",20
11,35,2,10,15,17,30,"1",-20
11,36,2,85,85,26,65,"-1",20
11,37,4,50,50,30,50,"-1",0
11,38,2,80,90,71,50,"-1",30
11,39,3,40,60,43,25,"1",15
11,40,5,80,55,21,70,"-1",10
11,41,2,20,70,17,10,"-1",10
11,42,3,75,60,13,40,"-1",35
11,43,4,15,20,81,20,"1",-5
11,44,3,5,10,19,10,"1",-5
11,45,5,80,70,19,30,"-1",50
11,46,5,10,70,45,5,"1",5
11,47,3,10,70,20,0,"1",10
11,48,2,5,30,18,5,"1",0
11,49,3,0,30,11,5,"1",-5
11,50,3,10,45,38,15,"1",-5
11,51,3,50,45,26,50,"-1",0
12,1,4,2,5,26,30,"1",-28
12,2,2,5,30,20,10,"1",-5
12,3,3,3,44,29,5,"1",-2
12,4,3,40,45,78,50,"1",-10
12,5,5,5,60,56,5,"1",0
12,6,5,25,40,29,40,"1",-15
12,7,2,10,45,45,10,"1",0
12,8,2,45,65,75,50,"1",-5
12,9,3,20,20,29,20,"1",0
12,10,2,15,25,56,15,"1",0
12,11,4,15,35,31,20,"1",-5
12,12,3,90,75,78,80,"-1",10
12,13,4,12,0,22,0,"1",12
12,14,2,5,15,41,5,"1",0
12,15,2,75,60,60,30,"-1",45
12,16,2,30,10,26,5,"-1",25
12,17,2,6,26,43,30,"1",-24
12,18,2,20,20,82,50,"1",-30
12,19,2,12,45,21,15,"1",-3
12,20,2,0,8,40,5,"1",-5
12,21,4,90,88,35,80,"-1",10
12,22,2,80,80,60,60,"-1",20
12,23,2,80,65,71,70,"-1",10
12,24,2,15,20,14,15,"-1",0
12,25,4,80,50,14,80,"-1",0
12,26,3,100,66,29,100,"-1",0
12,27,3,22,30,45,20,"1",2
12,28,3,20,20,20,15,"0",5
12,29,2,70,80,66,80,"-1",-10
12,30,4,100,35,48,100,"-1",0
12,31,3,40,70,19,50,"-1",-10
12,32,2,5,35,33,30,"1",-25
12,33,4,100,50,15,80,"-1",20
12,34,3,80,80,80,80,"0",0
12,35,2,10,50,17,5,"1",5
12,36,2,80,80,26,35,"-1",45
12,37,3,55,55,30,20,"-1",35
12,38,2,95,85,71,80,"-1",15
12,39,4,95,40,43,100,"-1",-5
12,40,3,5,20,21,50,"1",-45
12,41,3,30,40,17,50,"-1",-20
12,42,3,5,12,13,15,"1",-10
12,43,3,2,12,81,60,"1",-58
12,44,3,18,18,19,15,"1",3
12,45,4,60,28,19,70,"-1",-10
12,46,4,100,50,45,100,"-1",0
12,47,4,30,18,20,30,"-1",0
12,48,3,100,35,18,100,"-1",0
12,49,3,80,20,11,80,"-1",0
12,50,3,5,35,38,10,"1",-5
12,51,3,10,23,26,10,"1",0
13,1,3,0,3,26,0,"1",0
13,2,2,0,47,20,20,"1",-20
13,3,2,0,13,29,0,"1",0
13,4,5,98,56,78,50,"-1",48
13,5,5,15,16,56,44,"1",-29
13,6,2,19,19,29,10,"1",9
13,7,4,86,19,45,20,"-1",66
13,8,3,45,25,75,70,"1",-25
13,9,5,0,15,29,10,"1",-10
13,10,4,100,23,56,30,"-1",70
13,11,4,76,56,31,30,"-1",46
13,12,4,60,54,78,70,"1",-10
13,13,4,0,16,22,0,"1",0
13,14,2,99,56,41,50,"-1",49
13,15,2,99,78,60,100,"-1",-1
13,16,2,99,47,26,30,"-1",69
13,17,2,10,15,43,40,"1",-30
13,18,2,99,78,82,99,"-1",0
13,19,3,60,65,21,20,"-1",40
13,20,2,0,30,40,0,"1",0
13,21,2,80,50,35,30,"-1",50
13,22,2,99,99,60,40,"-1",59
13,23,2,89,67,71,50,"-1",39
13,24,3,30,30,14,10,"-1",20
13,25,4,1,13,14,30,"1",-29
13,26,3,99,67,29,30,"-1",69
13,27,3,99,88,45,98,"-1",1
13,28,3,50,51,20,20,"-1",30
13,29,2,99,15,66,99,"-1",0
13,30,3,0,38,48,20,"1",-20
13,31,2,20,30,19,30,"-1",-10
13,32,4,9,50,33,55,"1",-46
13,33,4,99,5,15,20,"-1",79
13,34,2,0,12,80,80,"1",-80
13,35,2,0,13,17,10,"1",-10
13,36,2,34,36,26,30,"-1",4
13,37,4,20,15,30,10,"1",10
13,38,2,99,99,71,50,"-1",49
13,39,2,50,34,43,30,"-1",20
13,40,3,87,78,21,30,"-1",57
13,41,4,100,10,17,99,"-1",1
13,42,4,99,55,13,99,"-1",0
13,43,2,0,13,81,99,"1",-99
13,44,4,12,10,19,0,"1",12
13,45,5,80,59,19,30,"-1",50
13,46,5,99,89,45,30,"-1",69
13,47,2,23,25,20,0,"-1",23
13,48,2,0,15,18,1,"1",-1
13,49,4,0,19,11,10,"1",-10
13,50,4,50,55,38,50,"-1",0
13,51,3,49,23,26,50,"-1",-1
14,1,4,50,40,26,35,"-1",15
14,2,4,15,20,20,15,"1",0
14,3,4,0,15,29,0,"1",0
14,4,3,100,90,78,100,"-1",0
14,5,4,5,25,56,5,"1",0
14,6,4,25,45,29,10,"1",15
14,7,4,25,65,45,10,"1",15
14,8,3,20,50,75,15,"1",5
14,9,4,10,15,29,10,"1",0
14,10,4,20,30,56,20,"1",0
14,11,5,30,25,31,35,"1",-5
14,12,3,100,70,78,100,"-1",0
14,13,5,0,18,22,0,"1",0
14,14,2,5,30,41,5,"1",0
14,15,2,15,20,60,10,"1",5
14,16,2,5,10,26,5,"1",0
14,17,2,0,15,43,5,"1",-5
14,18,2,5,25,82,5,"1",0
14,19,2,0,10,21,0,"1",0
14,20,2,0,15,40,0,"1",0
14,21,2,15,25,35,10,"1",5
14,22,2,75,75,60,65,"-1",10
14,23,2,10,45,71,10,"1",0
14,24,3,5,5,14,5,"1",0
14,25,3,50,50,14,20,"-1",30
14,26,3,10,20,29,20,"1",-10
14,27,2,0,22,45,0,"1",0
14,28,3,20,20,20,15,"0",5
14,29,2,85,85,66,80,"-1",5
14,30,3,50,40,48,25,"-1",25
14,31,3,100,85,19,0,"-1",100
14,32,4,100,45,33,100,"-1",0
14,33,4,100,75,15,100,"-1",0
14,34,2,0,10,80,0,"1",0
14,35,2,0,12,17,10,"1",-10
14,36,3,80,80,26,40,"-1",40
14,37,3,75,75,30,30,"-1",45
14,38,2,100,100,71,100,"-1",0
14,39,3,90,75,43,100,"-1",-10
14,40,3,50,55,21,40,"-1",10
14,41,3,0,10,17,0,"1",0
14,42,3,5,65,13,0,"1",5
14,43,3,60,75,81,75,"1",-15
14,44,3,15,15,19,15,"1",0
14,45,4,50,40,19,40,"-1",10
14,46,5,100,65,45,100,"-1",0
14,47,4,25,20,20,50,"-1",-25
14,48,3,55,40,18,40,"-1",15
14,49,4,0,5,11,0,"1",0
14,50,3,0,25,38,0,"1",0
14,51,3,10,20,26,5,"1",5
15,1,2,20,40,26,10,"1",10
15,2,2,10,13,20,20,"1",-10
15,3,3,0,20,29,15,"1",-15
15,4,3,100,80,78,30,"-1",70
15,5,5,90,80,56,80,"-1",10
15,6,4,20,35,29,15,"1",5
15,7,4,60,15,45,60,"-1",0
15,8,4,70,60,75,60,"1",10
15,9,3,10,14,29,15,"1",-5
15,10,3,20,60,56,20,"1",0
15,11,4,20,20,31,20,"1",0
15,12,2,100,75,78,100,"-1",0
15,13,4,13,0,22,10,"1",3
15,14,2,15,15,41,30,"1",-15
15,15,2,60,40,60,60,"0",0
15,16,2,15,20,26,40,"1",-25
15,17,2,15,15,43,20,"1",-5
15,18,2,20,40,82,20,"1",0
15,19,2,0,20,21,0,"1",0
15,20,2,5,15,40,10,"1",-5
15,21,3,60,15,35,50,"-1",10
15,22,2,80,80,60,40,"-1",40
15,23,2,30,60,71,30,"1",0
15,24,3,15,15,14,15,"-1",0
15,25,5,100,70,14,100,"-1",0
15,26,3,100,25,29,100,"-1",0
15,27,2,1,12,45,15,"1",-14
15,28,3,20,20,20,20,"0",0
15,29,2,70,70,66,60,"-1",10
15,30,5,100,15,48,100,"-1",0
15,31,2,100,60,19,20,"-1",80
15,32,4,100,30,33,100,"-1",0
15,33,3,70,70,15,60,"-1",10
15,34,4,100,80,80,60,"-1",40
15,35,2,20,70,17,40,"-1",-20
15,36,2,70,70,26,50,"-1",20
15,37,3,70,70,30,30,"-1",40
15,38,2,80,80,71,60,"-1",20
15,39,4,60,30,43,60,"-1",0
15,40,3,0,25,21,0,"1",0
15,41,5,100,70,17,100,"-1",0
15,42,3,100,15,13,60,"-1",40
15,43,3,20,60,81,70,"1",-50
15,44,3,0,15,19,20,"1",-20
15,45,3,80,8,19,40,"-1",40
15,46,5,100,30,45,100,"-1",0
15,47,4,70,35,20,100,"-1",-30
15,48,3,100,60,18,75,"-1",25
15,49,4,1,3,11,5,"1",-4
15,50,4,80,65,38,60,"-1",20
15,51,2,15,40,26,10,"1",5
16,1,5,15,10,26,0,"1",15
16,2,5,10,15,20,15,"1",-5
16,3,3,0,27,29,0,"1",0
16,4,4,100,70,78,100,"-1",0
16,5,4,30,34,56,10,"1",20
16,6,3,0,25,29,0,"1",0
16,7,4,0,22,45,0,"1",0
16,8,3,100,76,75,80,"-1",20
16,9,3,0,29,29,10,"1",-10
16,10,3,0,45,56,0,"1",0
16,11,4,0,12,31,15,"1",-15
16,12,3,100,90,78,100,"-1",0
16,13,4,0,14,22,0,"1",0
16,14,2,12,31,41,10,"1",2
16,15,2,20,23,60,30,"1",-10
16,16,2,0,12,26,10,"1",-10
16,17,2,0,10,43,10,"1",-10
16,18,2,60,70,82,90,"1",-30
16,19,2,0,12,21,0,"1",0
16,20,2,0,16,40,0,"1",0
16,21,2,15,25,35,50,"1",-35
16,22,2,60,60,60,60,"0",0
16,23,2,0,56,71,10,"1",-10
16,24,3,30,30,14,14,"-1",16
16,25,5,100,54,14,100,"-1",0
16,26,3,100,70,29,100,"-1",0
16,27,2,90,75,45,100,"-1",-10
16,28,3,15,15,20,15,"1",0
16,29,2,60,65,66,79,"1",-19
16,30,4,100,45,48,100,"-1",0
16,31,2,70,70,19,10,"-1",60
16,32,5,100,60,33,90,"-1",10
16,33,2,0,50,15,0,"1",0
16,34,3,60,60,80,80,"1",-20
16,35,2,0,10,17,0,"1",0
16,36,3,40,40,26,26,"-1",14
16,37,3,100,67,30,30,"-1",70
16,38,2,70,60,71,70,"1",0
16,39,2,0,60,43,0,"1",0
16,40,5,100,80,21,100,"-1",0
16,41,3,100,70,17,100,"-1",0
16,42,3,100,75,13,100,"-1",0
16,43,4,0,10,81,100,"1",-100
16,44,3,10,15,19,19,"1",-9
16,45,3,100,23,19,100,"-1",0
16,46,5,100,80,45,100,"-1",0
16,47,4,45,45,20,50,"-1",-5
16,48,2,100,60,18,100,"-1",0
16,49,2,0,12,11,0,"1",0
16,50,3,40,30,38,50,"-1",-10
16,51,2,0,30,26,0,"1",0
17,1,2,10,20,26,0,"1",10
17,2,3,90,48,20,80,"-1",10
17,3,2,50,42,29,50,"-1",0
17,4,3,100,100,78,100,"-1",0
17,5,4,100,40,56,100,"-1",0
17,6,4,80,75,29,100,"-1",-20
17,7,3,0,47,45,0,"1",0
17,8,3,100,45,75,100,"-1",0
17,9,3,100,60,29,100,"-1",0
17,10,3,100,46,56,100,"-1",0
17,11,4,32,21,31,70,"-1",-38
17,12,3,100,100,78,100,"-1",0
17,13,3,9,76,22,80,"1",-71
17,14,2,80,59,41,80,"-1",0
17,15,2,100,60,60,50,"-1",50
17,16,2,5,60,26,50,"1",-45
17,17,2,100,30,43,100,"-1",0
17,18,2,91,65,82,90,"-1",1
17,19,3,7,29,21,0,"1",7
17,20,2,100,20,40,100,"-1",0
17,21,2,50,60,35,80,"-1",-30
17,22,2,99,78,60,80,"-1",19
17,23,2,99,34,71,100,"-1",-1
17,24,3,8,46,14,50,"1",-42
17,25,2,100,39,14,100,"-1",0
17,26,3,100,99,29,100,"-1",0
17,27,3,50,48,45,50,"-1",0
17,28,3,40,70,20,50,"-1",-10
17,29,2,99,99,66,100,"-1",-1
17,30,3,100,69,48,100,"-1",0
17,31,3,100,55,19,100,"-1",0
17,32,3,25,50,33,100,"1",-75
17,33,3,100,87,15,100,"-1",0
17,34,3,2,43,80,0,"1",2
17,35,2,0,0,17,0,"1",0
17,36,2,100,100,26,100,"-1",0
17,37,3,5,75,30,20,"1",-15
17,38,3,100,100,71,100,"-1",0
17,39,4,100,80,43,100,"-1",0
17,40,3,99,55,21,100,"-1",-1
17,41,3,100,100,17,100,"-1",0
17,42,2,100,60,13,100,"-1",0
17,43,2,100,30,81,100,"-1",0
17,44,3,90,67,19,50,"-1",40
17,45,3,58,54,19,60,"-1",-2
17,46,3,100,88,45,100,"-1",0
17,47,3,80,32,20,50,"-1",30
17,48,3,80,87,18,100,"-1",-20
17,49,3,9,7,11,0,"1",9
17,50,3,0,7,38,0,"1",0
17,51,2,10,5,26,0,"1",10
18,1,3,0,24,26,25,"1",-25
18,2,2,25,60,20,75,"-1",-50
18,3,4,0,45,29,25,"1",-25
18,4,2,100,75,78,100,"-1",0
18,5,5,60,50,56,60,"-1",0
18,6,5,100,60,29,100,"-1",0
18,7,3,100,60,45,100,"-1",0
18,8,3,100,100,75,100,"-1",0
18,9,4,20,15,29,30,"1",-10
18,10,2,50,60,56,50,"1",0
18,11,4,70,50,31,50,"-1",20
18,12,2,100,89,78,100,"-1",0
18,13,4,0,15,22,0,"1",0
18,14,3,10,50,41,10,"1",0
18,15,2,100,77,60,100,"-1",0
18,16,2,100,56,26,90,"-1",10
18,17,2,55,36,43,55,"-1",0
18,18,2,70,70,82,80,"1",-10
18,19,2,100,89,21,75,"-1",25
18,20,3,100,47,40,75,"-1",25
18,21,3,100,80,35,100,"-1",0
18,22,2,75,100,60,75,"-1",0
18,23,2,25,60,71,25,"1",0
18,24,3,45,33,14,50,"-1",-5
18,25,4,100,35,14,80,"-1",20
18,26,2,0,35,29,0,"1",0
18,27,2,0,60,45,0,"1",0
18,28,3,70,60,20,50,"-1",20
18,29,2,99,60,66,100,"-1",-1
18,30,4,100,50,48,100,"-1",0
18,31,2,100,55,19,25,"-1",75
18,32,2,0,25,33,0,"1",0
18,33,3,60,5,15,50,"-1",10
18,34,2,100,67,80,80,"-1",20
18,35,3,0,4,17,0,"1",0
18,36,2,1,44,26,30,"1",-29
18,37,3,50,50,30,50,"-1",0
18,38,2,100,100,71,100,"-1",0
18,39,3,0,33,43,0,"1",0
18,40,3,80,44,21,80,"-1",0
18,41,2,0,30,17,0,"1",0
18,42,3,0,38,13,0,"1",0
18,43,3,25,43,81,70,"1",-45
18,44,3,5,20,19,20,"1",-15
18,45,4,50,60,19,50,"-1",0
18,46,4,100,30,45,100,"-1",0
18,47,5,100,30,20,100,"-1",0
18,48,2,100,60,18,100,"-1",0
18,49,2,0,30,11,0,"1",0
18,50,4,0,33,38,0,"1",0
18,51,2,0,50,26,0,"1",0
19,1,4,10,20,26,10,"1",0
19,2,4,30,40,20,20,"-1",10
19,3,4,5,30,29,60,"1",-55
19,4,4,100,70,78,100,"-1",0
19,5,4,100,40,56,80,"-1",20
19,6,4,30,50,29,30,"-1",0
19,7,5,100,80,45,100,"-1",0
19,8,4,70,60,75,70,"1",0
19,9,4,50,40,29,70,"-1",-20
19,10,4,100,20,56,100,"-1",0
19,11,4,30,30,31,30,"1",0
19,12,3,100,70,78,70,"-1",30
19,13,4,40,60,22,10,"-1",30
19,14,2,50,30,41,50,"-1",0
19,15,2,10,70,60,70,"1",-60
19,16,2,50,50,26,50,"-1",0
19,17,2,80,60,43,80,"-1",0
19,18,2,90,40,82,70,"-1",20
19,19,2,0,10,21,0,"1",0
19,20,2,0,10,40,0,"1",0
19,21,2,70,50,35,60,"-1",10
19,22,2,20,20,60,60,"1",-40
19,23,2,100,78,71,100,"-1",0
19,24,2,50,50,14,40,"-1",10
19,25,4,30,30,14,80,"-1",-50
19,26,4,100,90,29,100,"-1",0
19,27,3,10,20,45,50,"1",-40
19,28,3,10,10,20,50,"1",-40
19,29,2,60,70,66,80,"1",-20
19,30,4,100,30,48,80,"-1",20
19,31,2,70,40,19,80,"-1",-10
19,32,4,0,10,33,0,"1",0
19,33,4,90,80,15,20,"-1",70
19,34,2,0,10,80,30,"1",-30
19,35,4,90,80,17,70,"-1",20
19,36,2,70,70,26,60,"-1",10
19,37,4,80,90,30,80,"-1",0
19,38,2,100,100,71,100,"-1",0
19,39,2,0,20,43,0,"1",0
19,40,2,98,60,21,90,"-1",8
19,41,4,100,50,17,100,"-1",0
19,42,4,80,50,13,80,"-1",0
19,43,3,60,50,81,40,"1",20
19,44,3,0,40,19,0,"1",0
19,45,4,100,70,19,100,"-1",0
19,46,4,100,90,45,100,"-1",0
19,47,4,100,75,20,80,"-1",20
19,48,2,8,30,18,20,"1",-12
19,49,3,10,30,11,10,"1",0
19,50,3,0,20,38,0,"1",0
19,51,3,20,20,26,20,"1",0
20,1,2,0,10,26,0,"1",0
20,2,5,0,35,20,0,"1",0
20,3,3,33,33,29,0,"-1",33
20,4,4,100,78,78,100,"-1",0
20,5,3,75,65,56,55,"-1",20
20,6,2,23,45,29,20,"1",3
20,7,4,30,65,45,39,"1",-9
20,8,3,56,88,75,60,"1",-4
20,9,4,20,20,29,20,"1",0
20,10,5,30,90,56,39,"1",-9
20,11,4,0,23,31,0,"1",0
20,12,2,99,99,78,99,"-1",0
20,13,2,66,0,22,0,"-1",66
20,14,2,20,23,41,20,"1",0
20,15,2,78,78,60,60,"-1",18
20,16,2,12,0,26,12,"1",0
20,17,2,60,50,43,50,"-1",10
20,18,2,99,99,82,99,"-1",0
20,19,2,0,38,21,10,"1",-10
20,20,2,0,25,40,0,"1",0
20,21,2,50,50,35,50,"-1",0
20,22,2,45,45,60,50,"1",-5
20,23,2,50,50,71,77,"1",-27
20,24,3,37,45,14,30,"-1",7
20,25,3,0,25,14,0,"1",0
20,26,4,100,100,29,99,"-1",1
20,27,4,0,25,45,24,"1",-24
20,28,3,88,88,20,25,"-1",63
20,29,2,99,99,66,99,"-1",0
20,30,3,0,20,48,10,"1",-10
20,31,2,0,0,19,100,"1",-100
20,32,4,88,3,33,76,"-1",12
20,33,3,33,44,15,0,"-1",33
20,34,3,67,67,80,80,"1",-13
20,35,2,0,56,17,0,"1",0
20,36,2,50,76,26,76,"-1",-26
20,37,4,33,33,30,25,"-1",8
20,38,3,100,100,71,99,"-1",1
20,39,3,78,78,43,100,"-1",-22
20,40,5,89,78,21,86,"-1",3
20,41,3,80,90,17,87,"-1",-7
20,42,3,67,67,13,20,"-1",47
20,43,4,80,33,81,20,"1",60
20,44,3,13,13,19,33,"1",-20
20,45,5,99,76,19,99,"-1",0
20,46,5,100,69,45,100,"-1",0
20,47,3,33,45,20,10,"-1",23
20,48,2,65,78,18,10,"-1",55
20,49,5,0,15,11,10,"1",-10
20,50,4,0,65,38,10,"1",-10
20,51,3,50,78,26,20,"-1",30
21,1,3,0,36,26,0,"1",0
21,2,2,80,56,20,0,"-1",80
21,3,4,0,28,29,0,"1",0
21,4,2,90,10,78,85,"-1",5
21,5,4,5,45,56,15,"1",-10
21,6,2,10,26,29,25,"1",-15
21,7,4,10,57,45,50,"1",-40
21,8,3,10,65,75,10,"1",0
21,9,4,10,35,29,15,"1",-5
21,10,4,70,60,56,25,"-1",45
21,11,4,0,41,31,0,"1",0
21,12,3,40,35,78,80,"1",-40
21,13,5,15,0,22,0,"1",15
21,14,3,15,36,41,15,"1",0
21,15,2,1,5,60,0,"1",1
21,16,2,14,25,26,25,"1",-11
21,17,2,15,48,43,15,"1",0
21,18,2,78,50,82,50,"1",28
21,19,2,0,65,21,0,"1",0
21,20,2,0,3,40,0,"1",0
21,21,2,0,17,35,0,"1",0
21,22,2,25,87,60,15,"1",10
21,23,2,65,87,71,85,"1",-20
21,24,3,50,25,14,30,"-1",20
21,25,3,60,56,14,25,"-1",35
21,26,3,100,80,29,100,"-1",0
21,27,3,50,35,45,14,"-1",36
21,28,3,0,5,20,10,"1",-10
21,29,2,10,25,66,75,"1",-65
21,30,3,0,15,48,0,"1",0
21,31,2,0,26,19,0,"1",0
21,32,3,0,37,33,0,"1",0
21,33,4,100,68,15,100,"-1",0
21,34,3,0,1,80,0,"1",0
21,35,2,10,15,17,0,"1",10
21,36,2,50,78,26,65,"-1",-15
21,37,3,75,75,30,90,"-1",-15
21,38,2,100,90,71,98,"-1",2
21,39,3,25,50,43,15,"1",10
21,40,3,75,26,21,75,"-1",0
21,41,3,0,67,17,0,"1",0
21,42,3,98,75,13,75,"-1",23
21,43,3,50,56,81,50,"1",0
21,44,3,0,60,19,0,"1",0
21,45,4,37,15,19,25,"-1",12
21,46,3,0,20,45,0,"1",0
21,47,3,0,15,20,5,"1",-5
21,48,2,85,16,18,85,"-1",0
21,49,4,0,37,11,0,"1",0
21,50,3,0,37,38,0,"1",0
21,51,3,5,15,26,15,"1",-10
22,1,2,50,20,26,26,"-1",24
22,2,2,1,9,20,1,"1",0
22,3,3,10,56,29,11,"1",-1
22,4,3,100,80,78,100,"-1",0
22,5,5,40,70,56,45,"1",-5
22,6,5,100,60,29,100,"-1",0
22,7,4,100,66,45,100,"-1",0
22,8,4,99,32,75,75,"-1",24
22,9,5,0,23,29,10,"1",-10
22,10,4,32,10,56,67,"1",-35
22,11,5,100,45,31,55,"-1",45
22,12,3,100,90,78,100,"-1",0
22,13,4,0,32,22,12,"1",-12
22,14,2,77,76,41,45,"-1",32
22,15,3,67,50,60,89,"-1",-22
22,16,2,100,78,26,77,"-1",23
22,17,2,44,22,43,67,"-1",-23
22,18,2,98,23,82,89,"-1",9
22,19,2,12,14,21,12,"1",0
22,20,2,100,30,40,99,"-1",1
22,21,3,100,100,35,45,"-1",55
22,22,2,66,60,60,65,"-1",1
22,23,2,33,77,71,40,"1",-7
22,24,3,15,15,14,29,"-1",-14
22,25,2,0,5,14,12,"1",-12
22,26,5,100,78,29,100,"-1",0
22,27,2,89,78,45,98,"-1",-9
22,28,3,70,80,20,19,"-1",51
22,29,2,50,50,66,77,"1",-27
22,30,3,100,12,48,100,"-1",0
22,31,4,34,70,19,22,"-1",12
22,32,5,70,20,33,30,"-1",40
22,33,3,0,14,15,0,"1",0
22,34,3,60,60,80,80,"1",-20
22,35,2,10,15,17,10,"1",0
22,36,2,80,50,26,89,"-1",-9
22,37,5,99,70,30,33,"-1",66
22,38,2,100,100,71,100,"-1",0
22,39,3,10,12,43,34,"1",-24
22,40,5,98,44,21,100,"-1",-2
22,41,3,100,43,17,100,"-1",0
22,42,3,100,20,13,99,"-1",1
22,43,2,0,6,81,89,"1",-89
22,44,3,98,78,19,77,"-1",21
22,45,3,100,40,19,100,"-1",0
22,46,5,100,70,45,100,"-1",0
22,47,3,0,10,20,0,"1",0
22,48,2,99,20,18,99,"-1",0
22,49,3,100,56,11,100,"-1",0
22,50,2,11,11,38,38,"1",-27
22,51,2,50,50,26,25,"-1",25
23,1,3,5,5,26,20,"1",-15
23,2,3,10,5,20,10,"1",0
23,3,2,30,30,29,5,"-1",25
23,4,4,60,40,78,90,"1",-30
23,5,4,50,50,56,40,"1",10
23,6,4,20,30,29,10,"1",10
23,7,4,60,50,45,30,"-1",30
23,8,4,90,80,75,90,"-1",0
23,9,4,0,5,29,5,"1",-5
23,10,4,90,70,56,70,"-1",20
23,11,4,5,5,31,10,"1",-5
23,12,4,90,70,78,80,"-1",10
23,13,2,0,5,22,0,"1",0
23,14,3,90,60,41,60,"-1",30
23,15,2,10,10,60,20,"1",-10
23,16,4,5,10,26,5,"1",0
23,17,2,10,15,43,10,"1",0
23,18,2,20,30,82,30,"1",-10
23,19,2,0,10,21,0,"1",0
23,20,2,0,15,40,5,"1",-5
23,21,2,10,10,35,20,"1",-10
23,22,3,80,80,60,40,"-1",40
23,23,2,60,50,71,40,"1",20
23,24,4,20,20,14,5,"-1",15
23,25,2,90,50,14,90,"-1",0
23,26,2,100,70,29,90,"-1",10
23,27,2,0,5,45,10,"1",-10
23,28,3,10,10,20,20,"1",-10
23,29,4,90,70,66,70,"-1",20
23,30,3,10,20,48,10,"1",0
23,31,2,20,70,19,50,"-1",-30
23,32,4,80,50,33,30,"-1",50
23,33,4,40,30,15,50,"-1",-10
23,34,2,30,30,80,30,"1",0
23,35,4,10,50,17,20,"1",-10
23,36,4,50,50,26,10,"-1",40
23,37,4,30,40,30,70,"0",-40
23,38,3,100,90,71,90,"-1",10
23,39,4,70,70,43,80,"-1",-10
23,40,2,90,80,21,60,"-1",30
23,41,2,90,90,17,20,"-1",70
23,42,3,0,40,13,20,"1",-20
23,43,2,5,15,81,90,"1",-85
23,44,3,5,10,19,10,"1",-5
23,45,2,80,40,19,90,"-1",-10
23,46,3,10,30,45,5,"1",5
23,47,3,5,10,20,0,"1",5
23,48,3,30,5,18,5,"-1",25
23,49,4,0,5,11,0,"1",0
23,50,2,0,10,38,0,"1",0
23,51,4,70,50,26,0,"-1",70
24,1,2,2,9,26,2,"1",0
24,2,5,1,11,20,2,"1",-1
24,3,5,60,50,29,80,"-1",-20
24,4,4,25,40,78,24,"1",1
24,5,5,50,35,56,70,"1",-20
24,6,4,5,12,29,5,"1",0
24,7,2,65,35,45,40,"-1",25
24,8,4,80,20,75,80,"-1",0
24,9,4,85,35,29,35,"-1",50
24,10,4,50,60,56,65,"1",-15
24,11,4,40,18,31,45,"-1",-5
24,12,2,20,75,78,24,"1",-4
24,13,5,18,10,22,10,"1",8
24,14,2,22,18,41,25,"1",-3
24,15,2,95,40,60,85,"-1",10
24,16,4,27,80,26,80,"-1",-53
24,17,3,95,70,43,85,"-1",10
24,18,2,50,75,82,40,"1",10
24,19,3,90,38,21,90,"-1",0
24,20,4,60,42,40,70,"-1",-10
24,21,3,95,69,35,85,"-1",10
24,22,3,80,65,60,65,"-1",15
24,23,2,95,89,71,95,"-1",0
24,24,3,12,12,14,12,"1",0
24,25,4,20,60,14,60,"-1",-40
24,26,3,100,86,29,100,"-1",0
24,27,2,80,70,45,60,"-1",20
24,28,3,50,55,20,50,"-1",0
24,29,2,90,70,66,90,"-1",0
24,30,3,0,24,48,5,"1",-5
24,31,2,8,21,19,80,"1",-72
24,32,5,100,21,33,100,"-1",0
24,33,3,100,30,15,100,"-1",0
24,34,2,20,58,80,21,"1",-1
24,35,2,0,68,17,0,"1",0
24,36,3,50,26,26,50,"-1",0
24,37,3,80,38,30,85,"-1",-5
24,38,2,90,80,71,95,"-1",-5
24,39,3,75,19,43,75,"-1",0
24,40,4,0,12,21,0,"1",0
24,41,4,40,34,17,60,"-1",-20
24,42,4,100,35,13,100,"-1",0
24,43,2,5,38,81,100,"1",-95
24,44,3,5,30,19,10,"1",-5
24,45,3,0,19,19,22,"1",-22
24,46,5,100,40,45,100,"-1",0
24,47,3,5,18,20,20,"1",-15
24,48,3,50,20,18,50,"-1",0
24,49,2,30,40,11,40,"-1",-10
24,50,3,5,48,38,5,"1",0
24,51,3,25,28,26,26,"1",-1
25,1,3,0,5,26,0,"1",0
25,2,2,30,50,20,17,"-1",13
25,3,4,50,50,29,50,"-1",0
25,4,2,100,25,78,68,"-1",32
25,5,5,100,10,56,100,"-1",0
25,6,3,30,20,29,30,"-1",0
25,7,4,100,50,45,100,"-1",0
25,8,3,90,80,75,80,"-1",10
25,9,5,100,50,29,100,"-1",0
25,10,4,25,60,56,80,"1",-55
25,11,5,90,90,31,70,"-1",20
25,12,2,100,95,78,100,"-1",0
25,13,5,30,15,22,25,"-1",5
25,14,2,15,30,41,30,"1",-15
25,15,2,75,60,60,80,"-1",-5
25,16,2,25,50,26,25,"1",0
25,17,2,80,82,43,80,"-1",0
25,18,2,60,60,82,80,"1",-20
25,19,2,10,30,21,0,"1",10
25,20,2,75,45,40,0,"-1",75
25,21,2,30,60,35,60,"1",-30
25,22,2,100,100,60,60,"-1",40
25,23,2,50,75,71,70,"1",-20
25,24,3,2,2,14,15,"1",-13
25,25,2,10,25,14,10,"1",0
25,26,5,100,68,29,100,"-1",0
25,27,2,50,20,45,100,"-1",-50
25,28,3,26,20,20,20,"-1",6
25,29,2,80,50,66,80,"-1",0
25,30,2,0,20,48,0,"1",0
25,31,4,80,30,19,70,"-1",10
25,32,4,100,50,33,100,"-1",0
25,33,3,25,75,15,20,"-1",5
25,34,3,85,75,80,75,"-1",10
25,35,2,0,10,17,0,"1",0
25,36,2,30,30,26,50,"-1",-20
25,37,4,50,20,30,30,"-1",20
25,38,2,100,99,71,68,"-1",32
25,39,2,0,20,43,0,"1",0
25,40,3,0,0,21,0,"1",0
25,41,3,100,20,17,100,"-1",0
25,42,3,50,20,13,50,"-1",0
25,43,3,10,70,81,100,"1",-90
25,44,3,30,30,19,20,"-1",10
25,45,4,20,5,19,50,"-1",-30
25,46,5,100,30,45,100,"-1",0
25,47,3,0,20,20,10,"1",-10
25,48,2,0,10,18,0,"1",0
25,49,2,0,10,11,0,"1",0
25,50,3,0,10,38,0,"1",0
25,51,2,0,25,26,0,"1",0
26,1,2,10,15,26,10,"1",0
26,2,4,40,70,20,20,"-1",20
26,3,3,60,10,29,16,"-1",44
26,4,4,100,80,78,80,"-1",20
26,5,4,5,10,56,40,"1",-35
26,6,3,20,40,29,40,"1",-20
26,7,3,20,80,45,40,"1",-20
26,8,3,50,70,75,70,"1",-20
26,9,3,80,60,29,50,"-1",30
26,10,4,50,60,56,80,"1",-30
26,11,4,5,10,31,15,"1",-10
26,12,3,80,80,78,70,"-1",10
26,13,3,10,40,22,10,"1",0
26,14,2,50,50,41,50,"-1",0
26,15,3,90,90,60,80,"-1",10
26,16,2,60,60,26,60,"-1",0
26,17,2,50,75,43,80,"-1",-30
26,18,2,20,60,82,80,"1",-60
26,19,2,30,70,21,5,"-1",25
26,20,2,0,15,40,10,"1",-10
26,21,2,50,50,35,60,"-1",-10
26,22,2,80,80,60,70,"-1",10
26,23,2,100,100,71,100,"-1",0
26,24,3,30,30,14,60,"-1",-30
26,25,5,80,40,14,60,"-1",20
26,26,3,100,90,29,100,"-1",0
26,27,2,50,50,45,80,"-1",-30
26,28,3,8,70,20,60,"1",-52
26,29,3,2,5,66,60,"1",-58
26,30,4,40,70,48,40,"1",0
26,31,4,100,80,19,10,"-1",90
26,32,4,80,20,33,40,"-1",40
26,33,4,20,50,15,20,"-1",0
26,34,2,10,30,80,80,"1",-70
26,35,2,79,5,17,20,"-1",59
26,36,2,50,70,26,30,"-1",20
26,37,4,80,80,30,40,"-1",40
26,38,3,100,100,71,7,"-1",93
26,39,2,5,20,43,0,"1",5
26,40,5,100,78,21,100,"-1",0
26,41,2,90,85,17,80,"-1",10
26,42,3,60,30,13,30,"-1",30
26,43,2,90,80,81,80,"-1",10
26,44,3,0,5,19,5,"1",-5
26,45,4,70,60,19,40,"-1",30
26,46,4,80,60,45,70,"-1",10
26,47,3,10,10,20,20,"1",-10
26,48,3,80,20,18,20,"-1",60
26,49,3,10,70,11,5,"1",5
26,50,3,20,50,38,35,"1",-15
26,51,3,0,50,26,30,"1",-30
27,1,3,80,80,26,60,"-1",20
27,2,3,2,20,20,20,"1",-18
27,3,2,5,30,29,5,"1",0
27,4,3,100,50,78,100,"-1",0
27,5,4,85,60,56,75,"-1",10
27,6,4,80,20,29,60,"-1",20
27,7,4,10,25,45,20,"1",-10
27,8,3,40,80,75,25,"1",15
27,9,3,5,20,29,5,"1",0
27,10,4,75,70,56,65,"-1",10
27,11,5,80,50,31,75,"-1",5
27,12,3,80,90,78,70,"-1",10
27,13,2,0,15,22,1,"1",-1
27,14,2,20,40,41,20,"1",0
27,15,2,10,30,60,25,"1",-15
27,16,2,10,10,26,20,"1",-10
27,17,2,10,30,43,10,"1",0
27,18,2,85,26,82,85,"-1",0
27,19,2,1,10,21,10,"1",-9
27,20,2,5,17,40,5,"1",0
27,21,2,5,5,35,20,"1",-15
27,22,2,30,30,60,10,"1",20
27,23,2,80,60,71,80,"-1",0
27,24,3,10,20,14,25,"1",-15
27,25,5,100,5,14,100,"-1",0
27,26,3,100,85,29,85,"-1",15
27,27,2,5,20,45,10,"1",-5
27,28,3,30,30,20,32,"-1",-2
27,29,2,99,99,66,75,"-1",24
27,30,4,100,30,48,100,"-1",0
27,31,2,90,40,19,5,"-1",85
27,32,4,99,50,33,95,"-1",4
27,33,3,40,60,15,85,"-1",-45
27,34,2,2,5,80,5,"1",-3
27,35,2,5,20,17,10,"1",-5
27,36,3,1,25,26,70,"1",-69
27,37,4,5,5,30,30,"1",-25
27,38,3,60,60,71,87,"1",-27
27,39,3,99,50,43,85,"-1",14
27,40,3,100,50,21,99,"-1",1
27,41,3,40,60,17,20,"-1",20
27,42,2,5,17,13,5,"1",0
27,43,4,80,20,81,10,"1",70
27,44,3,1,20,19,10,"1",-9
27,45,4,60,40,19,70,"-1",-10
27,46,5,100,90,45,100,"-1",0
27,47,3,99,40,20,50,"-1",49
27,48,4,99,30,18,99,"-1",0
27,49,3,5,10,11,5,"1",0
27,50,3,20,10,38,20,"1",0
27,51,2,10,40,26,24,"1",-14
28,1,2,2,33,26,50,"1",-48
28,2,5,8,12,20,20,"1",-12
28,3,5,90,75,29,90,"-1",0
28,4,3,100,80,78,95,"-1",5
28,5,4,80,56,56,80,"-1",0
28,6,3,3,10,29,25,"1",-22
28,7,3,100,15,45,95,"-1",5
28,8,3,89,89,75,98,"-1",-9
28,9,4,1,6,29,20,"1",-19
28,10,3,85,80,56,95,"-1",-10
28,11,4,15,10,31,15,"1",0
28,12,3,100,89,78,95,"-1",5
28,13,5,45,75,22,80,"-1",-35
28,14,2,1,2,41,25,"1",-24
28,15,2,75,80,60,60,"-1",15
28,16,2,21,3,26,5,"1",16
28,17,2,1,10,43,5,"1",-4
28,18,2,75,35,82,80,"1",-5
28,19,2,15,20,21,20,"1",-5
28,20,2,45,5,40,45,"-1",0
28,21,2,86,87,35,50,"-1",36
28,22,2,100,99,60,80,"-1",20
28,23,2,25,76,71,60,"1",-35
28,24,3,2,8,14,12,"1",-10
28,25,3,85,75,14,85,"-1",0
28,26,3,100,72,29,95,"-1",5
28,27,2,78,65,45,80,"-1",-2
28,28,3,15,15,20,20,"1",-5
28,29,3,94,85,66,90,"-1",4
28,30,3,55,45,48,75,"-1",-20
28,31,3,91,75,19,80,"-1",11
28,32,2,100,50,33,95,"-1",5
28,33,3,25,35,15,80,"-1",-55
28,34,3,75,75,80,80,"1",-5
28,35,2,0,8,17,2,"1",-2
28,36,3,78,78,26,50,"-1",28
28,37,3,70,60,30,35,"-1",35
28,38,2,96,96,71,85,"-1",11
28,39,3,2,3,43,50,"1",-48
28,40,3,5,20,21,25,"1",-20
28,41,3,95,45,17,85,"-1",10
28,42,3,80,15,13,80,"-1",0
28,43,3,20,52,81,80,"1",-60
28,44,3,2,2,19,20,"1",-18
28,45,4,98,25,19,90,"-1",8
28,46,3,0,60,45,0,"1",0
28,47,3,100,20,20,100,"-1",0
28,48,3,100,5,18,100,"-1",0
28,49,3,60,8,11,50,"-1",10
28,50,3,0,40,38,0,"1",0
28,51,2,2,50,26,2,"1",0
29,1,2,3,3,26,10,"1",-7
29,2,5,12,12,20,20,"1",-8
29,3,4,10,30,29,12,"1",-2
29,4,2,100,100,78,100,"-1",0
29,5,4,80,80,56,80,"-1",0
29,6,4,5,10,29,5,"1",0
29,7,4,70,50,45,10,"-1",60
29,8,4,50,50,75,50,"1",0
29,9,4,30,30,29,30,"-1",0
29,10,4,30,50,56,40,"1",-10
29,11,4,4,10,31,10,"1",-6
29,12,3,10,80,78,20,"1",-10
29,13,5,30,20,22,10,"-1",20
29,14,2,90,50,41,70,"-1",20
29,15,3,80,40,60,40,"-1",40
29,16,2,70,50,26,10,"-1",60
29,17,3,40,40,43,40,"1",0
29,18,2,70,60,82,80,"1",-10
29,19,2,0,30,21,0,"1",0
29,20,2,70,65,40,90,"-1",-20
29,21,3,100,90,35,70,"-1",30
29,22,2,80,80,60,80,"-1",0
29,23,2,20,50,71,80,"1",-60
29,24,3,10,10,14,20,"1",-10
29,25,3,60,40,14,10,"-1",50
29,26,5,100,100,29,100,"-1",0
29,27,3,1,1,45,80,"1",-79
29,28,3,50,50,20,10,"-1",40
29,29,2,90,90,66,80,"-1",10
29,30,3,7,10,48,5,"1",2
29,31,4,80,40,19,90,"-1",-10
29,32,4,70,20,33,70,"-1",0
29,33,4,0,30,15,3,"1",-3
29,34,3,10,10,80,10,"1",0
29,35,2,40,30,17,30,"-1",10
29,36,2,90,70,26,20,"-1",70
29,37,4,50,50,30,40,"-1",10
29,38,2,100,90,71,100,"-1",0
29,39,2,0,30,43,0,"1",0
29,40,3,80,90,21,50,"-1",30
29,41,2,80,80,17,90,"-1",-10
29,42,2,5,40,13,5,"1",0
29,43,4,20,40,81,80,"1",-60
29,44,3,100,60,19,90,"-1",10
29,45,4,70,70,19,20,"-1",50
29,46,2,0,50,45,0,"1",0
29,47,4,3,30,20,10,"1",-7
29,48,4,20,20,18,10,"-1",10
29,49,3,10,30,11,10,"1",0
29,50,4,60,50,38,20,"-1",40
29,51,3,30,30,26,20,"-1",10
30,1,5,10,15,26,15,"1",-5
30,2,4,5,6,20,20,"1",-15
30,3,4,5,25,29,5,"1",0
30,4,4,75,70,78,70,"1",5
30,5,4,25,20,56,25,"1",0
30,6,4,30,20,29,25,"-1",5
30,7,4,40,50,45,45,"1",-5
30,8,3,50,60,75,75,"1",-25
30,9,4,30,25,29,30,"-1",0
30,10,4,60,70,56,50,"-1",10
30,11,4,20,20,31,30,"1",-10
30,12,2,60,50,78,65,"1",-5
30,13,4,5,10,22,5,"1",0
30,14,2,15,20,41,35,"1",-20
30,15,2,40,55,60,50,"1",-10
30,16,2,15,25,26,15,"1",0
30,17,2,20,30,43,40,"1",-20
30,18,2,35,40,82,80,"1",-45
30,19,2,30,50,21,15,"-1",15
30,20,2,5,10,40,5,"1",0
30,21,3,40,50,35,50,"-1",-10
30,22,2,15,25,60,60,"1",-45
30,23,2,80,80,71,70,"-1",10
30,24,3,55,45,14,5,"-1",50
30,25,3,20,29,14,10,"-1",10
30,26,4,70,50,29,20,"-1",50
30,27,3,25,25,45,75,"1",-50
30,28,3,30,30,20,15,"-1",15
30,29,2,30,40,66,65,"1",-35
30,30,3,15,20,48,20,"1",-5
30,31,3,10,40,19,45,"1",-35
30,32,4,60,30,33,40,"-1",20
30,33,3,40,50,15,25,"-1",15
30,34,3,60,50,80,75,"1",-15
30,35,3,25,35,17,10,"-1",15
30,36,2,29,30,26,25,"-1",4
30,37,4,90,90,30,20,"-1",70
30,38,2,60,65,71,70,"1",-10
30,39,2,5,3,43,25,"1",-20
30,40,4,90,70,21,30,"-1",60
30,41,3,60,70,17,20,"-1",40
30,42,3,80,70,13,30,"-1",50
30,43,3,50,30,81,20,"1",30
30,44,3,5,10,19,5,"1",0
30,45,4,25,20,19,25,"-1",0
30,46,4,70,80,45,60,"-1",10
30,47,4,5,10,20,8,"1",-3
30,48,2,10,15,18,5,"1",5
30,49,3,10,15,11,10,"1",0
30,50,4,30,40,38,30,"1",0
30,51,2,1,4,26,35,"1",-34
31,1,3,19,12,26,60,"1",-41
31,2,4,48,50,20,30,"-1",18
31,3,4,10,31,29,35,"1",-25
31,4,3,70,80,78,95,"1",-25
31,5,4,80,45,56,95,"-1",-15
31,6,5,30,21,29,60,"-1",-30
31,7,4,20,48,45,40,"1",-20
31,8,3,20,30,75,80,"1",-60
31,9,4,76,23,29,87,"-1",-11
31,10,4,98,78,56,90,"-1",8
31,11,5,85,30,31,80,"-1",5
31,12,3,98,91,78,88,"-1",10
31,13,5,1,17,22,10,"1",-9
31,14,2,75,75,41,30,"-1",45
31,15,2,40,40,60,40,"1",0
31,16,3,78,22,26,70,"-1",8
31,17,2,44,65,43,36,"-1",8
31,18,2,90,70,82,90,"-1",0
31,19,2,70,23,21,70,"-1",0
31,20,2,14,30,40,15,"1",-1
31,21,3,15,15,35,30,"1",-15
31,22,2,80,80,60,60,"-1",20
31,23,2,38,63,71,25,"1",13
31,24,3,1,5,14,1,"1",0
31,25,3,98,70,14,97,"-1",1
31,26,3,99,92,29,90,"-1",9
31,27,2,12,18,45,18,"1",-6
31,28,3,40,30,20,30,"-1",10
31,29,3,80,70,66,80,"-1",0
31,30,4,30,11,48,45,"1",-15
31,31,4,90,46,19,5,"-1",85
31,32,4,98,41,33,96,"-1",2
31,33,2,1,5,15,2,"1",-1
31,34,3,80,71,80,90,"0",-10
31,35,2,30,70,17,20,"-1",10
31,36,3,60,40,26,50,"-1",10
31,37,4,70,67,30,50,"-1",20
31,38,3,99,94,71,87,"-1",12
31,39,3,13,30,43,5,"1",8
31,40,5,41,21,21,40,"-1",1
31,41,2,3,19,17,3,"1",0
31,42,3,33,48,13,11,"-1",22
31,43,4,80,67,81,15,"1",65
31,44,3,50,46,19,40,"-1",10
31,45,3,31,33,19,18,"-1",13
31,46,5,96,70,45,88,"-1",8
31,47,5,80,31,20,80,"-1",0
31,48,3,88,37,18,80,"-1",8
31,49,3,1,18,11,20,"1",-19
31,50,5,50,60,38,38,"-1",12
31,51,3,35,35,26,30,"-1",5
32,1,3,2,2,26,2,"1",0
32,2,2,12,35,20,24,"1",-12
32,3,4,0,50,29,10,"1",-10
32,4,4,100,70,78,100,"-1",0
32,5,4,1,10,56,46,"1",-45
32,6,4,50,43,29,50,"-1",0
32,7,3,0,76,45,1,"1",-1
32,8,3,80,40,75,80,"-1",0
32,9,4,43,43,29,60,"-1",-17
32,10,4,45,57,56,80,"1",-35
32,11,4,34,34,31,90,"-1",-56
32,12,3,0,76,78,10,"1",-10
32,13,4,32,10,22,10,"-1",22
32,14,2,40,12,41,40,"1",0
32,15,2,90,50,60,90,"-1",0
32,16,2,76,100,26,80,"-1",-4
32,17,3,50,50,43,67,"-1",-17
32,18,2,80,50,82,80,"1",0
32,19,2,1,70,21,0,"1",1
32,20,2,14,2,40,12,"1",2
32,21,2,100,100,35,100,"-1",0
32,22,2,70,70,60,56,"-1",14
32,23,2,80,70,71,80,"-1",0
32,24,3,5,5,14,12,"1",-7
32,25,4,98,34,14,98,"-1",0
32,26,3,100,65,29,100,"-1",0
32,27,3,50,24,45,45,"-1",5
32,28,3,20,20,20,20,"0",0
32,29,2,90,80,66,100,"-1",-10
32,30,4,70,21,48,90,"-1",-20
32,31,3,78,56,19,3,"-1",75
32,32,5,25,30,33,78,"1",-53
32,33,3,23,43,15,30,"-1",-7
32,34,3,23,43,80,15,"1",8
32,35,4,0,2,17,0,"1",0
32,36,2,80,80,26,80,"-1",0
32,37,4,76,76,30,60,"-1",16
32,38,2,100,90,71,100,"-1",0
32,39,3,0,10,43,0,"1",0
32,40,4,96,12,21,98,"-1",-2
32,41,3,50,12,17,43,"-1",7
32,42,3,80,64,13,80,"-1",0
32,43,3,10,23,81,80,"1",-70
32,44,3,0,10,19,19,"1",-19
32,45,4,78,2,19,80,"-1",-2
32,46,5,100,78,45,100,"-1",0
32,47,4,10,24,20,10,"1",0
32,48,2,50,10,18,20,"-1",30
32,49,4,1,12,11,10,"1",-9
32,50,3,65,56,38,65,"-1",0
32,51,2,0,23,26,13,"1",-13
33,1,3,20,10,26,20,"1",0
33,2,2,5,15,20,5,"1",0
33,3,2,1,20,29,1,"1",0
33,4,3,95,90,78,90,"-1",5
33,5,4,60,50,56,60,"-1",0
33,6,4,50,40,29,60,"-1",-10
33,7,2,5,40,45,10,"1",-5
33,8,2,5,50,75,5,"1",0
33,9,4,10,5,29,10,"1",0
33,10,2,20,30,56,30,"1",-10
33,11,4,10,15,31,10,"1",0
33,12,2,100,90,78,90,"-1",10
33,13,3,1,20,22,1,"1",0
33,14,2,10,10,41,20,"1",-10
33,15,2,50,30,60,50,"1",0
33,16,2,1,20,26,10,"1",-9
33,17,2,30,40,43,40,"1",-10
33,18,2,10,15,82,40,"1",-30
33,19,2,0,50,21,0,"1",0
33,20,3,80,50,40,80,"-1",0
33,21,2,10,10,35,30,"1",-20
33,22,2,100,100,60,100,"-1",0
33,23,2,10,50,71,60,"1",-50
33,24,3,40,35,14,10,"-1",30
33,25,4,40,40,14,10,"-1",30
33,26,3,100,100,29,80,"-1",20
33,27,3,80,70,45,80,"-1",0
33,28,3,30,30,20,20,"-1",10
33,29,2,80,80,66,80,"-1",0
33,30,3,5,15,48,5,"1",0
33,31,2,90,80,19,10,"-1",80
33,32,4,100,20,33,90,"-1",10
33,33,3,99,60,15,99,"-1",0
33,34,3,60,60,80,80,"1",-20
33,35,3,5,40,17,5,"1",0
33,36,2,80,80,26,20,"-1",60
33,37,3,80,70,30,80,"-1",0
33,38,2,100,90,71,100,"-1",0
33,39,2,5,60,43,5,"1",0
33,40,3,99,80,21,99,"-1",0
33,41,2,1,40,17,5,"1",-4
33,42,3,5,30,13,10,"1",-5
33,43,3,80,75,81,80,"1",0
33,44,3,20,20,19,20,"-1",0
33,45,4,20,25,19,20,"-1",0
33,46,5,40,50,45,60,"1",-20
33,47,4,100,60,20,100,"-1",0
33,48,3,80,40,18,80,"-1",0
33,49,4,5,15,11,20,"1",-15
33,50,3,5,30,38,5,"1",0
33,51,3,5,25,26,5,"1",0
34,1,4,25,5,26,65,"1",-40
34,2,5,85,20,20,75,"-1",10
34,3,2,20,0,29,0,"1",20
34,4,4,100,95,78,100,"-1",0
34,5,5,100,75,56,100,"-1",0
34,6,4,100,15,29,100,"-1",0
34,7,5,95,65,45,95,"-1",0
34,8,4,65,85,75,55,"1",10
34,9,5,85,45,29,75,"-1",10
34,10,5,100,65,56,100,"-1",0
34,11,4,10,35,31,10,"1",0
34,12,3,100,85,78,100,"-1",0
34,13,5,25,25,22,0,"-1",25
34,14,2,55,75,41,20,"-1",35
34,15,2,10,25,60,20,"1",-10
34,16,2,55,10,26,30,"-1",25
34,17,2,10,60,43,10,"1",0
34,18,2,50,85,82,65,"1",-15
34,19,2,0,55,21,0,"1",0
34,20,2,0,25,40,0,"1",0
34,21,2,5,5,35,5,"1",0
34,22,2,70,95,60,15,"-1",55
34,23,2,80,90,71,75,"-1",5
34,24,3,20,20,14,55,"-1",-35
34,25,2,5,25,14,5,"1",0
34,26,4,95,75,29,100,"-1",-5
34,27,3,55,80,45,20,"-1",35
34,28,3,70,70,20,30,"-1",40
34,29,2,60,85,66,60,"1",0
34,30,3,5,45,48,5,"1",0
34,31,2,95,20,19,5,"-1",90
34,32,5,100,15,33,100,"-1",0
34,33,3,5,10,15,5,"1",0
34,34,3,1,20,80,5,"1",-4
34,35,3,0,55,17,0,"1",0
34,36,2,85,85,26,26,"-1",59
34,37,4,65,65,30,75,"-1",-10
34,38,3,100,100,71,100,"-1",0
34,39,2,0,70,43,0,"1",0
34,40,3,0,10,21,0,"1",0
34,41,3,0,65,17,0,"1",0
34,42,4,100,25,13,100,"-1",0
34,43,3,25,55,81,45,"1",-20
34,44,3,0,10,19,0,"1",0
34,45,5,30,60,19,70,"-1",-40
34,46,5,100,75,45,100,"-1",0
34,47,2,0,10,20,0,"1",0
34,48,2,0,1,18,0,"1",0
34,49,3,5,25,11,10,"1",-5
34,50,4,0,55,38,0,"1",0
34,51,3,0,85,26,0,"1",0
35,1,5,10,10,26,20,"1",-10
35,2,5,60,60,20,60,"-1",0
35,3,5,1,10,29,1,"1",0
35,4,5,70,45,78,70,"1",0
35,5,5,90,50,56,99,"-1",-9
35,6,4,1,50,29,1,"1",0
35,7,5,80,70,45,80,"-1",0
35,8,3,99,80,75,80,"-1",19
35,9,5,1,20,29,1,"1",0
35,10,5,90,60,56,80,"-1",10
35,11,5,20,20,31,1,"1",19
35,12,2,10,80,78,80,"1",-70
35,13,5,20,1,22,1,"1",19
35,14,2,30,60,41,60,"1",-30
35,15,2,90,90,60,80,"-1",10
35,16,2,60,20,26,20,"-1",40
35,17,2,10,40,43,10,"1",0
35,18,2,90,80,82,80,"-1",10
35,19,2,1,40,21,1,"1",0
35,20,2,1,25,40,1,"1",0
35,21,2,80,80,35,80,"-1",0
35,22,2,99,99,60,99,"-1",0
35,23,2,99,70,71,99,"-1",0
35,24,3,10,10,14,14,"1",-4
35,25,5,80,40,14,80,"-1",0
35,26,3,99,60,29,99,"-1",0
35,27,2,1,30,45,1,"1",0
35,28,3,14,14,20,14,"1",0
35,29,2,99,95,66,99,"-1",0
35,30,5,1,20,48,1,"1",0
35,31,4,99,90,19,1,"-1",98
35,32,2,1,60,33,1,"1",0
35,33,3,99,30,15,1,"-1",98
35,34,3,1,20,80,20,"1",-19
35,35,2,1,40,17,1,"1",0
35,36,2,60,60,26,60,"-1",0
35,37,4,50,60,30,60,"-1",-10
35,38,2,99,99,71,99,"-1",0
35,39,4,1,60,43,1,"1",0
35,40,5,99,80,21,99,"-1",0
35,41,3,15,60,17,10,"1",5
35,42,2,10,30,13,10,"1",0
35,43,3,90,70,81,1,"-1",89
35,44,3,14,14,19,14,"1",0
35,45,4,60,5,19,60,"-1",0
35,46,5,99,70,45,99,"-1",0
35,47,3,1,40,20,1,"1",0
35,48,4,99,20,18,99,"-1",0
35,49,5,10,30,11,30,"1",-20
35,50,5,1,40,38,1,"1",0
35,51,4,1,30,26,1,"1",0
36,1,4,50,30,26,50,"-1",0
36,2,4,10,15,20,10,"1",0
36,3,3,0,19,29,0,"1",0
36,4,4,100,100,78,100,"-1",0
36,5,2,40,60,56,40,"1",0
36,6,4,50,30,29,65,"-1",-15
36,7,3,0,25,45,10,"1",-10
36,8,3,100,100,75,70,"-1",30
36,9,5,100,50,29,100,"-1",0
36,10,4,60,80,56,50,"-1",10
36,11,3,30,40,31,20,"1",10
36,12,2,60,60,78,70,"1",-10
36,13,3,10,0,22,0,"1",10
36,14,2,80,80,41,90,"-1",-10
36,15,2,60,60,60,25,"0",35
36,16,2,10,10,26,20,"1",-10
36,17,2,10,30,43,25,"1",-15
36,18,2,65,65,82,65,"1",0
36,19,3,0,20,21,10,"1",-10
36,20,2,15,15,40,10,"1",5
36,21,2,30,45,35,40,"1",-10
36,22,2,50,50,60,30,"1",20
36,23,2,60,60,71,75,"1",-15
36,24,3,50,50,14,10,"-1",40
36,25,3,5,10,14,10,"1",-5
36,26,3,100,80,29,100,"-1",0
36,27,3,40,60,45,40,"1",0
36,28,3,10,10,20,15,"1",-5
36,29,2,90,80,66,90,"-1",0
36,30,4,65,40,48,65,"-1",0
36,31,3,10,50,19,20,"1",-10
36,32,2,0,20,33,100,"1",-100
36,33,3,75,80,15,30,"-1",45
36,34,3,45,45,80,30,"1",15
36,35,3,40,40,17,40,"-1",0
36,36,2,0,60,26,0,"1",0
36,37,3,90,25,30,90,"-1",0
36,38,2,100,100,71,100,"-1",0
36,39,3,50,89,43,29,"-1",21
36,40,3,10,20,21,10,"1",0
36,41,3,20,20,17,25,"-1",-5
36,42,3,30,40,13,15,"-1",15
36,43,3,0,30,81,100,"1",-100
36,44,3,11,11,19,15,"1",-4
36,45,4,15,15,19,30,"1",-15
36,46,3,30,75,45,30,"1",0
36,47,4,50,25,20,60,"-1",-10
36,48,3,70,30,18,30,"-1",40
36,49,3,0,30,11,0,"1",0
36,50,3,0,18,38,0,"1",0
36,51,3,0,45,26,0,"1",0
37,1,3,10,10,26,20,"1",-10
37,2,2,5,5,20,10,"1",-5
37,3,4,0,20,29,0,"1",0
37,4,3,0,25,78,0,"1",0
37,5,4,5,5,56,5,"1",0
37,6,3,20,20,29,10,"1",10
37,7,4,75,60,45,75,"-1",0
37,8,3,10,25,75,10,"1",0
37,9,4,100,50,29,100,"-1",0
37,10,3,5,30,56,10,"1",-5
37,11,4,10,15,31,0,"1",10
37,12,2,80,80,78,80,"-1",0
37,13,4,0,10,22,0,"1",0
37,14,3,75,75,41,50,"-1",25
37,15,2,4,15,60,4,"1",0
37,16,2,0,4,26,5,"1",-5
37,17,2,4,20,43,10,"1",-6
37,18,2,50,50,82,40,"1",10
37,19,2,50,50,21,20,"-1",30
37,20,2,0,10,40,10,"1",-10
37,21,3,40,40,35,50,"-1",-10
37,22,2,80,80,60,50,"-1",30
37,23,2,0,40,71,0,"1",0
37,24,3,2,2,14,20,"1",-18
37,25,3,70,50,14,50,"-1",20
37,26,3,10,80,29,10,"1",0
37,27,2,0,15,45,0,"1",0
37,28,3,30,30,20,20,"-1",10
37,29,2,50,50,66,50,"1",0
37,30,3,50,20,48,50,"-1",0
37,31,3,100,15,19,0,"-1",100
37,32,3,100,20,33,100,"-1",0
37,33,3,100,80,15,100,"-1",0
37,34,3,0,15,80,0,"1",0
37,35,2,10,40,17,0,"1",10
37,36,2,40,40,26,25,"-1",15
37,37,4,5,5,30,10,"1",-5
37,38,3,100,100,71,50,"-1",50
37,39,2,0,5,43,0,"1",0
37,40,3,0,15,21,0,"1",0
37,41,3,0,40,17,0,"1",0
37,42,3,0,80,13,0,"1",0
37,43,3,0,10,81,100,"1",-100
37,44,3,10,10,19,20,"1",-10
37,45,4,10,10,19,10,"1",0
37,46,4,90,75,45,50,"-1",40
37,47,3,10,10,20,10,"1",0
37,48,3,70,70,18,40,"-1",30
37,49,3,80,20,11,80,"-1",0
37,50,3,5,5,38,15,"1",-10
37,51,3,50,50,26,30,"-1",20
38,1,5,35,15,26,56,"-1",-21
38,2,3,10,20,20,10,"1",0
38,3,3,10,43,29,10,"1",0
38,4,3,50,20,78,58,"1",-8
38,5,3,25,20,56,20,"1",5
38,6,2,10,30,29,10,"1",0
38,7,4,100,34,45,100,"-1",0
38,8,3,10,16,75,25,"1",-15
38,9,3,10,23,29,10,"1",0
38,10,3,12,27,56,25,"1",-13
38,11,4,56,20,31,56,"-1",0
38,12,3,75,75,78,78,"1",-3
38,13,3,0,10,22,0,"1",0
38,14,3,60,57,41,50,"-1",10
38,15,2,50,50,60,56,"1",-6
38,16,3,20,30,26,20,"1",0
38,17,3,25,60,43,27,"1",-2
38,18,2,68,37,82,80,"1",-12
38,19,3,15,20,21,10,"1",5
38,20,2,0,2,40,0,"1",0
38,21,3,50,26,35,56,"-1",-6
38,22,2,34,34,60,50,"1",-16
38,23,2,50,40,71,25,"1",25
38,24,3,1,1,14,23,"1",-22
38,25,5,100,25,14,100,"-1",0
38,26,3,100,80,29,100,"-1",0
38,27,3,15,6,45,45,"1",-30
38,28,3,12,23,20,56,"1",-44
38,29,2,60,60,66,56,"1",4
38,30,5,100,30,48,100,"-1",0
38,31,3,70,2,19,10,"-1",60
38,32,3,98,50,33,100,"-1",-2
38,33,3,40,10,15,67,"-1",-27
38,34,3,5,5,80,76,"1",-71
38,35,3,75,56,17,20,"-1",55
38,36,3,50,35,26,30,"-1",20
38,37,3,80,80,30,20,"-1",60
38,38,3,100,80,71,100,"-1",0
38,39,3,75,34,43,23,"-1",52
38,40,5,100,80,21,100,"-1",0
38,41,3,56,78,17,23,"-1",33
38,42,3,27,30,13,56,"-1",-29
38,43,3,65,59,81,26,"1",39
38,44,3,25,50,19,10,"-1",15
38,45,4,100,54,19,100,"-1",0
38,46,5,100,70,45,100,"-1",0
38,47,3,100,10,20,100,"-1",0
38,48,3,45,25,18,40,"-1",5
38,49,3,0,10,11,1,"1",-1
38,50,3,0,20,38,0,"1",0
38,51,3,0,3,26,0,"1",0
39,1,2,90,40,26,90,"-1",0
39,2,5,50,15,20,25,"-1",25
39,3,5,90,50,29,90,"-1",0
39,4,3,100,70,78,100,"-1",0
39,5,5,80,40,56,60,"-1",20
39,6,4,50,50,29,70,"-1",-20
39,7,4,25,40,45,25,"1",0
39,8,3,50,60,75,90,"1",-40
39,9,4,50,25,29,50,"-1",0
39,10,4,90,30,56,90,"-1",0
39,11,5,50,30,31,80,"-1",-30
39,12,3,90,90,78,100,"-1",-10
39,13,4,25,25,22,50,"-1",-25
39,14,2,15,50,41,20,"1",-5
39,15,2,50,50,60,15,"1",35
39,16,2,25,5,26,25,"1",0
39,17,2,50,50,43,25,"-1",25
39,18,2,10,30,82,10,"1",0
39,19,2,35,50,21,5,"-1",30
39,20,2,15,7,40,25,"1",-10
39,21,2,3,25,35,5,"1",-2
39,22,2,70,70,60,5,"-1",65
39,23,2,100,90,71,90,"-1",10
39,24,3,25,25,14,19,"-1",6
39,25,5,100,40,14,100,"-1",0
39,26,3,100,90,29,100,"-1",0
39,27,2,40,70,45,50,"1",-10
39,28,3,5,5,20,25,"1",-20
39,29,2,90,90,66,80,"-1",10
39,30,5,99,60,48,100,"-1",-1
39,31,4,10,40,19,25,"1",-15
39,32,4,50,40,33,40,"-1",10
39,33,3,80,70,15,90,"-1",-10
39,34,2,5,10,80,5,"1",0
39,35,2,3,25,17,5,"1",-2
39,36,2,75,60,26,70,"-1",5
39,37,3,90,90,30,90,"-1",0
39,38,2,100,100,71,100,"-1",0
39,39,2,0,15,43,0,"1",0
39,40,5,90,25,21,90,"-1",0
39,41,2,10,50,17,20,"1",-10
39,42,3,50,75,13,50,"-1",0
39,43,4,20,60,81,90,"1",-70
39,44,3,25,25,19,25,"-1",0
39,45,4,50,30,19,50,"-1",0
39,46,5,99,40,45,100,"-1",-1
39,47,3,50,60,20,50,"-1",0
39,48,3,90,70,18,50,"-1",40
39,49,3,15,10,11,15,"-1",0
39,50,3,0,15,38,0,"1",0
39,51,2,2,5,26,0,"1",2
40,1,2,45,40,26,19,"-1",26
40,2,2,8,10,20,14,"1",-6
40,3,4,25,35,29,12,"1",13
40,4,3,90,95,78,89,"-1",1
40,5,4,10,30,56,32,"1",-22
40,6,3,25,35,29,21,"1",4
40,7,3,5,35,45,29,"1",-24
40,8,3,60,70,75,69,"1",-9
40,9,4,10,15,29,56,"1",-46
40,10,2,19,59,56,43,"1",-24
40,11,4,28,38,31,18,"1",10
40,12,2,90,90,78,88,"-1",2
40,13,4,15,18,22,19,"1",-4
40,14,2,19,10,41,67,"1",-48
40,15,2,35,30,60,40,"1",-5
40,16,2,5,7,26,7,"1",-2
40,17,2,6,15,43,9,"1",-3
40,18,2,65,56,82,76,"1",-11
40,19,2,56,65,21,34,"-1",22
40,20,2,5,12,40,16,"1",-11
40,21,2,27,30,35,15,"1",12
40,22,2,45,36,60,67,"1",-22
40,23,2,45,56,71,76,"1",-31
40,24,3,35,35,14,15,"-1",20
40,25,3,9,26,14,29,"1",-20
40,26,3,89,85,29,78,"-1",11
40,27,2,46,55,45,34,"-1",12
40,28,3,35,40,20,24,"-1",11
40,29,2,85,80,66,78,"-1",7
40,30,2,10,46,48,13,"1",-3
40,31,3,99,50,19,23,"-1",76
40,32,2,5,25,33,78,"1",-73
40,33,3,25,18,15,12,"-1",13
40,34,3,70,67,80,75,"1",-5
40,35,3,45,48,17,45,"-1",0
40,36,2,67,68,26,54,"-1",13
40,37,4,45,50,30,16,"-1",29
40,38,2,85,88,71,90,"-1",-5
40,39,2,80,75,43,65,"-1",15
40,40,4,35,40,21,67,"-1",-32
40,41,3,45,25,17,13,"-1",32
40,42,3,55,60,13,24,"-1",31
40,43,3,45,30,81,49,"1",-4
40,44,3,5,7,19,12,"1",-7
40,45,4,0,25,19,12,"1",-12
40,46,4,65,70,45,75,"-1",-10
40,47,3,15,25,20,23,"1",-8
40,48,2,15,5,18,17,"1",-2
40,49,3,5,30,11,9,"1",-4
40,50,3,0,18,38,0,"1",0
40,51,3,0,23,26,23,"1",-23
41,1,3,21,20,26,20,"1",1
41,2,4,50,30,20,20,"-1",30
41,3,4,20,40,29,10,"1",10
41,4,3,80,40,78,70,"-1",10
41,5,3,40,30,56,50,"1",-10
41,6,3,25,30,29,30,"1",-5
41,7,4,25,45,45,20,"1",5
41,8,3,80,70,75,80,"-1",0
41,9,3,20,25,29,30,"1",-10
41,10,4,35,40,56,40,"1",-5
41,11,4,55,35,31,20,"-1",35
41,12,2,80,90,78,60,"-1",20
41,13,4,10,30,22,20,"1",-10
41,14,2,20,40,41,10,"1",10
41,15,2,45,40,60,55,"1",-10
41,16,2,60,50,26,20,"-1",40
41,17,2,45,50,43,45,"-1",0
41,18,2,50,40,82,70,"1",-20
41,19,2,0,30,21,0,"1",0
41,20,2,10,25,40,20,"1",-10
41,21,2,35,40,35,30,"0",5
41,22,2,66,55,60,70,"-1",-4
41,23,2,40,45,71,70,"1",-30
41,24,3,35,20,14,10,"-1",25
41,25,3,20,35,14,10,"-1",10
41,26,3,80,75,29,50,"-1",30
41,27,2,30,27,45,20,"1",10
41,28,3,12,10,20,10,"1",2
41,29,2,44,30,66,60,"1",-16
41,30,4,100,40,48,100,"-1",0
41,31,2,70,45,19,30,"-1",40
41,32,3,30,30,33,30,"1",0
41,33,3,65,50,15,50,"-1",15
41,34,2,35,25,80,60,"1",-25
41,35,2,50,60,17,30,"-1",20
41,36,2,35,40,26,40,"-1",-5
41,37,4,55,50,30,30,"-1",25
41,38,2,90,85,71,70,"-1",20
41,39,2,0,45,43,0,"1",0
41,40,3,60,70,21,60,"-1",0
41,41,3,30,40,17,10,"-1",20
41,42,3,60,45,13,30,"-1",30
41,43,3,19,25,81,30,"1",-11
41,44,3,10,20,19,12,"1",-2
41,45,3,70,50,19,30,"-1",40
41,46,4,14,20,45,20,"1",-6
41,47,3,25,20,20,15,"-1",10
41,48,3,44,50,18,20,"-1",24
41,49,3,10,20,11,10,"1",0
41,50,3,35,40,38,38,"1",-3
41,51,2,10,20,26,10,"1",0
42,1,3,5,15,26,10,"1",-5
42,2,2,50,30,20,50,"-1",0
42,3,4,30,46,29,30,"-1",0
42,4,4,100,90,78,100,"-1",0
42,5,4,30,64,56,25,"1",5
42,6,4,45,28,29,85,"-1",-40
42,7,4,20,45,45,15,"1",5
42,8,2,32,68,75,45,"1",-13
42,9,4,55,18,29,55,"-1",0
42,10,3,23,72,56,40,"1",-17
42,11,4,15,30,31,20,"1",-5
42,12,3,40,26,78,70,"1",-30
42,13,4,34,20,22,30,"-1",4
42,14,2,12,26,41,20,"1",-8
42,15,2,50,58,60,40,"1",10
42,16,2,10,18,26,15,"1",-5
42,17,2,5,17,43,20,"1",-15
42,18,2,7,20,82,10,"1",-3
42,19,2,0,24,21,0,"1",0
42,20,2,18,12,40,5,"1",13
42,21,2,24,54,35,40,"1",-16
42,22,2,100,100,60,100,"-1",0
42,23,2,72,84,71,35,"-1",37
42,24,3,8,8,14,15,"1",-7
42,25,3,60,23,14,60,"-1",0
42,26,3,95,62,29,80,"-1",15
42,27,2,4,25,45,8,"1",-4
42,28,3,25,32,20,10,"-1",15
42,29,2,70,62,66,85,"-1",-15
42,30,2,0,27,48,0,"1",0
42,31,2,85,36,19,8,"-1",77
42,32,3,15,22,33,15,"1",0
42,33,3,75,70,15,75,"-1",0
42,34,3,5,15,80,20,"1",-15
42,35,2,8,25,17,8,"1",0
42,36,2,65,65,26,25,"-1",40
42,37,3,80,56,30,80,"-1",0
42,38,2,100,96,71,100,"-1",0
42,39,2,0,32,43,0,"1",0
42,40,4,25,12,21,25,"-1",0
42,41,2,0,55,17,0,"1",0
42,42,3,90,45,13,95,"-1",-5
42,43,3,68,36,81,15,"1",53
42,44,3,5,17,19,5,"1",0
42,45,4,100,8,19,100,"-1",0
42,46,4,100,50,45,100,"-1",0
42,47,4,40,24,20,60,"-1",-20
42,48,3,65,35,18,65,"-1",0
42,49,2,0,11,11,0,"1",0
42,50,3,0,3,38,0,"1",0
42,51,2,0,24,26,0,"1",0
43,1,4,0,25,26,0,"1",0
43,2,3,22,23,20,20,"-1",2
43,3,4,0,45,29,0,"1",0
43,4,4,100,70,78,100,"-1",0
43,5,4,5,15,56,0,"1",5
43,6,3,0,22,29,0,"1",0
43,7,4,50,47,45,60,"-1",-10
43,8,4,40,55,75,25,"1",15
43,9,4,45,22,29,25,"-1",20
43,10,4,55,40,56,100,"1",-45
43,11,3,15,24,31,2,"1",13
43,12,4,100,50,78,100,"-1",0
43,13,3,45,0,22,0,"-1",45
43,14,3,54,43,41,15,"-1",39
43,15,3,50,33,60,100,"1",-50
43,16,3,25,99,26,100,"1",-75
43,17,4,25,66,43,25,"1",0
43,18,4,20,46,82,8,"1",12
43,19,3,0,43,21,0,"1",0
43,20,4,44,35,40,50,"-1",-6
43,21,4,100,33,35,100,"-1",0
43,22,4,60,55,60,99,"0",-39
43,23,4,70,38,71,100,"1",-30
43,24,3,1,12,14,12,"1",-11
43,25,3,0,44,14,0,"1",0
43,26,4,85,80,29,100,"-1",-15
43,27,4,25,50,45,55,"1",-30
43,28,4,25,33,20,5,"-1",20
43,29,4,23,33,66,100,"1",-77
43,30,3,5,55,48,0,"1",5
43,31,4,0,55,19,0,"1",0
43,32,3,10,49,33,10,"1",0
43,33,5,25,40,15,56,"-1",-31
43,34,4,35,45,80,80,"1",-45
43,35,3,0,5,17,0,"1",0
43,36,4,0,45,26,0,"1",0
43,37,3,20,44,30,10,"1",10
43,38,4,100,80,71,100,"-1",0
43,39,4,11,15,43,45,"1",-34
43,40,4,0,33,21,0,"1",0
43,41,4,100,76,17,50,"-1",50
43,42,5,15,27,13,56,"-1",-41
43,43,4,100,48,81,12,"-1",88
43,44,3,5,5,19,25,"1",-20
43,45,4,100,88,19,25,"-1",75
43,46,5,100,57,45,100,"-1",0
43,47,3,25,43,20,20,"-1",5
43,48,3,0,1,18,23,"1",-23
43,49,4,0,22,11,0,"1",0
43,50,3,100,45,38,100,"-1",0
43,51,4,40,60,26,22,"-1",18
44,1,2,3,20,26,5,"1",-2
44,2,5,10,10,20,15,"1",-5
44,3,4,5,10,29,5,"1",0
44,4,5,100,90,78,95,"-1",5
44,5,5,50,80,56,50,"1",0
44,6,4,10,10,29,20,"1",-10
44,7,4,60,40,45,60,"-1",0
44,8,3,99,99,75,60,"-1",39
44,9,4,75,50,29,50,"-1",25
44,10,3,75,75,56,50,"-1",25
44,11,4,25,20,31,50,"1",-25
44,12,3,95,95,78,90,"-1",5
44,13,4,10,1,22,2,"1",8
44,14,2,30,40,41,30,"1",0
44,15,2,90,90,60,75,"-1",15
44,16,2,5,1,26,10,"1",-5
44,17,2,5,15,43,10,"1",-5
44,18,2,5,10,82,30,"1",-25
44,19,2,5,15,21,5,"1",0
44,20,2,1,15,40,5,"1",-4
44,21,2,10,10,35,75,"1",-65
44,22,2,75,75,60,75,"-1",0
44,23,2,85,80,71,80,"-1",5
44,24,3,5,5,14,10,"1",-5
44,25,4,10,20,14,10,"1",0
44,26,4,100,95,29,100,"-1",0
44,27,2,50,50,45,95,"-1",-45
44,28,3,20,20,20,20,"0",0
44,29,2,99,99,66,90,"-1",9
44,30,3,10,25,48,15,"1",-5
44,31,2,90,75,19,70,"-1",20
44,32,4,25,20,33,20,"1",5
44,33,2,10,15,15,5,"1",5
44,34,3,5,10,80,20,"1",-15
44,35,2,5,5,17,10,"1",-5
44,36,2,95,95,26,75,"-1",20
44,37,4,80,80,30,80,"-1",0
44,38,2,95,95,71,80,"-1",15
44,39,3,99,60,43,90,"-1",9
44,40,5,95,80,21,95,"-1",0
44,41,3,80,90,17,20,"-1",60
44,42,3,2,10,13,10,"1",-8
44,43,3,25,25,81,75,"1",-50
44,44,3,10,20,19,20,"1",-10
44,45,4,25,50,19,25,"-1",0
44,46,5,100,75,45,100,"-1",0
44,47,4,100,40,20,100,"-1",0
44,48,3,100,90,18,100,"-1",0
44,49,4,1,5,11,2,"1",-1
44,50,4,100,30,38,100,"-1",0
44,51,2,5,15,26,1,"1",4
45,1,4,25,25,26,40,"1",-15
45,2,4,5,15,20,5,"1",0
45,3,3,0,35,29,0,"1",0
45,4,5,100,50,78,100,"-1",0
45,5,3,60,70,56,20,"-1",40
45,6,3,15,20,29,15,"1",0
45,7,4,100,46,45,100,"-1",0
45,8,2,10,50,75,10,"1",0
45,9,4,0,15,29,0,"1",0
45,10,4,75,55,56,75,"-1",0
45,11,4,10,20,31,10,"1",0
45,12,2,55,44,78,75,"1",-20
45,13,4,0,13,22,0,"1",0
45,14,2,35,35,41,20,"1",15
45,15,3,30,30,60,30,"1",0
45,16,2,10,30,26,10,"1",0
45,17,2,25,20,43,20,"1",5
45,18,2,35,25,82,25,"1",10
45,19,2,0,40,21,0,"1",0
45,20,2,10,25,40,20,"1",-10
45,21,2,15,15,35,30,"1",-15
45,22,2,85,65,60,80,"-1",5
45,23,2,68,75,71,70,"1",-2
45,24,3,6,20,14,50,"1",-44
45,25,4,0,12,14,10,"1",-10
45,26,3,100,99,29,100,"-1",0
45,27,3,5,35,45,10,"1",-5
45,28,3,60,50,20,40,"-1",20
45,29,2,11,27,66,20,"1",-9
45,30,3,10,30,48,10,"1",0
45,31,3,68,57,19,30,"-1",38
45,32,3,100,43,33,15,"-1",85
45,33,3,45,55,15,90,"-1",-45
45,34,3,0,10,80,10,"1",-10
45,35,3,70,47,17,30,"-1",40
45,36,3,0,12,26,0,"1",0
45,37,3,85,85,30,80,"-1",5
45,38,2,15,25,71,10,"1",5
45,39,3,10,40,43,30,"1",-20
45,40,2,100,70,21,100,"-1",0
45,41,3,100,80,17,100,"-1",0
45,42,3,10,20,13,10,"1",0
45,43,3,18,5,81,100,"1",-82
45,44,3,5,11,19,10,"1",-5
45,45,4,85,55,19,85,"-1",0
45,46,5,100,65,45,100,"-1",0
45,47,3,80,40,20,40,"-1",40
45,48,4,60,80,18,10,"-1",50
45,49,2,0,16,11,10,"1",-10
45,50,3,0,20,38,0,"1",0
45,51,2,0,56,26,10,"1",-10
46,1,4,5,5,26,20,"1",-15
46,2,5,5,20,20,50,"1",-45
46,3,4,60,70,29,20,"-1",40
46,4,5,70,60,78,60,"1",10
46,5,5,20,20,56,40,"1",-20
46,6,4,10,30,29,20,"1",-10
46,7,4,70,55,45,60,"-1",10
46,8,4,100,90,75,40,"-1",60
46,9,5,30,10,29,40,"-1",-10
46,10,4,60,80,56,60,"-1",0
46,11,5,20,20,31,40,"1",-20
46,12,3,70,70,78,20,"1",50
46,13,4,0,15,22,40,"1",-40
46,14,2,30,30,41,20,"1",10
46,15,2,70,70,60,40,"-1",30
46,16,2,50,20,26,20,"-1",30
46,17,2,20,40,43,40,"1",-20
46,18,2,60,50,82,80,"1",-20
46,19,2,0,20,21,30,"1",-30
46,20,2,60,30,40,40,"-1",20
46,21,2,40,40,35,40,"-1",0
46,22,2,90,90,60,60,"-1",30
46,23,2,10,30,71,70,"1",-60
46,24,4,0,5,14,15,"1",-15
46,25,4,10,10,14,15,"1",-5
46,26,5,100,70,29,90,"-1",10
46,27,2,0,20,45,30,"1",-30
46,28,3,40,40,20,40,"-1",0
46,29,2,70,90,66,40,"-1",30
46,30,3,10,33,48,10,"1",0
46,31,2,80,40,19,30,"-1",50
46,32,4,10,10,33,60,"1",-50
46,33,2,80,60,15,10,"-1",70
46,34,2,50,50,80,80,"1",-30
46,35,2,5,15,17,50,"1",-45
46,36,2,20,33,26,40,"1",-20
46,37,5,70,60,30,60,"-1",10
46,38,2,70,70,71,40,"1",30
46,39,2,0,15,43,20,"1",-20
46,40,5,20,20,21,75,"1",-55
46,41,4,20,70,17,30,"-1",-10
46,42,3,20,40,13,20,"-1",0
46,43,4,5,40,81,40,"1",-35
46,44,3,20,20,19,20,"-1",0
46,45,4,0,20,19,10,"1",-10
46,46,4,0,10,45,20,"1",-20
46,47,2,20,20,20,10,"0",10
46,48,2,100,50,18,30,"-1",70
46,49,2,0,10,11,10,"1",-10
46,50,2,5,20,38,15,"1",-10
46,51,2,5,15,26,20,"1",-15
47,1,2,10,10,26,10,"1",0
47,2,2,25,25,20,10,"-1",15
47,3,4,0,22,29,0,"1",0
47,4,5,100,95,78,100,"-1",0
47,5,4,0,30,56,25,"1",-25
47,6,4,0,25,29,0,"1",0
47,7,4,100,50,45,100,"-1",0
47,8,4,100,100,75,100,"-1",0
47,9,4,20,35,29,10,"1",10
47,10,5,100,50,56,100,"-1",0
47,11,4,10,17,31,0,"1",10
47,12,3,100,100,78,100,"-1",0
47,13,4,0,40,22,0,"1",0
47,14,2,10,10,41,10,"1",0
47,15,2,10,10,60,10,"1",0
47,16,2,50,11,26,50,"-1",0
47,17,2,10,12,43,10,"1",0
47,18,2,10,10,82,25,"1",-15
47,19,3,0,33,21,10,"1",-10
47,20,2,0,5,40,0,"1",0
47,21,2,30,10,35,12,"1",18
47,22,2,20,20,60,20,"1",0
47,23,2,100,80,71,22,"-1",78
47,24,3,13,10,14,25,"1",-12
47,25,5,100,85,14,100,"-1",0
47,26,4,100,95,29,100,"-1",0
47,27,2,13,13,45,15,"1",-2
47,28,3,45,45,20,13,"-1",32
47,29,3,10,10,66,66,"1",-56
47,30,4,10,10,48,10,"1",0
47,31,3,0,10,19,100,"1",-100
47,32,3,0,11,33,0,"1",0
47,33,3,0,12,15,0,"1",0
47,34,2,10,10,80,80,"1",-70
47,35,2,0,10,17,0,"1",0
47,36,2,20,20,26,20,"1",0
47,37,4,85,85,30,80,"-1",5
47,38,2,100,90,71,50,"-1",50
47,39,3,80,65,43,50,"-1",30
47,40,5,60,74,21,50,"-1",10
47,41,3,100,2,17,100,"-1",0
47,42,3,10,10,13,10,"1",0
47,43,2,20,20,81,10,"1",10
47,44,3,25,15,19,25,"-1",0
47,45,4,90,35,19,20,"-1",70
47,46,2,0,75,45,25,"1",-25
47,47,4,100,10,20,100,"-1",0
47,48,2,100,14,18,100,"-1",0
47,49,4,0,25,11,0,"1",0
47,50,2,0,44,38,0,"1",0
47,51,3,0,25,26,0,"1",0
48,1,3,10,20,26,10,"1",0
48,2,3,10,20,20,30,"1",-20
48,3,2,10,40,29,0,"1",10
48,4,4,100,70,78,100,"-1",0
48,5,4,60,70,56,50,"-1",10
48,6,3,20,20,29,50,"1",-30
48,7,3,10,50,45,20,"1",-10
48,8,4,100,100,75,100,"-1",0
48,9,3,40,20,29,50,"-1",-10
48,10,4,70,40,56,100,"-1",-30
48,11,4,50,40,31,50,"-1",0
48,12,2,100,60,78,100,"-1",0
48,13,3,35,0,22,0,"-1",35
48,14,4,100,100,41,20,"-1",80
48,15,2,90,90,60,50,"-1",40
48,16,3,40,10,26,10,"-1",30
48,17,2,50,50,43,30,"-1",20
48,18,2,20,20,82,20,"1",0
48,19,2,0,0,21,10,"1",-10
48,20,2,40,30,40,70,"0",-30
48,21,2,20,20,35,30,"1",-10
48,22,2,100,100,60,100,"-1",0
48,23,2,90,90,71,70,"-1",20
48,24,4,40,30,14,30,"-1",10
48,25,4,60,60,14,100,"-1",-40
48,26,4,100,80,29,100,"-1",0
48,27,3,70,20,45,100,"-1",-30
48,28,3,50,40,20,20,"-1",30
48,29,3,99,99,66,100,"-1",-1
48,30,4,10,20,48,50,"1",-40
48,31,3,50,20,19,80,"-1",-30
48,32,3,100,100,33,20,"-1",80
48,33,3,0,20,15,0,"1",0
48,34,3,20,20,80,80,"1",-60
48,35,3,0,10,17,0,"1",0
48,36,2,40,50,26,50,"-1",-10
48,37,3,40,40,30,30,"-1",10
48,38,3,100,100,71,100,"-1",0
48,39,3,0,30,43,0,"1",0
48,40,3,30,50,21,50,"-1",-20
48,41,3,100,50,17,100,"-1",0
48,42,3,50,35,13,20,"-1",30
48,43,3,50,40,81,50,"1",0
48,44,3,10,30,19,30,"1",-20
48,45,3,70,50,19,50,"-1",20
48,46,4,20,20,45,50,"1",-30
48,47,4,90,40,20,60,"-1",30
48,48,2,10,20,18,20,"1",-10
48,49,3,10,30,11,20,"1",-10
48,50,5,100,100,38,100,"-1",0
48,51,3,30,50,26,80,"-1",-50
49,1,4,75,25,26,70,"-1",5
49,2,5,50,5,20,20,"-1",30
49,3,4,5,56,29,5,"1",0
49,4,4,99,50,78,99,"-1",0
49,5,4,70,60,56,80,"-1",-10
49,6,4,80,25,29,50,"-1",30
49,7,4,5,50,45,40,"1",-35
49,8,4,50,86,75,75,"1",-25
49,9,4,10,40,29,5,"1",5
49,10,3,5,50,56,10,"1",-5
49,11,4,5,15,31,10,"1",-5
49,12,3,20,70,78,20,"1",0
49,13,3,10,1,22,2,"1",8
49,14,2,50,50,41,50,"-1",0
49,15,3,99,80,60,60,"-1",39
49,16,3,10,10,26,10,"1",0
49,17,2,2,20,43,2,"1",0
49,18,2,30,40,82,20,"1",10
49,19,2,2,25,21,2,"1",0
49,20,2,1,25,40,5,"1",-4
49,21,2,1,10,35,5,"1",-4
49,22,2,15,15,60,60,"1",-45
49,23,2,60,80,71,40,"1",20
49,24,3,5,5,14,12,"1",-7
49,25,4,99,25,14,99,"-1",0
49,26,3,99,50,29,99,"-1",0
49,27,2,15,60,45,2,"1",13
49,28,3,20,20,20,20,"0",0
49,29,2,50,40,66,50,"1",0
49,30,4,99,10,48,99,"-1",0
49,31,2,99,80,19,10,"-1",89
49,32,3,95,60,33,90,"-1",5
49,33,3,99,75,15,99,"-1",0
49,34,3,2,30,80,5,"1",-3
49,35,2,5,10,17,5,"1",0
49,36,3,30,30,26,20,"-1",10
49,37,3,99,95,30,80,"-1",19
49,38,3,99,95,71,78,"-1",21
49,39,4,75,50,43,80,"-1",-5
49,40,4,99,80,21,95,"-1",4
49,41,2,1,20,17,1,"1",0
49,42,3,1,17,13,1,"1",0
49,43,4,1,10,81,5,"1",-4
49,44,3,5,25,19,19,"1",-14
49,45,4,80,20,19,80,"-1",0
49,46,5,100,75,45,99,"-1",1
49,47,3,15,40,20,25,"1",-10
49,48,4,90,50,18,80,"-1",10
49,49,4,100,40,11,100,"-1",0
49,50,2,1,20,38,1,"1",0
49,51,2,1,25,26,1,"1",0
50,1,5,35,23,26,35,"-1",0
50,2,2,10,15,20,30,"1",-20
50,3,3,0,25,29,0,"1",0
50,4,4,100,85,78,99,"-1",1
50,5,5,80,55,56,75,"-1",5
50,6,4,20,25,29,50,"1",-30
50,7,2,0,35,45,0,"1",0
50,8,4,100,75,75,99,"-1",1
50,9,4,0,20,29,0,"1",0
50,10,4,30,45,56,30,"1",0
50,11,4,40,30,31,24,"-1",16
50,12,3,78,66,78,99,"0",-21
50,13,2,0,17,22,0,"1",0
50,14,2,85,65,41,75,"-1",10
50,15,2,50,45,60,40,"1",10
50,16,2,25,35,26,40,"1",-15
50,17,2,10,15,43,15,"1",-5
50,18,2,25,35,82,25,"1",0
50,19,2,0,15,21,0,"1",0
50,20,2,0,20,40,0,"1",0
50,21,2,45,65,35,40,"-1",5
50,22,2,15,25,60,30,"1",-15
50,23,2,25,35,71,30,"1",-5
50,24,3,50,50,14,12,"-1",38
50,25,4,5,12,14,10,"1",-5
50,26,5,100,75,29,99,"-1",1
50,27,3,75,55,45,75,"-1",0
50,28,3,20,15,20,14,"0",6
50,29,2,99,65,66,70,"-1",29
50,30,4,35,15,48,20,"1",15
50,31,2,99,35,19,0,"-1",99
50,32,4,65,45,33,78,"-1",-13
50,33,3,10,75,15,70,"1",-60
50,34,3,50,40,80,60,"1",-10
50,35,2,25,65,17,20,"-1",5
50,36,2,75,80,26,40,"-1",35
50,37,5,65,70,30,60,"-1",5
50,38,2,100,95,71,99,"-1",1
50,39,3,15,25,43,25,"1",-10
50,40,3,45,50,21,75,"-1",-30
50,41,5,85,70,17,76,"-1",9
50,42,3,0,25,13,0,"1",0
50,43,4,20,45,81,80,"1",-60
50,44,3,20,10,19,15,"-1",5
50,45,4,70,75,19,75,"-1",-5
50,46,3,0,56,45,0,"1",0
50,47,3,0,20,20,20,"1",-20
50,48,2,0,15,18,0,"1",0
50,49,3,20,15,11,10,"-1",10
50,50,3,0,35,38,0,"1",0
50,51,3,50,25,26,50,"-1",0
51,1,5,25,14,26,25,"1",0
51,2,5,1,15,20,13,"1",-12
51,3,4,5,28,29,12,"1",-7
51,4,2,75,50,78,77,"1",-2
51,5,5,60,42,56,50,"-1",10
51,6,2,5,12,29,10,"1",-5
51,7,2,40,13,45,45,"1",-5
51,8,4,35,15,75,25,"1",10
51,9,5,40,20,29,45,"-1",-5
51,10,5,74,63,56,87,"-1",-13
51,11,5,5,10,31,22,"1",-17
51,12,2,12,9,78,45,"1",-33
51,13,5,1,24,22,20,"1",-19
51,14,2,45,40,41,45,"-1",0
51,15,2,45,32,60,22,"1",23
51,16,2,14,68,26,25,"1",-11
51,17,2,98,21,43,78,"-1",20
51,18,2,28,30,82,65,"1",-37
51,19,2,45,33,21,30,"-1",15
51,20,2,0,12,40,33,"1",-33
51,21,2,70,55,35,77,"-1",-7
51,22,2,95,80,60,78,"-1",17
51,23,2,85,75,71,88,"-1",-3
51,24,3,5,12,14,2,"1",3
51,25,3,66,71,14,75,"-1",-9
51,26,5,100,85,29,100,"-1",0
51,27,3,22,15,45,64,"1",-42
51,28,3,45,35,20,25,"-1",20
51,29,2,87,80,66,98,"-1",-11
51,30,3,5,8,48,5,"1",0
51,31,2,5,87,19,88,"1",-83
51,32,4,90,5,33,75,"-1",15
51,33,3,10,41,15,15,"1",-5
51,34,3,5,1,80,80,"1",-75
51,35,2,1,5,17,5,"1",-4
51,36,2,50,65,26,87,"-1",-37
51,37,3,15,35,30,33,"1",-18
51,38,2,99,90,71,95,"-1",4
51,39,2,0,35,43,1,"1",-1
51,40,3,87,65,21,65,"-1",22
51,41,3,100,75,17,98,"-1",2
51,42,5,25,65,13,55,"-1",-30
51,43,4,87,56,81,99,"-1",-12
51,44,3,21,25,19,55,"-1",-34
51,45,5,5,32,19,75,"1",-70
51,46,5,100,87,45,100,"-1",0
51,47,2,15,33,20,32,"1",-17
51,48,4,22,25,18,36,"-1",-14
51,49,3,5,35,11,15,"1",-10
51,50,2,5,14,38,5,"1",0
51,51,3,50,41,26,45,"-1",5
52,1,5,5,2,26,5,"1",0
52,2,5,10,10,20,10,"1",0
52,3,4,45,5,29,5,"-1",40
52,4,5,100,80,78,100,"-1",0
52,5,5,60,12,56,100,"-1",-40
52,6,3,0,5,29,0,"1",0
52,7,5,0,10,45,0,"1",0
52,8,4,90,90,75,80,"-1",10
52,9,5,0,40,29,0,"1",0
52,10,5,15,65,56,20,"1",-5
52,11,4,40,25,31,40,"-1",0
52,12,2,100,100,78,90,"-1",10
52,13,4,0,11,22,0,"1",0
52,14,2,20,45,41,25,"1",-5
52,15,2,50,40,60,50,"1",0
52,16,2,0,5,26,0,"1",0
52,17,2,2,44,43,20,"1",-18
52,18,2,50,50,82,50,"1",0
52,19,2,5,66,21,40,"1",-35
52,20,2,12,40,40,10,"1",2
52,21,2,10,30,35,50,"1",-40
52,22,2,40,70,60,40,"1",0
52,23,2,0,65,71,0,"1",0
52,24,3,2,2,14,2,"1",0
52,25,4,0,10,14,10,"1",-10
52,26,4,50,10,29,10,"-1",40
52,27,2,1,1,45,10,"1",-9
52,28,3,80,80,20,2,"-1",78
52,29,2,1,12,66,0,"1",1
52,30,3,0,12,48,0,"1",0
52,31,5,20,30,19,10,"-1",10
52,32,4,20,70,33,20,"1",0
52,33,3,0,20,15,0,"1",0
52,34,2,2,12,80,5,"1",-3
52,35,2,15,10,17,0,"1",15
52,36,2,0,15,26,0,"1",0
52,37,5,14,35,30,30,"1",-16
52,38,2,90,90,71,90,"-1",0
52,39,2,55,20,43,30,"-1",25
52,40,4,0,70,21,0,"1",0
52,41,2,0,50,17,0,"1",0
52,42,2,0,80,13,0,"1",0
52,43,4,10,60,81,80,"1",-70
52,44,3,2,2,19,2,"1",0
52,45,4,0,60,19,0,"1",0
52,46,3,0,77,45,0,"1",0
52,47,3,0,3,20,0,"1",0
52,48,2,1,5,18,2,"1",-1
52,49,4,0,12,11,0,"1",0
52,50,2,0,35,38,0,"1",0
52,51,3,0,70,26,0,"1",0
53,1,4,20,16,26,20,"1",0
53,2,5,20,30,20,20,"0",0
53,3,3,0,40,29,10,"1",-10
53,4,4,100,90,78,80,"-1",20
53,5,4,80,80,56,80,"-1",0
53,6,2,20,10,29,20,"1",0
53,7,5,80,60,45,70,"-1",10
53,8,4,55,60,75,60,"1",-5
53,9,4,20,30,29,20,"1",0
53,10,4,70,40,56,60,"-1",10
53,11,5,30,20,31,30,"1",0
53,12,2,0,70,78,0,"1",0
53,13,4,0,10,22,10,"1",-10
53,14,2,30,20,41,20,"1",10
53,15,2,80,70,60,80,"-1",0
53,16,2,20,30,26,30,"1",-10
53,17,2,10,30,43,20,"1",-10
53,18,2,80,80,82,80,"1",0
53,19,2,20,40,21,20,"1",0
53,20,2,0,10,40,10,"1",-10
53,21,2,80,88,35,60,"-1",20
53,22,2,100,100,60,80,"-1",20
53,23,2,60,80,71,60,"1",0
53,24,4,40,40,14,60,"-1",-20
53,25,4,70,30,14,80,"-1",-10
53,26,3,100,80,29,80,"-1",20
53,27,2,88,61,45,30,"-1",58
53,28,4,60,60,20,40,"-1",20
53,29,2,70,53,66,70,"-1",0
53,30,2,10,5,48,30,"1",-20
53,31,2,98,65,19,20,"-1",78
53,32,4,80,60,33,80,"-1",0
53,33,3,10,20,15,20,"1",-10
53,34,4,70,30,80,30,"1",40
53,35,2,10,20,17,20,"1",-10
53,36,2,80,80,26,70,"-1",10
53,37,3,70,70,30,40,"-1",30
53,38,2,100,100,71,70,"-1",30
53,39,2,0,40,43,0,"1",0
53,40,4,60,80,21,80,"-1",-20
53,41,2,0,40,17,20,"1",-20
53,42,2,80,80,13,30,"-1",50
53,43,3,0,20,81,70,"1",-70
53,44,4,60,40,19,40,"-1",20
53,45,4,10,5,19,20,"1",-10
53,46,5,100,80,45,100,"-1",0
53,47,4,30,20,20,20,"-1",10
53,48,2,30,52,18,40,"-1",-10
53,49,2,0,10,11,0,"1",0
53,50,4,60,70,38,70,"-1",-10
53,51,2,40,50,26,20,"-1",20
54,1,2,13,10,26,50,"1",-37
54,2,2,2,19,20,2,"1",0
54,3,4,20,33,29,13,"1",7
54,4,5,100,80,78,99,"-1",1
54,5,5,2,33,56,10,"1",-8
54,6,5,15,22,29,20,"1",-5
54,7,4,25,25,45,45,"1",-20
54,8,5,100,78,75,88,"-1",12
54,9,4,2,15,29,10,"1",-8
54,10,4,78,54,56,65,"-1",13
54,11,5,2,16,31,13,"1",-11
54,12,2,98,96,78,60,"-1",38
54,13,4,10,29,22,25,"1",-15
54,14,2,78,35,41,55,"-1",23
54,15,2,65,42,60,19,"-1",46
54,16,2,27,24,26,30,"-1",-3
54,17,2,5,26,43,5,"1",0
54,18,2,96,28,82,87,"-1",9
54,19,2,0,67,21,0,"1",0
54,20,2,0,17,40,3,"1",-3
54,21,2,10,25,35,34,"1",-24
54,22,2,80,76,60,88,"-1",-8
54,23,2,99,90,71,99,"-1",0
54,24,3,87,76,14,50,"-1",37
54,25,5,100,40,14,95,"-1",5
54,26,5,99,95,29,99,"-1",0
54,27,2,20,16,45,60,"1",-40
54,28,3,33,17,20,50,"-1",-17
54,29,2,99,97,66,98,"-1",1
54,30,3,0,16,48,21,"1",-21
54,31,2,78,17,19,58,"-1",20
54,32,5,88,45,33,33,"-1",55
54,33,3,5,66,15,10,"1",-5
54,34,3,0,13,80,80,"1",-80
54,35,2,2,33,17,3,"1",-1
54,36,2,0,46,26,2,"1",-2
54,37,4,50,58,30,30,"-1",20
54,38,2,100,96,71,95,"-1",5
54,39,2,0,47,43,0,"1",0
54,40,5,0,13,21,25,"1",-25
54,41,3,33,28,17,66,"-1",-33
54,42,3,100,76,13,30,"-1",70
54,43,4,32,32,81,60,"1",-28
54,44,3,98,33,19,99,"-1",-1
54,45,3,20,33,19,25,"-1",-5
54,46,5,98,78,45,68,"-1",30
54,47,3,68,70,20,68,"-1",0
54,48,2,0,5,18,2,"1",-2
54,49,4,50,51,11,67,"-1",-17
54,50,3,3,46,38,22,"1",-19
54,51,3,25,33,26,40,"1",-15
55,1,4,10,10,26,25,"1",-15
55,2,2,10,10,20,20,"1",-10
55,3,4,0,30,29,0,"1",0
55,4,4,100,80,78,100,"-1",0
55,5,4,50,50,56,50,"1",0
55,6,4,60,30,29,80,"-1",-20
55,7,4,50,50,45,60,"-1",-10
55,8,3,20,40,75,50,"1",-30
55,9,4,5,10,29,25,"1",-20
55,10,4,40,40,56,80,"1",-40
55,11,4,5,15,31,20,"1",-15
55,12,3,100,50,78,100,"-1",0
55,13,4,0,5,22,0,"1",0
55,14,2,10,30,41,20,"1",-10
55,15,2,20,20,60,25,"1",-5
55,16,2,10,15,26,20,"1",-10
55,17,2,20,20,43,40,"1",-20
55,18,2,50,50,82,70,"1",-20
55,19,2,10,15,21,10,"1",0
55,20,2,5,5,40,10,"1",-5
55,21,3,30,30,35,20,"1",10
55,22,2,10,30,60,50,"1",-40
55,23,2,80,40,71,70,"-1",10
55,24,3,20,20,14,14,"-1",6
55,25,4,0,25,14,50,"1",-50
55,26,4,100,80,29,100,"-1",0
55,27,3,2,15,45,50,"1",-48
55,28,3,20,20,20,25,"0",-5
55,29,2,30,40,66,40,"1",-10
55,30,4,0,20,48,50,"1",-50
55,31,4,80,40,19,10,"-1",70
55,32,4,100,30,33,100,"-1",0
55,33,3,100,40,15,100,"-1",0
55,34,3,100,80,80,100,"-1",0
55,35,2,10,20,17,10,"1",0
55,36,2,80,80,26,40,"-1",40
55,37,4,50,50,30,50,"-1",0
55,38,2,80,90,71,40,"-1",40
55,39,4,80,40,43,100,"-1",-20
55,40,3,90,50,21,100,"-1",-10
55,41,3,100,30,17,80,"-1",20
55,42,3,0,60,13,50,"1",-50
55,43,3,90,80,81,70,"-1",20
55,44,4,20,20,19,50,"-1",-30
55,45,4,80,20,19,100,"-1",-20
55,46,4,10,30,45,10,"1",0
55,47,4,10,10,20,25,"1",-15
55,48,4,100,20,18,100,"-1",0
55,49,3,0,5,11,0,"1",0
55,50,4,10,20,38,10,"1",0
55,51,3,20,25,26,25,"1",-5
56,1,3,10,10,26,20,"1",-10
56,2,5,10,20,20,10,"1",0
56,3,4,50,30,29,50,"-1",0
56,4,3,50,50,78,60,"1",-10
56,5,4,75,67,56,70,"-1",5
56,6,4,10,10,29,10,"1",0
56,7,4,20,50,45,50,"1",-30
56,8,4,15,30,75,60,"1",-45
56,9,4,10,20,29,20,"1",-10
56,10,4,50,50,56,50,"1",0
56,11,4,30,25,31,50,"1",-20
56,12,2,100,100,78,100,"-1",0
56,13,4,5,10,22,10,"1",-5
56,14,3,25,25,41,30,"1",-5
56,15,3,80,80,60,50,"-1",30
56,16,3,50,50,26,60,"-1",-10
56,17,2,21,21,43,35,"1",-14
56,18,2,40,33,82,80,"1",-40
56,19,2,75,60,21,30,"-1",45
56,20,2,0,15,40,0,"1",0
56,21,3,60,60,35,60,"-1",0
56,22,2,100,100,60,90,"-1",10
56,23,2,50,60,71,60,"1",-10
56,24,3,10,10,14,10,"1",0
56,25,5,100,17,14,100,"-1",0
56,26,3,100,80,29,100,"-1",0
56,27,3,70,60,45,50,"-1",20
56,28,3,30,30,20,20,"-1",10
56,29,2,20,20,66,25,"1",-5
56,30,5,100,30,48,100,"-1",0
56,31,3,50,50,19,20,"-1",30
56,32,4,30,20,33,80,"1",-50
56,33,3,50,20,15,30,"-1",20
56,34,2,0,30,80,50,"1",-50
56,35,2,0,0,17,10,"1",-10
56,36,2,60,50,26,70,"-1",-10
56,37,5,15,10,30,25,"1",-10
56,38,2,100,100,71,80,"-1",20
56,39,3,50,40,43,50,"-1",0
56,40,3,0,0,21,0,"1",0
56,41,3,50,50,17,60,"-1",-10
56,42,3,10,20,13,20,"1",-10
56,43,2,50,50,81,100,"1",-50
56,44,3,15,15,19,15,"1",0
56,45,4,15,10,19,60,"1",-45
56,46,5,50,50,45,50,"-1",0
56,47,3,0,9,20,20,"1",-20
56,48,3,15,10,18,40,"1",-25
56,49,3,0,23,11,10,"1",-10
56,50,3,20,20,38,25,"1",-5
56,51,2,40,30,26,20,"-1",20
57,1,4,5,5,26,50,"1",-45
57,2,2,5,25,20,5,"1",0
57,3,4,0,25,29,0,"1",0
57,4,4,100,60,78,100,"-1",0
57,5,4,40,50,56,50,"1",-10
57,6,4,25,25,29,75,"1",-50
57,7,4,100,80,45,100,"-1",0
57,8,3,25,75,75,50,"1",-25
57,9,4,50,25,29,50,"-1",0
57,10,4,10,50,56,100,"1",-90
57,11,4,10,10,31,20,"1",-10
57,12,3,75,75,78,75,"1",0
57,13,4,25,0,22,0,"-1",25
57,14,2,10,20,41,10,"1",0
57,15,2,50,50,60,75,"1",-25
57,16,2,25,50,26,50,"1",-25
57,17,2,50,85,43,40,"-1",10
57,18,2,20,20,82,50,"1",-30
57,19,2,75,20,21,50,"-1",25
57,20,2,0,25,40,0,"1",0
57,21,3,85,85,35,50,"-1",35
57,22,2,100,100,60,100,"-1",0
57,23,2,90,90,71,95,"-1",-5
57,24,3,25,5,14,25,"-1",0
57,25,3,95,20,14,95,"-1",0
57,26,3,100,80,29,100,"-1",0
57,27,2,0,5,45,0,"1",0
57,28,3,15,15,20,20,"1",-5
57,29,2,65,65,66,95,"1",-30
57,30,3,1,20,48,5,"1",-4
57,31,4,0,25,19,100,"1",-100
57,32,2,0,25,33,100,"1",-100
57,33,3,99,17,15,100,"-1",-1
57,34,3,75,75,80,80,"1",-5
57,35,2,0,15,17,1,"1",-1
57,36,3,50,50,26,50,"-1",0
57,37,4,5,10,30,10,"1",-5
57,38,3,100,20,71,95,"-1",5
57,39,3,0,45,43,0,"1",0
57,40,3,99,80,21,100,"-1",-1
57,41,3,75,50,17,80,"-1",-5
57,42,3,100,5,13,100,"-1",0
57,43,3,50,80,81,50,"1",0
57,44,3,10,10,19,10,"1",0
57,45,4,10,20,19,10,"1",0
57,46,5,100,65,45,100,"-1",0
57,47,3,10,30,20,10,"1",0
57,48,3,100,20,18,100,"-1",0
57,49,4,100,20,11,100,"-1",0
57,50,5,2,15,38,5,"1",-3
57,51,3,100,40,26,100,"-1",0
58,1,3,0,20,26,0,"1",0
58,2,3,0,0,20,0,"1",0
58,3,4,0,40,29,0,"1",0
58,4,3,100,90,78,100,"-1",0
58,5,4,90,88,56,100,"-1",-10
58,6,4,20,15,29,20,"1",0
58,7,4,90,70,45,90,"-1",0
58,8,2,55,90,75,50,"1",5
58,9,4,70,70,29,50,"-1",20
58,10,4,70,90,56,20,"-1",50
58,11,4,29,29,31,10,"1",19
58,12,3,100,100,78,100,"-1",0
58,13,4,76,0,22,0,"-1",76
58,14,4,100,100,41,0,"-1",100
58,15,2,85,79,60,85,"-1",0
58,16,2,15,20,26,20,"1",-5
58,17,2,40,60,43,20,"1",20
58,18,2,50,50,82,82,"1",-32
58,19,2,0,76,21,0,"1",0
58,20,2,0,2,40,0,"1",0
58,21,2,70,70,35,85,"-1",-15
58,22,2,80,100,60,100,"-1",-20
58,23,3,50,65,71,20,"1",30
58,24,3,10,10,14,14,"1",-4
58,25,4,20,10,14,80,"-1",-60
58,26,3,100,80,29,100,"-1",0
58,27,3,80,80,45,0,"-1",80
58,28,3,28,28,20,8,"-1",20
58,29,2,80,90,66,60,"-1",20
58,30,4,30,60,48,30,"1",0
58,31,2,0,56,19,0,"1",0
58,32,4,12,12,33,0,"1",12
58,33,3,10,56,15,0,"1",10
58,34,3,10,40,80,80,"1",-70
58,35,2,60,87,17,0,"-1",60
58,36,3,0,78,26,0,"1",0
58,37,4,80,100,30,30,"-1",50
58,38,3,100,100,71,80,"-1",20
58,39,2,0,80,43,0,"1",0
58,40,4,100,78,21,100,"-1",0
58,41,3,56,50,17,50,"-1",6
58,42,3,40,40,13,0,"-1",40
58,43,3,40,23,81,80,"1",-40
58,44,3,0,50,19,0,"1",0
58,45,3,0,30,19,0,"1",0
58,46,4,10,50,45,10,"1",0
58,47,4,0,20,20,0,"1",0
58,48,3,80,70,18,80,"-1",0
58,49,4,0,40,11,0,"1",0
58,50,4,0,30,38,0,"1",0
58,51,3,50,50,26,50,"-1",0
59,1,2,0,10,26,0,"1",0
59,2,5,0,8,20,0,"1",0
59,3,4,100,40,29,38,"-1",62
59,4,4,70,60,78,70,"1",0
59,5,5,100,40,56,60,"-1",40
59,6,4,15,20,29,25,"1",-10
59,7,3,70,35,45,100,"-1",-30
59,8,3,100,70,75,100,"-1",0
59,9,3,10,20,29,20,"1",-10
59,10,3,60,34,56,75,"-1",-15
59,11,4,5,10,31,5,"1",0
59,12,2,0,60,78,0,"1",0
59,13,5,25,10,22,30,"-1",-5
59,14,2,30,45,41,70,"1",-40
59,15,2,5,15,60,30,"1",-25
59,16,3,10,8,26,25,"1",-15
59,17,2,10,23,43,15,"1",-5
59,18,3,38,25,82,80,"1",-42
59,19,2,0,15,21,0,"1",0
59,20,2,100,18,40,100,"-1",0
59,21,2,0,25,35,25,"1",-25
59,22,2,50,70,60,50,"1",0
59,23,2,100,65,71,100,"-1",0
59,24,3,30,50,14,11,"-1",19
59,25,3,0,12,14,0,"1",0
59,26,3,100,60,29,100,"-1",0
59,27,2,10,15,45,5,"1",5
59,28,3,15,15,20,24,"1",-9
59,29,3,40,35,66,70,"1",-30
59,30,3,0,21,48,0,"1",0
59,31,2,100,30,19,0,"-1",100
59,32,5,0,10,33,0,"1",0
59,33,3,100,70,15,100,"-1",0
59,34,3,60,45,80,60,"1",0
59,35,2,0,30,17,0,"1",0
59,36,2,80,70,26,80,"-1",0
59,37,3,20,30,30,43,"1",-23
59,38,3,90,68,71,70,"-1",20
59,39,2,0,15,43,0,"1",0
59,40,4,0,20,21,0,"1",0
59,41,3,100,15,17,100,"-1",0
59,42,3,0,65,13,0,"1",0
59,43,3,10,50,81,100,"1",-90
59,44,3,50,40,19,60,"-1",-10
59,45,3,10,5,19,10,"1",0
59,46,5,100,30,45,100,"-1",0
59,47,3,0,20,20,0,"1",0
59,48,2,0,15,18,0,"1",0
59,49,4,100,25,11,100,"-1",0
59,50,3,100,35,38,10,"-1",90
59,51,3,0,35,26,100,"1",-100
60,1,4,0,5,26,0,"1",0
60,2,5,25,25,20,20,"-1",5
60,3,3,0,40,29,0,"1",0
60,4,4,100,100,78,100,"-1",0
60,5,3,20,50,56,20,"1",0
60,6,4,20,20,29,25,"1",-5
60,7,4,0,50,45,0,"1",0
60,8,4,100,70,75,100,"-1",0
60,9,5,100,40,29,100,"-1",0
60,10,4,100,75,56,100,"-1",0
60,11,4,40,10,31,40,"-1",0
60,12,3,0,50,78,0,"1",0
60,13,3,20,0,22,0,"1",20
60,14,2,15,35,41,30,"1",-15
60,15,2,30,30,60,30,"1",0
60,16,2,18,12,26,20,"1",-2
60,17,2,12,18,43,15,"1",-3
60,18,2,10,30,82,10,"1",0
60,19,2,0,10,21,0,"1",0
60,20,3,100,25,40,100,"-1",0
60,21,4,100,50,35,60,"-1",40
60,22,3,60,60,60,60,"0",0
60,23,2,60,60,71,60,"1",0
60,24,3,3,3,14,19,"1",-16
60,25,4,25,18,14,40,"-1",-15
60,26,3,100,80,29,100,"-1",0
60,27,2,0,10,45,0,"1",0
60,28,3,18,18,20,19,"1",-1
60,29,3,50,50,66,50,"1",0
60,30,2,0,8,48,0,"1",0
60,31,3,50,80,19,40,"-1",10
60,32,5,100,50,33,100,"-1",0
60,33,3,0,5,15,0,"1",0
60,34,3,0,5,80,0,"1",0
60,35,2,0,20,17,0,"1",0
60,36,3,50,70,26,50,"-1",0
60,37,4,50,50,30,30,"-1",20
60,38,3,100,100,71,100,"-1",0
60,39,2,0,70,43,0,"1",0
60,40,3,40,60,21,60,"-1",-20
60,41,2,0,60,17,0,"1",0
60,42,3,90,60,13,80,"-1",10
60,43,4,100,75,81,20,"-1",80
60,44,3,14,14,19,18,"1",-4
60,45,5,25,25,19,50,"-1",-25
60,46,5,100,80,45,100,"-1",0
60,47,5,0,10,20,0,"1",0
60,48,5,100,30,18,100,"-1",0
60,49,3,0,20,11,0,"1",0
60,50,3,0,10,38,0,"1",0
60,51,3,70,70,26,30,"-1",40
61,1,4,10,25,26,12,"1",-2
61,2,2,70,63,20,70,"-1",0
61,3,5,70,27,29,75,"-1",-5
61,4,5,100,100,78,100,"-1",0
61,5,5,20,22,56,10,"1",10
61,6,3,15,15,29,20,"1",-5
61,7,5,0,63,45,0,"1",0
61,8,3,100,93,75,95,"-1",5
61,9,4,4,18,29,5,"1",-1
61,10,5,100,57,56,100,"-1",0
61,11,4,2,11,31,0,"1",2
61,12,3,100,82,78,100,"-1",0
61,13,4,0,12,22,0,"1",0
61,14,2,80,44,41,63,"-1",17
61,15,2,50,50,60,50,"1",0
61,16,2,0,14,26,0,"1",0
61,17,2,80,31,43,100,"-1",-20
61,18,2,92,81,82,80,"-1",12
61,19,2,0,33,21,0,"1",0
61,20,2,2,8,40,2,"1",0
61,21,3,100,29,35,100,"-1",0
61,22,2,100,100,60,100,"-1",0
61,23,2,100,100,71,100,"-1",0
61,24,3,8,8,14,8,"1",0
61,25,3,10,12,14,15,"1",-5
61,26,3,100,98,29,100,"-1",0
61,27,3,60,83,45,25,"-1",35
61,28,3,50,50,20,15,"-1",35
61,29,3,12,12,66,15,"1",-3
61,30,3,0,17,48,15,"1",-15
61,31,5,15,38,19,0,"1",15
61,32,2,0,54,33,5,"1",-5
61,33,3,0,20,15,0,"1",0
61,34,3,52,50,80,60,"1",-8
61,35,5,30,78,17,23,"-1",7
61,36,2,21,21,26,20,"1",1
61,37,3,80,45,30,80,"-1",0
61,38,3,71,71,71,100,"0",-29
61,39,4,80,45,43,40,"-1",40
61,40,5,100,87,21,100,"-1",0
61,41,2,0,5,17,10,"1",-10
61,42,3,10,13,13,12,"1",-2
61,43,3,100,42,81,12,"-1",88
61,44,3,0,17,19,11,"1",-11
61,45,4,0,4,19,0,"1",0
61,46,3,0,18,45,0,"1",0
61,47,2,0,3,20,0,"1",0
61,48,3,0,23,18,0,"1",0
61,49,3,0,10,11,0,"1",0
61,50,2,0,24,38,0,"1",0
61,51,2,0,14,26,0,"1",0
62,1,2,25,15,26,25,"1",0
62,2,3,40,20,20,20,"-1",20
62,3,3,0,25,29,0,"1",0
62,4,4,75,40,78,75,"1",0
62,5,2,50,45,56,20,"1",30
62,6,4,50,20,29,50,"-1",0
62,7,4,100,50,45,100,"-1",0
62,8,2,0,25,75,50,"1",-50
62,9,3,10,20,29,10,"1",0
62,10,2,0,50,56,0,"1",0
62,11,4,5,5,31,0,"1",5
62,12,3,0,25,78,10,"1",-10
62,13,4,20,0,22,0,"1",20
62,14,2,10,30,41,10,"1",0
62,15,2,25,20,60,50,"1",-25
62,16,3,20,50,26,60,"1",-40
62,17,2,0,34,43,0,"1",0
62,18,2,0,45,82,10,"1",-10
62,19,2,0,20,21,0,"1",0
62,20,2,0,15,40,0,"1",0
62,21,2,50,50,35,50,"-1",0
62,22,2,70,65,60,50,"-1",20
62,23,2,75,50,71,75,"-1",0
62,24,3,0,25,14,10,"1",-10
62,25,2,0,15,14,0,"1",0
62,26,4,100,70,29,100,"-1",0
62,27,2,20,60,45,10,"1",10
62,28,3,10,15,20,13,"1",-3
62,29,2,99,50,66,50,"-1",49
62,30,3,0,25,48,0,"1",0
62,31,4,0,67,19,100,"1",-100
62,32,2,0,20,33,0,"1",0
62,33,3,50,25,15,10,"-1",40
62,34,2,0,20,80,50,"1",-50
62,35,2,0,30,17,10,"1",-10
62,36,3,0,10,26,20,"1",-20
62,37,4,60,85,30,20,"-1",40
62,38,2,100,95,71,100,"-1",0
62,39,2,0,30,43,0,"1",0
62,40,3,10,10,21,0,"1",10
62,41,2,0,20,17,50,"1",-50
62,42,3,0,70,13,0,"1",0
62,43,4,70,40,81,75,"1",-5
62,44,3,0,10,19,20,"1",-20
62,45,4,75,25,19,100,"-1",-25
62,46,5,100,80,45,100,"-1",0
62,47,2,0,34,20,0,"1",0
62,48,3,100,15,18,75,"-1",25
62,49,3,100,25,11,100,"-1",0
62,50,3,0,5,38,0,"1",0
62,51,3,0,25,26,10,"1",-10
63,1,2,0,10,26,0,"1",0
63,2,3,80,40,20,80,"-1",0
63,3,3,5,25,29,15,"1",-10
63,4,5,100,80,78,100,"-1",0
63,5,4,100,50,56,80,"-1",20
63,6,3,0,40,29,0,"1",0
63,7,4,0,50,45,10,"1",-10
63,8,3,5,10,75,5,"1",0
63,9,3,5,20,29,5,"1",0
63,10,5,100,60,56,100,"-1",0
63,11,4,50,30,31,50,"-1",0
63,12,3,0,100,78,0,"1",0
63,13,5,50,10,22,26,"-1",24
63,14,3,0,40,41,0,"1",0
63,15,3,0,10,60,0,"1",0
63,16,3,0,15,26,0,"1",0
63,17,3,0,15,43,0,"1",0
63,18,3,0,20,82,5,"1",-5
63,19,2,0,25,21,0,"1",0
63,20,2,20,40,40,15,"1",5
63,21,3,0,2,35,0,"1",0
63,22,3,70,80,60,60,"-1",10
63,23,2,40,60,71,30,"1",10
63,24,3,15,15,14,15,"-1",0
63,25,5,100,40,14,100,"-1",0
63,26,3,50,70,29,70,"-1",-20
63,27,3,30,35,45,50,"1",-20
63,28,3,15,15,20,15,"1",0
63,29,3,80,80,66,80,"-1",0
63,30,5,100,30,48,100,"-1",0
63,31,3,100,30,19,5,"-1",95
63,32,3,100,30,33,5,"-1",95
63,33,3,5,10,15,5,"1",0
63,34,3,0,10,80,10,"1",-10
63,35,2,30,30,17,15,"-1",15
63,36,3,10,15,26,10,"1",0
63,37,4,100,60,30,100,"-1",0
63,38,2,100,80,71,80,"-1",20
63,39,2,0,40,43,0,"1",0
63,40,5,100,40,21,100,"-1",0
63,41,4,100,70,17,100,"-1",0
63,42,3,0,50,13,5,"1",-5
63,43,5,15,30,81,15,"1",0
63,44,2,0,10,19,0,"1",0
63,45,4,100,70,19,100,"-1",0
63,46,3,15,25,45,10,"1",5
63,47,3,5,40,20,10,"1",-5
63,48,3,100,50,18,80,"-1",20
63,49,5,100,70,11,100,"-1",0
63,50,3,5,70,38,20,"1",-15
63,51,2,0,5,26,0,"1",0
64,1,3,10,10,26,40,"1",-30
64,2,2,15,15,20,14,"1",1
64,3,4,35,35,29,5,"-1",30
64,4,3,65,65,78,78,"1",-13
64,5,2,10,29,56,1,"1",9
64,6,3,50,80,29,40,"-1",10
64,7,4,71,72,45,10,"-1",61
64,8,4,29,29,75,50,"1",-21
64,9,4,2,5,29,5,"1",-3
64,10,4,45,81,56,34,"1",11
64,11,3,5,14,31,5,"1",0
64,12,3,78,78,78,90,"0",-12
64,13,3,5,20,22,4,"1",1
64,14,2,20,41,41,30,"1",-10
64,15,3,29,29,60,45,"1",-16
64,16,2,14,3,26,30,"1",-16
64,17,2,5,40,43,2,"1",3
64,18,2,29,29,82,80,"1",-51
64,19,3,12,29,21,5,"1",7
64,20,3,5,29,40,10,"1",-5
64,21,2,29,29,35,10,"1",19
64,22,2,60,60,60,10,"0",50
64,23,2,90,90,71,90,"-1",0
64,24,3,10,10,14,30,"1",-20
64,25,3,0,29,14,1,"1",-1
64,26,4,0,19,29,1,"1",-1
64,27,2,76,76,45,5,"-1",71
64,28,3,20,20,20,30,"0",-10
64,29,2,40,65,66,98,"1",-58
64,30,3,0,15,48,0,"1",0
64,31,3,70,70,19,5,"-1",65
64,32,4,5,5,33,2,"1",3
64,33,3,1,29,15,70,"1",-69
64,34,3,60,60,80,60,"1",0
64,35,2,20,80,17,5,"-1",15
64,36,2,62,62,26,14,"-1",48
64,37,2,70,70,30,30,"-1",40
64,38,2,90,90,71,90,"-1",0
64,39,3,1,70,43,6,"1",-5
64,40,3,5,15,21,1,"1",4
64,41,4,5,70,17,5,"1",0
64,42,3,5,45,13,5,"1",0
64,43,3,33,33,81,20,"1",13
64,44,3,30,50,19,45,"-1",-15
64,45,4,5,29,19,5,"1",0
64,46,4,20,30,45,50,"1",-30
64,47,3,10,29,20,5,"1",5
64,48,3,10,41,18,5,"1",5
64,49,2,5,23,11,5,"1",0
64,50,4,8,73,38,30,"1",-22
64,51,3,70,70,26,34,"-1",36
65,1,4,54,23,26,30,"-1",24
65,2,5,15,9,20,25,"1",-10
65,3,2,0,37,29,0,"1",0
65,4,3,100,76,78,100,"-1",0
65,5,5,12,40,56,10,"1",2
65,6,4,7,7,29,20,"1",-13
65,7,4,5,19,45,5,"1",0
65,8,4,100,50,75,100,"-1",0
65,9,4,100,40,29,100,"-1",0
65,10,4,15,50,56,30,"1",-15
65,11,4,0,18,31,6,"1",-6
65,12,3,65,95,78,45,"1",20
65,13,4,15,0,22,0,"1",15
65,14,2,18,23,41,30,"1",-12
65,15,2,40,40,60,20,"1",20
65,16,2,54,32,26,30,"-1",24
65,17,2,10,40,43,10,"1",0
65,18,2,20,40,82,23,"1",-3
65,19,2,10,15,21,10,"1",0
65,20,2,0,17,40,0,"1",0
65,21,2,10,45,35,10,"1",0
65,22,2,56,56,60,50,"1",6
65,23,2,25,60,71,50,"1",-25
65,24,3,30,15,14,25,"-1",5
65,25,2,10,25,14,0,"1",10
65,26,3,100,95,29,100,"-1",0
65,27,2,65,65,45,50,"-1",15
65,28,3,45,45,20,24,"-1",21
65,29,2,78,56,66,90,"-1",-12
65,30,3,100,15,48,80,"-1",20
65,31,2,25,75,19,50,"-1",-25
65,32,4,0,30,33,50,"1",-50
65,33,3,100,70,15,80,"-1",20
65,34,2,2,9,80,76,"1",-74
65,35,2,0,30,17,0,"1",0
65,36,3,30,20,26,45,"-1",-15
65,37,3,65,45,30,12,"-1",53
65,38,2,90,80,71,70,"-1",20
65,39,2,0,60,43,0,"1",0
65,40,4,90,45,21,90,"-1",0
65,41,3,75,65,17,50,"-1",25
65,42,3,1,15,13,0,"1",1
65,43,4,20,60,81,60,"1",-40
65,44,3,1,5,19,23,"1",-22
65,45,4,50,19,19,50,"-1",0
65,46,5,100,45,45,100,"-1",0
65,47,4,100,23,20,90,"-1",10
65,48,2,90,30,18,90,"-1",0
65,49,2,10,9,11,10,"1",0
65,50,4,0,35,38,0,"1",0
65,51,2,0,46,26,0,"1",0
66,1,3,50,20,26,50,"-1",0
66,2,5,25,25,20,20,"-1",5
66,3,3,12,20,29,10,"1",2
66,4,3,99,80,78,99,"-1",0
66,5,4,90,65,56,80,"-1",10
66,6,4,16,20,29,20,"1",-4
66,7,3,0,35,45,0,"1",0
66,8,5,99,89,75,99,"-1",0
66,9,4,10,10,29,10,"1",0
66,10,4,85,80,56,85,"-1",0
66,11,4,15,15,31,25,"1",-10
66,12,2,12,26,78,50,"1",-38
66,13,4,2,10,22,10,"1",-8
66,14,2,5,25,41,10,"1",-5
66,15,2,50,50,60,50,"1",0
66,16,2,5,10,26,10,"1",-5
66,17,2,5,35,43,50,"1",-45
66,18,2,75,70,82,80,"1",-5
66,19,2,1,25,21,1,"1",0
66,20,2,0,15,40,0,"1",0
66,21,2,50,50,35,50,"-1",0
66,22,2,80,85,60,65,"-1",15
66,23,2,45,65,71,85,"1",-40
66,24,3,10,10,14,15,"1",-5
66,25,4,70,50,14,60,"-1",10
66,26,3,99,90,29,99,"-1",0
66,27,3,99,75,45,85,"-1",14
66,28,3,26,30,20,25,"-1",1
66,29,2,99,99,66,99,"-1",0
66,30,3,99,50,48,99,"-1",0
66,31,3,99,50,19,99,"-1",0
66,32,5,99,50,33,99,"-1",0
66,33,3,21,12,15,50,"-1",-29
66,34,3,10,10,80,20,"1",-10
66,35,2,0,5,17,1,"1",-1
66,36,2,85,80,26,50,"-1",35
66,37,3,50,50,30,50,"-1",0
66,38,3,99,90,71,99,"-1",0
66,39,2,0,65,43,0,"1",0
66,40,3,99,80,21,99,"-1",0
66,41,3,5,69,17,25,"1",-20
66,42,3,1,10,13,5,"1",-4
66,43,5,50,50,81,50,"1",0
66,44,3,50,65,19,50,"-1",0
66,45,4,87,56,19,85,"-1",2
66,46,3,0,26,45,1,"1",-1
66,47,3,0,10,20,10,"1",-10
66,48,3,10,15,18,10,"1",0
66,49,2,1,13,11,2,"1",-1
66,50,3,50,50,38,25,"-1",25
66,51,3,65,60,26,50,"-1",15
67,1,4,0,10,26,10,"1",-10
67,2,2,0,10,20,0,"1",0
67,3,4,0,30,29,0,"1",0
67,4,5,100,70,78,100,"-1",0
67,5,5,70,60,56,20,"-1",50
67,6,4,20,30,29,10,"1",10
67,7,2,10,60,45,10,"1",0
67,8,2,60,70,75,60,"1",0
67,9,4,0,10,29,20,"1",-20
67,10,2,10,60,56,10,"1",0
67,11,5,20,40,31,10,"1",10
67,12,4,10,80,78,30,"1",-20
67,13,5,25,0,22,0,"-1",25
67,14,2,20,30,41,30,"1",-10
67,15,2,70,60,60,60,"-1",10
67,16,2,30,10,26,10,"-1",20
67,17,2,40,30,43,40,"1",0
67,18,2,80,50,82,60,"1",20
67,19,2,0,50,21,0,"1",0
67,20,2,5,30,40,10,"1",-5
67,21,2,10,35,35,20,"1",-10
67,22,2,60,60,60,60,"0",0
67,23,2,40,50,71,40,"1",0
67,24,3,20,20,14,40,"-1",-20
67,25,3,0,30,14,0,"1",0
67,26,5,100,80,29,100,"-1",0
67,27,3,80,70,45,70,"-1",10
67,28,3,30,30,20,30,"-1",0
67,29,2,80,80,66,70,"-1",10
67,30,3,0,40,48,0,"1",0
67,31,2,100,30,19,0,"-1",100
67,32,2,80,40,33,90,"-1",-10
67,33,3,40,30,15,10,"-1",30
67,34,3,70,60,80,60,"1",10
67,35,2,10,30,17,10,"1",0
67,36,2,40,40,26,40,"-1",0
67,37,3,30,40,30,30,"0",0
67,38,3,80,80,71,80,"-1",0
67,39,2,0,50,43,0,"1",0
67,40,5,100,60,21,100,"-1",0
67,41,3,100,70,17,80,"-1",20
67,42,4,10,50,13,40,"1",-30
67,43,2,20,30,81,20,"1",0
67,44,4,90,40,19,90,"-1",0
67,45,4,80,70,19,60,"-1",20
67,46,5,100,50,45,100,"-1",0
67,47,5,10,10,20,30,"1",-20
67,48,4,80,70,18,80,"-1",0
67,49,4,5,40,11,5,"1",0
67,50,4,60,30,38,60,"-1",0
67,51,3,40,50,26,50,"-1",-10
68,1,4,50,30,26,50,"-1",0
68,2,5,20,20,20,0,"0",20
68,3,3,10,30,29,0,"1",10
68,4,4,100,80,78,100,"-1",0
68,5,4,40,30,56,20,"1",20
68,6,4,50,40,29,30,"-1",20
68,7,5,0,60,45,0,"1",0
68,8,5,100,80,75,100,"-1",0
68,9,5,80,20,29,40,"-1",40
68,10,5,80,70,56,100,"-1",-20
68,11,4,10,30,31,0,"1",10
68,12,2,100,100,78,100,"-1",0
68,13,3,0,40,22,0,"1",0
68,14,2,15,20,41,10,"1",5
68,15,2,40,40,60,15,"1",25
68,16,2,0,15,26,0,"1",0
68,17,2,10,15,43,12,"1",-2
68,18,2,25,40,82,35,"1",-10
68,19,2,0,40,21,0,"1",0
68,20,2,0,28,40,0,"1",0
68,21,2,5,25,35,15,"1",-10
68,22,2,20,50,60,15,"1",5
68,23,2,40,60,71,40,"1",0
68,24,3,60,50,14,30,"-1",30
68,25,5,100,22,14,100,"-1",0
68,26,3,100,95,29,100,"-1",0
68,27,2,0,15,45,0,"1",0
68,28,3,50,50,20,30,"-1",20
68,29,2,90,80,66,90,"-1",0
68,30,5,100,40,48,100,"-1",0
68,31,3,0,60,19,80,"1",-80
68,32,4,80,50,33,100,"-1",-20
68,33,3,100,55,15,100,"-1",0
68,34,3,0,10,80,0,"1",0
68,35,2,0,12,17,0,"1",0
68,36,2,90,40,26,60,"-1",30
68,37,3,70,80,30,40,"-1",30
68,38,2,100,100,71,100,"-1",0
68,39,4,100,70,43,100,"-1",0
68,40,4,100,78,21,100,"-1",0
68,41,3,0,50,17,0,"1",0
68,42,3,60,80,13,60,"-1",0
68,43,3,10,10,81,60,"1",-50
68,44,3,0,45,19,20,"1",-20
68,45,4,80,75,19,80,"-1",0
68,46,5,100,70,45,100,"-1",0
68,47,4,0,10,20,0,"1",0
68,48,4,40,20,18,10,"-1",30
68,49,5,100,20,11,100,"-1",0
68,50,3,0,45,38,0,"1",0
68,51,2,0,12,26,0,"1",0
69,1,4,0,20,26,80,"1",-80
69,2,2,10,10,20,10,"1",0
69,3,5,0,10,29,0,"1",0
69,4,4,100,80,78,100,"-1",0
69,5,5,0,15,56,10,"1",-10
69,6,5,100,60,29,100,"-1",0
69,7,4,100,66,45,100,"-1",0
69,8,3,100,100,75,100,"-1",0
69,9,5,100,20,29,100,"-1",0
69,10,2,0,80,56,50,"1",-50
69,11,4,5,30,31,10,"1",-5
69,12,2,100,100,78,100,"-1",0
69,13,5,20,0,22,0,"1",20
69,14,2,95,20,41,95,"-1",0
69,15,2,10,50,60,10,"1",0
69,16,2,10,0,26,5,"1",5
69,17,2,5,20,43,5,"1",0
69,18,2,90,90,82,90,"-1",0
69,19,2,0,20,21,0,"1",0
69,20,2,1,5,40,10,"1",-9
69,21,2,40,75,35,60,"-1",-20
69,22,2,80,80,60,80,"-1",0
69,23,2,100,100,71,100,"-1",0
69,24,2,3,3,14,14,"1",-11
69,25,2,0,5,14,0,"1",0
69,26,3,100,80,29,100,"-1",0
69,27,2,0,20,45,5,"1",-5
69,28,3,45,45,20,30,"-1",15
69,29,2,10,20,66,70,"1",-60
69,30,3,2,4,48,10,"1",-8
69,31,3,0,20,19,0,"1",0
69,32,4,100,40,33,100,"-1",0
69,33,3,100,70,15,0,"-1",100
69,34,3,100,100,80,50,"-1",50
69,35,2,0,5,17,0,"1",0
69,36,3,90,90,26,50,"-1",40
69,37,2,90,90,30,50,"-1",40
69,38,2,100,100,71,100,"-1",0
69,39,2,0,50,43,10,"1",-10
69,40,3,0,8,21,0,"1",0
69,41,3,0,50,17,0,"1",0
69,42,3,0,50,13,0,"1",0
69,43,4,20,80,81,50,"1",-30
69,44,3,0,30,19,0,"1",0
69,45,5,100,25,19,100,"-1",0
69,46,5,100,60,45,100,"-1",0
69,47,3,100,5,20,100,"-1",0
69,48,3,100,20,18,100,"-1",0
69,49,3,0,20,11,0,"1",0
69,50,3,10,25,38,10,"1",0
69,51,2,0,60,26,0,"1",0
70,1,4,75,45,26,70,"-1",5
70,2,2,85,15,20,85,"-1",0
70,3,3,10,30,29,5,"1",5
70,4,3,95,90,78,90,"-1",5
70,5,4,50,45,56,50,"1",0
70,6,3,25,10,29,20,"1",5
70,7,2,5,40,45,2,"1",3
70,8,2,2,60,75,2,"1",0
70,9,4,90,50,29,85,"-1",5
70,10,3,25,20,56,10,"1",15
70,11,3,5,10,31,10,"1",-5
70,12,3,10,30,78,10,"1",0
70,13,4,0,15,22,5,"1",-5
70,14,2,2,20,41,2,"1",0
70,15,2,60,50,60,60,"0",0
70,16,3,10,15,26,15,"1",-5
70,17,2,50,15,43,65,"-1",-15
70,18,2,5,25,82,5,"1",0
70,19,2,1,40,21,0,"1",1
70,20,2,0,10,40,2,"1",-2
70,21,3,50,70,35,65,"-1",-15
70,22,2,95,95,60,90,"-1",5
70,23,2,2,60,71,5,"1",-3
70,24,3,5,5,14,10,"1",-5
70,25,3,95,50,14,90,"-1",5
70,26,2,0,45,29,0,"1",0
70,27,2,0,15,45,0,"1",0
70,28,3,25,25,20,10,"-1",15
70,29,3,5,20,66,10,"1",-5
70,30,3,10,20,48,10,"1",0
70,31,3,99,50,19,0,"-1",99
70,32,3,100,50,33,100,"-1",0
70,33,3,95,55,15,95,"-1",0
70,34,3,0,30,80,0,"1",0
70,35,2,1,40,17,2,"1",-1
70,36,3,10,85,26,10,"1",0
70,37,3,15,70,30,15,"1",0
70,38,2,90,90,71,75,"-1",15
70,39,3,0,30,43,0,"1",0
70,40,3,85,50,21,80,"-1",5
70,41,3,0,50,17,0,"1",0
70,42,3,5,60,13,0,"1",5
70,43,3,95,30,81,5,"-1",90
70,44,3,5,10,19,10,"1",-5
70,45,3,75,40,19,65,"-1",10
70,46,5,100,65,45,100,"-1",0
70,47,4,100,50,20,100,"-1",0
70,48,2,5,10,18,5,"1",0
70,49,3,0,5,11,0,"1",0
70,50,3,10,20,38,10,"1",0
70,51,3,50,35,26,50,"-1",0
71,1,2,10,5,26,25,"1",-15
71,2,5,35,15,20,26,"-1",9
71,3,4,0,46,29,0,"1",0
71,4,3,100,99,78,100,"-1",0
71,5,5,89,79,56,78,"-1",11
71,6,5,45,49,29,25,"-1",20
71,7,5,0,40,45,5,"1",-5
71,8,4,28,78,75,46,"1",-18
71,9,5,10,19,29,10,"1",0
71,10,5,79,89,56,78,"-1",1
71,11,5,11,25,31,21,"1",-10
71,12,2,100,50,78,89,"-1",11
71,13,3,0,23,22,0,"1",0
71,14,2,11,19,41,18,"1",-7
71,15,2,29,25,60,34,"1",-5
71,16,2,10,29,26,15,"1",-5
71,17,2,2,25,43,5,"1",-3
71,18,2,50,18,82,45,"1",5
71,19,2,0,28,21,0,"1",0
71,20,2,5,35,40,8,"1",-3
71,21,2,39,45,35,8,"-1",31
71,22,2,50,25,60,22,"1",28
71,23,2,3,47,71,3,"1",0
71,24,3,16,17,14,17,"-1",-1
71,25,4,2,15,14,11,"1",-9
71,26,3,45,39,29,56,"-1",-11
71,27,2,8,10,45,12,"1",-4
71,28,3,28,28,20,18,"-1",10
71,29,2,89,55,66,78,"-1",11
71,30,4,100,39,48,100,"-1",0
71,31,4,100,38,19,0,"-1",100
71,32,3,100,76,33,100,"-1",0
71,33,3,100,33,15,100,"-1",0
71,34,3,8,10,80,8,"1",0
71,35,2,0,48,17,0,"1",0
71,36,3,0,27,26,0,"1",0
71,37,3,78,55,30,78,"-1",0
71,38,2,45,48,71,19,"1",26
71,39,2,50,34,43,0,"-1",50
71,40,5,5,65,21,0,"1",5
71,41,3,0,18,17,0,"1",0
71,42,3,45,59,13,68,"-1",-23
71,43,4,100,85,81,23,"-1",77
71,44,3,5,6,19,19,"1",-14
71,45,4,10,15,19,17,"1",-7
71,46,5,100,79,45,100,"-1",0
71,47,5,10,10,20,11,"1",-1
71,48,2,100,39,18,100,"-1",0
71,49,3,0,25,11,0,"1",0
71,50,2,0,28,38,0,"1",0
71,51,2,0,18,26,0,"1",0
72,1,3,50,42,26,10,"-1",40
72,2,2,30,46,20,15,"-1",15
72,3,4,2,30,29,2,"1",0
72,4,2,75,56,78,83,"1",-8
72,5,4,25,35,56,30,"1",-5
72,6,3,10,15,29,10,"1",0
72,7,4,75,19,45,75,"-1",0
72,8,4,85,42,75,85,"-1",0
72,9,4,40,19,29,15,"-1",25
72,10,4,79,85,56,79,"-1",0
72,11,3,10,25,31,15,"1",-5
72,12,3,100,100,78,85,"-1",15
72,13,3,17,5,22,2,"1",15
72,14,2,75,45,41,75,"-1",0
72,15,4,41,42,60,60,"1",-19
72,16,2,15,5,26,15,"1",0
72,17,2,50,50,43,50,"-1",0
72,18,2,10,10,82,40,"1",-30
72,19,2,2,15,21,10,"1",-8
72,20,3,70,30,40,40,"-1",30
72,21,3,45,45,35,19,"-1",26
72,22,2,50,36,60,50,"1",0
72,23,2,15,55,71,75,"1",-60
72,24,3,56,56,14,30,"-1",26
72,25,3,30,56,14,20,"-1",10
72,26,4,95,75,29,80,"-1",15
72,27,3,10,10,45,10,"1",0
72,28,3,75,70,20,30,"-1",45
72,29,2,55,50,66,60,"1",-5
72,30,3,10,29,48,5,"1",5
72,31,3,70,16,19,10,"-1",60
72,32,3,31,16,33,10,"1",21
72,33,5,85,69,15,5,"-1",80
72,34,3,60,60,80,80,"1",-20
72,35,3,10,65,17,20,"1",-10
72,36,2,55,48,26,50,"-1",5
72,37,4,30,25,30,30,"0",0
72,38,2,99,80,71,80,"-1",19
72,39,3,5,36,43,5,"1",0
72,40,3,10,60,21,10,"1",0
72,41,3,89,45,17,60,"-1",29
72,42,3,2,5,13,60,"1",-58
72,43,4,10,30,81,85,"1",-75
72,44,4,50,35,19,30,"-1",20
72,45,4,50,50,19,19,"-1",31
72,46,4,2,49,45,10,"1",-8
72,47,3,2,29,20,5,"1",-3
72,48,2,76,42,18,18,"-1",58
72,49,3,36,50,11,10,"-1",26
72,50,4,75,12,38,75,"-1",0
72,51,3,85,35,26,80,"-1",5
73,1,5,80,50,26,80,"-1",0
73,2,4,20,20,20,20,"0",0
73,3,5,100,25,29,20,"-1",80
73,4,3,100,90,78,99,"-1",1
73,5,5,50,49,56,50,"1",0
73,6,3,1,31,29,10,"1",-9
73,7,4,100,71,45,99,"-1",1
73,8,3,100,75,75,99,"-1",1
73,9,5,80,46,29,80,"-1",0
73,10,4,5,49,56,10,"1",-5
73,11,5,10,10,31,20,"1",-10
73,12,2,1,80,78,1,"1",0
73,13,5,30,10,22,20,"-1",10
73,14,3,1,15,41,10,"1",-9
73,15,2,70,80,60,99,"-1",-29
73,16,2,59,20,26,20,"-1",39
73,17,2,1,30,43,1,"1",0
73,18,2,10,70,82,10,"1",0
73,19,2,70,50,21,70,"-1",0
73,20,2,1,30,40,10,"1",-9
73,21,4,99,80,35,99,"-1",0
73,22,2,1,23,60,99,"1",-98
73,23,2,1,50,71,1,"1",0
73,24,3,35,35,14,16,"-1",19
73,25,3,1,11,14,10,"1",-9
73,26,3,100,60,29,99,"-1",1
73,27,2,20,80,45,20,"1",0
73,28,3,26,26,20,20,"-1",6
73,29,2,99,65,66,99,"-1",0
73,30,4,100,35,48,99,"-1",1
73,31,3,1,43,19,50,"1",-49
73,32,4,90,71,33,50,"-1",40
73,33,3,100,80,15,10,"-1",90
73,34,3,10,50,80,20,"1",-10
73,35,2,1,20,17,1,"1",0
73,36,3,99,78,26,99,"-1",0
73,37,4,100,38,30,99,"-1",1
73,38,2,100,100,71,99,"-1",1
73,39,2,1,63,43,1,"1",0
73,40,4,20,32,21,20,"1",0
73,41,3,10,32,17,10,"1",0
73,42,3,10,35,13,30,"1",-20
73,43,5,10,30,81,99,"1",-89
73,44,3,1,19,19,10,"1",-9
73,45,5,99,60,19,99,"-1",0
73,46,4,100,53,45,99,"-1",1
73,47,4,10,35,20,10,"1",0
73,48,3,10,10,18,10,"1",0
73,49,5,50,10,11,10,"-1",40
73,50,3,1,25,38,1,"1",0
73,51,3,5,35,26,1,"1",4
74,1,2,50,30,26,40,"-1",10
74,2,5,50,30,20,45,"-1",5
74,3,5,1,70,29,30,"1",-29
74,4,4,60,40,78,75,"1",-15
74,5,4,10,25,56,60,"1",-50
74,6,5,12,25,29,12,"1",0
74,7,5,20,32,45,20,"1",0
74,8,5,60,78,75,65,"1",-5
74,9,5,60,56,29,35,"-1",25
74,10,5,30,33,56,30,"1",0
74,11,5,50,60,31,60,"-1",-10
74,12,3,99,70,78,99,"-1",0
74,13,5,6,56,22,30,"1",-24
74,14,2,45,33,41,65,"-1",-20
74,15,2,15,20,60,30,"1",-15
74,16,2,1,10,26,10,"1",-9
74,17,2,5,10,43,20,"1",-15
74,18,2,70,55,82,65,"1",5
74,19,2,0,60,21,1,"1",-1
74,20,3,5,10,40,22,"1",-17
74,21,2,22,55,35,56,"1",-34
74,22,2,40,60,60,60,"1",-20
74,23,2,90,60,71,70,"-1",20
74,24,3,12,20,14,12,"1",0
74,25,5,60,64,14,60,"-1",0
74,26,5,99,80,29,85,"-1",14
74,27,2,70,40,45,56,"-1",14
74,28,3,60,55,20,30,"-1",30
74,29,2,99,70,66,78,"-1",21
74,30,4,2,45,48,60,"1",-58
74,31,2,70,45,19,55,"-1",15
74,32,4,10,50,33,45,"1",-35
74,33,3,90,80,15,75,"-1",15
74,34,3,80,66,80,65,"0",15
74,35,2,60,60,17,60,"-1",0
74,36,2,99,70,26,75,"-1",24
74,37,5,40,32,30,85,"-1",-45
74,38,3,100,100,71,99,"-1",1
74,39,2,1,30,43,1,"1",0
74,40,5,75,56,21,75,"-1",0
74,41,3,54,55,17,40,"-1",14
74,42,3,10,80,13,20,"1",-10
74,43,5,35,42,81,50,"1",-15
74,44,3,30,12,19,12,"-1",18
74,45,4,50,30,19,50,"-1",0
74,46,4,2,45,45,2,"1",0
74,47,5,1,30,20,20,"1",-19
74,48,5,40,80,18,50,"-1",-10
74,49,4,5,40,11,32,"1",-27
74,50,5,0,15,38,1,"1",-1
74,51,4,78,56,26,70,"-1",8
75,1,3,50,45,26,50,"-1",0
75,2,2,40,40,20,15,"-1",25
75,3,4,20,25,29,50,"1",-30
75,4,4,100,80,78,100,"-1",0
75,5,2,10,20,56,5,"1",5
75,6,3,60,40,29,45,"-1",15
75,7,3,50,50,45,50,"-1",0
75,8,2,90,90,75,85,"-1",5
75,9,4,60,30,29,30,"-1",30
75,10,4,20,40,56,29,"1",-9
75,11,5,80,45,31,90,"-1",-10
75,12,2,75,80,78,35,"1",40
75,13,4,0,10,22,11,"1",-11
75,14,2,25,25,41,20,"1",5
75,15,3,90,60,60,80,"-1",10
75,16,2,80,70,26,80,"-1",0
75,17,2,20,30,43,20,"1",0
75,18,2,80,50,82,80,"1",0
75,19,2,0,15,21,0,"1",0
75,20,2,20,15,40,45,"1",-25
75,21,3,70,50,35,70,"-1",0
75,22,2,100,100,60,100,"-1",0
75,23,2,100,99,71,100,"-1",0
75,24,3,38,40,14,25,"-1",13
75,25,2,5,10,14,0,"1",5
75,26,3,90,80,29,80,"-1",10
75,27,2,0,5,45,0,"1",0
75,28,3,25,25,20,35,"-1",-10
75,29,2,55,60,66,80,"1",-25
75,30,3,10,25,48,10,"1",0
75,31,3,100,78,19,0,"-1",100
75,32,2,35,45,33,20,"-1",15
75,33,3,10,14,15,15,"1",-5
75,34,3,40,45,80,24,"1",16
75,35,2,20,40,17,20,"-1",0
75,36,2,27,27,26,20,"-1",7
75,37,3,20,60,30,30,"1",-10
75,38,2,100,100,71,100,"-1",0
75,39,2,25,45,43,25,"1",0
75,40,4,95,79,21,89,"-1",6
75,41,3,45,50,17,20,"-1",25
75,42,3,50,55,13,5,"-1",45
75,43,3,70,40,81,30,"1",40
75,44,3,10,15,19,20,"1",-10
75,45,5,100,45,19,80,"-1",20
75,46,5,100,50,45,100,"-1",0
75,47,3,10,12,20,20,"1",-10
75,48,2,50,50,18,18,"-1",32
75,49,4,10,25,11,10,"1",0
75,50,4,0,11,38,0,"1",0
75,51,3,10,30,26,20,"1",-10
76,1,3,10,10,26,50,"1",-40
76,2,4,50,50,20,50,"-1",0
76,3,2,0,60,29,0,"1",0
76,4,5,100,95,78,100,"-1",0
76,5,4,99,60,56,99,"-1",0
76,6,4,30,30,29,40,"-1",-10
76,7,3,20,65,45,20,"1",0
76,8,3,50,85,75,50,"1",0
76,9,3,2,20,29,0,"1",2
76,10,3,50,85,56,50,"1",0
76,11,3,10,20,31,0,"1",10
76,12,3,100,99,78,100,"-1",0
76,13,4,30,0,22,0,"-1",30
76,14,2,10,30,41,10,"1",0
76,15,2,50,70,60,40,"1",10
76,16,2,10,10,26,20,"1",-10
76,17,2,20,30,43,40,"1",-20
76,18,3,99,99,82,80,"-1",19
76,19,2,2,65,21,2,"1",0
76,20,3,0,40,40,4,"1",-4
76,21,2,80,60,35,60,"-1",20
76,22,2,85,85,60,40,"-1",45
76,23,2,99,99,71,85,"-1",14
76,24,3,30,30,14,5,"-1",25
76,25,3,20,70,14,5,"-1",15
76,26,3,100,100,29,100,"-1",0
76,27,2,0,5,45,0,"1",0
76,28,3,20,20,20,5,"0",15
76,29,3,90,90,66,80,"-1",10
76,30,3,85,85,48,40,"-1",45
76,31,3,100,60,19,10,"-1",90
76,32,4,5,5,33,100,"1",-95
76,33,3,0,0,15,10,"1",-10
76,34,3,85,85,80,80,"-1",5
76,35,2,0,10,17,5,"1",-5
76,36,2,75,75,26,10,"-1",65
76,37,3,95,95,30,50,"-1",45
76,38,2,99,99,71,100,"-1",-1
76,39,2,3,80,43,10,"1",-7
76,40,3,100,80,21,100,"-1",0
76,41,3,20,90,17,50,"-1",-30
76,42,3,60,95,13,80,"-1",-20
76,43,4,95,60,81,20,"-1",75
76,44,3,5,60,19,5,"1",0
76,45,3,5,40,19,10,"1",-5
76,46,3,0,80,45,0,"1",0
76,47,3,5,25,20,20,"1",-15
76,48,3,75,75,18,80,"-1",-5
76,49,3,20,65,11,2,"-1",18
76,50,3,0,5,38,0,"1",0
76,51,2,50,75,26,50,"-1",0
77,1,4,1,7,26,10,"1",-9
77,2,2,75,62,20,82,"-1",-7
77,3,4,25,54,29,78,"1",-53
77,4,4,78,58,78,78,"0",0
77,5,2,90,87,56,10,"-1",80
77,6,3,65,25,29,87,"-1",-22
77,7,4,11,26,45,2,"1",9
77,8,4,89,97,75,78,"-1",11
77,9,4,10,10,29,10,"1",0
77,10,3,21,43,56,5,"1",16
77,11,4,46,17,31,67,"-1",-21
77,12,2,95,88,78,97,"-1",-2
77,13,4,15,10,22,67,"1",-52
77,14,5,60,80,41,85,"-1",-25
77,15,4,25,35,60,30,"1",-5
77,16,4,32,5,26,34,"-1",-2
77,17,2,8,24,43,2,"1",6
77,18,2,10,24,82,10,"1",0
77,19,5,15,72,21,15,"1",0
77,20,2,1,16,40,1,"1",0
77,21,4,44,33,35,43,"-1",1
77,22,2,90,95,60,78,"-1",12
77,23,2,30,76,71,78,"1",-48
77,24,3,15,32,14,13,"-1",2
77,25,3,5,14,14,10,"1",-5
77,26,4,95,80,29,98,"-1",-3
77,27,2,20,32,45,12,"1",8
77,28,3,11,13,20,21,"1",-10
77,29,3,71,87,66,90,"-1",-19
77,30,4,5,13,48,3,"1",2
77,31,3,76,85,19,33,"-1",43
77,32,2,5,37,33,2,"1",3
77,33,4,33,63,15,89,"-1",-56
77,34,2,10,13,80,5,"1",5
77,35,5,13,87,17,10,"1",3
77,36,4,44,67,26,33,"-1",11
77,37,2,90,90,30,85,"-1",5
77,38,2,100,98,71,89,"-1",11
77,39,3,0,78,43,0,"1",0
77,40,4,87,61,21,80,"-1",7
77,41,3,45,61,17,48,"-1",-3
77,42,3,10,30,13,1,"1",9
77,43,3,35,75,81,57,"1",-22
77,44,4,8,12,19,32,"1",-24
77,45,4,25,22,19,55,"-1",-30
77,46,4,100,67,45,100,"-1",0
77,47,5,2,35,20,2,"1",0
77,48,4,35,23,18,95,"-1",-60
77,49,3,2,5,11,5,"1",-3
77,50,4,76,55,38,89,"-1",-13
77,51,4,10,38,26,23,"1",-13
78,1,5,0,10,26,25,"1",-25
78,2,4,10,15,20,10,"1",0
78,3,5,80,55,29,80,"-1",0
78,4,4,90,80,78,90,"-1",0
78,5,5,80,45,56,70,"-1",10
78,6,4,25,10,29,35,"1",-10
78,7,4,40,30,45,80,"1",-40
78,8,4,80,90,75,70,"-1",10
78,9,4,10,10,29,10,"1",0
78,10,4,65,70,56,10,"-1",55
78,11,4,10,20,31,5,"1",5
78,12,2,80,80,78,90,"-1",-10
78,13,4,80,55,22,60,"-1",20
78,14,2,10,15,41,10,"1",0
78,15,2,25,25,60,10,"1",15
78,16,2,10,10,26,10,"1",0
78,17,2,10,10,43,10,"1",0
78,18,2,20,25,82,50,"1",-30
78,19,2,20,25,21,10,"1",10
78,20,2,5,5,40,5,"1",0
78,21,3,25,20,35,10,"1",15
78,22,2,80,80,60,20,"-1",60
78,23,2,80,75,71,60,"-1",20
78,24,4,10,10,14,10,"1",0
78,25,3,10,25,14,10,"1",0
78,26,4,80,75,29,30,"-1",50
78,27,3,25,30,45,45,"1",-20
78,28,3,50,45,20,20,"-1",30
78,29,2,90,70,66,90,"-1",0
78,30,3,2,10,48,5,"1",-3
78,31,2,10,10,19,10,"1",0
78,32,5,0,10,33,5,"1",-5
78,33,3,30,20,15,10,"-1",20
78,34,3,5,5,80,10,"1",-5
78,35,3,0,20,17,5,"1",-5
78,36,2,10,10,26,5,"1",5
78,37,4,85,85,30,35,"-1",50
78,38,3,70,70,71,90,"1",-20
78,39,4,20,30,43,20,"1",0
78,40,4,90,75,21,90,"-1",0
78,41,3,10,15,17,10,"1",0
78,42,4,5,20,13,80,"1",-75
78,43,3,25,25,81,10,"1",15
78,44,3,10,10,19,10,"1",0
78,45,4,65,25,19,60,"-1",5
78,46,5,80,80,45,80,"-1",0
78,47,4,10,12,20,5,"1",5
78,48,3,2,20,18,5,"1",-3
78,49,4,10,20,11,10,"1",0
78,50,4,15,15,38,30,"1",-15
78,51,3,80,65,26,80,"-1",0
79,1,3,10,30,26,26,"1",-16
79,2,2,10,30,20,20,"1",-10
79,3,4,65,40,29,50,"-1",15
79,4,5,70,63,78,70,"1",0
79,5,4,40,65,56,40,"1",0
79,6,3,57,40,29,30,"-1",27
79,7,2,5,40,45,5,"1",0
79,8,4,30,70,75,50,"1",-20
79,9,5,15,57,29,15,"1",0
79,10,5,50,76,56,75,"1",-25
79,11,5,55,45,31,50,"-1",5
79,12,2,80,70,78,65,"-1",15
79,13,5,40,5,22,5,"-1",35
79,14,2,25,40,41,25,"1",0
79,15,5,80,70,60,80,"-1",0
79,16,2,20,45,26,45,"1",-25
79,17,2,50,80,43,50,"-1",0
79,18,2,45,60,82,60,"1",-15
79,19,2,45,60,21,18,"-1",27
79,20,2,75,48,40,60,"-1",15
79,21,2,50,50,35,50,"-1",0
79,22,2,50,70,60,70,"1",-20
79,23,2,70,90,71,55,"1",15
79,24,3,60,50,14,15,"-1",45
79,25,3,40,80,14,47,"-1",-7
79,26,4,100,85,29,80,"-1",20
79,27,3,100,95,45,60,"-1",40
79,28,3,17,45,20,20,"1",-3
79,29,3,48,65,66,61,"1",-13
79,30,4,20,80,48,40,"1",-20
79,31,5,58,80,19,35,"-1",23
79,32,4,20,40,33,35,"1",-15
79,33,3,10,58,15,25,"1",-15
79,34,3,70,70,80,80,"1",-10
79,35,3,30,60,17,25,"-1",5
79,36,2,50,55,26,30,"-1",20
79,37,5,75,85,30,15,"-1",60
79,38,2,100,60,71,75,"-1",25
79,39,4,100,60,43,100,"-1",0
79,40,3,40,63,21,20,"-1",20
79,41,3,100,80,17,17,"-1",83
79,42,3,10,35,13,10,"1",0
79,43,4,35,60,81,35,"1",0
79,44,3,30,50,19,30,"-1",0
79,45,3,50,70,19,30,"-1",20
79,46,5,100,88,45,100,"-1",0
79,47,3,20,40,20,20,"0",0
79,48,3,40,50,18,10,"-1",30
79,49,3,15,60,11,11,"-1",4
79,50,2,10,45,38,40,"1",-30
79,51,3,45,60,26,43,"-1",2
80,1,3,70,50,26,30,"-1",40
80,2,4,40,20,20,48,"-1",-8
80,3,4,30,60,29,78,"-1",-48
80,4,2,67,40,78,68,"1",-1
80,5,4,50,40,56,78,"1",-28
80,6,2,15,30,29,36,"1",-21
80,7,4,20,40,45,36,"1",-16
80,8,4,34,68,75,76,"1",-42
80,9,4,12,37,29,48,"1",-36
80,10,4,35,60,56,34,"1",1
80,11,5,45,30,31,75,"-1",-30
80,12,2,60,45,78,60,"1",0
80,13,4,55,30,22,68,"-1",-13
80,14,2,20,20,41,26,"1",-6
80,15,2,70,40,60,68,"-1",2
80,16,2,68,30,26,56,"-1",12
80,17,2,50,30,43,60,"-1",-10
80,18,2,28,38,82,26,"1",2
80,19,2,10,37,21,15,"1",-5
80,20,2,30,45,40,25,"1",5
80,21,2,50,45,35,56,"-1",-6
80,22,2,60,75,60,65,"0",-5
80,23,2,21,38,71,17,"1",4
80,24,4,10,20,14,15,"1",-5
80,25,2,15,37,14,10,"-1",5
80,26,3,100,89,29,100,"-1",0
80,27,2,10,18,45,24,"1",-14
80,28,3,60,50,20,10,"-1",50
80,29,3,65,55,66,70,"1",-5
80,30,3,5,40,48,15,"1",-10
80,31,2,80,60,19,87,"-1",-7
80,32,4,40,35,33,78,"-1",-38
80,33,3,20,30,15,45,"-1",-25
80,34,2,80,60,80,89,"0",-9
80,35,2,20,30,17,10,"-1",10
80,36,2,25,30,26,18,"1",7
80,37,4,47,30,30,48,"-1",-1
80,38,2,75,70,71,69,"-1",6
80,39,3,20,30,43,48,"1",-28
80,40,4,10,20,21,10,"1",0
80,41,3,70,55,17,75,"-1",-5
80,42,3,88,67,13,80,"-1",8
80,43,4,30,10,81,36,"1",-6
80,44,3,20,30,19,17,"-1",3
80,45,4,79,60,19,89,"-1",-10
80,46,4,20,60,45,30,"1",-10
80,47,3,50,20,20,65,"-1",-15
80,48,3,60,50,18,74,"-1",-14
80,49,3,15,20,11,25,"-1",-10
80,50,2,40,30,38,40,"-1",0
80,51,3,60,40,26,50,"-1",10
81,1,2,5,19,26,25,"1",-20
81,2,5,50,28,20,50,"-1",0
81,3,5,50,21,29,25,"-1",25
81,4,2,100,90,78,90,"-1",10
81,5,5,50,27,56,50,"1",0
81,6,4,15,21,29,12,"1",3
81,7,5,90,50,45,90,"-1",0
81,8,3,95,90,75,95,"-1",0
81,9,4,80,30,29,90,"-1",-10
81,10,5,100,75,56,90,"-1",10
81,11,5,40,20,31,80,"-1",-40
81,12,3,100,75,78,80,"-1",20
81,13,5,5,0,22,10,"1",-5
81,14,2,20,68,41,72,"1",-52
81,15,2,26,26,60,40,"1",-14
81,16,2,68,50,26,60,"-1",8
81,17,2,12,12,43,30,"1",-18
81,18,2,90,87,82,87,"-1",3
81,19,2,10,8,21,10,"1",0
81,20,2,21,60,40,12,"1",9
81,21,2,50,50,35,35,"-1",15
81,22,2,100,100,60,80,"-1",20
81,23,2,99,85,71,100,"-1",-1
81,24,3,8,8,14,18,"1",-10
81,25,5,50,25,14,30,"-1",20
81,26,3,99,78,29,100,"-1",-1
81,27,2,100,75,45,100,"-1",0
81,28,3,20,17,20,17,"0",3
81,29,2,90,80,66,85,"-1",5
81,30,3,12,40,48,50,"1",-38
81,31,4,90,80,19,10,"-1",80
81,32,2,76,60,33,80,"-1",-4
81,33,3,21,87,15,25,"-1",-4
81,34,3,90,81,80,90,"-1",0
81,35,2,100,95,17,0,"-1",100
81,36,2,40,40,26,40,"-1",0
81,37,4,30,66,30,50,"0",-20
81,38,2,80,77,71,90,"-1",-10
81,39,3,15,13,43,30,"1",-15
81,40,3,13,50,21,21,"1",-8
81,41,3,5,5,17,50,"1",-45
81,42,3,50,50,13,50,"-1",0
81,43,4,15,20,81,80,"1",-65
81,44,3,45,60,19,35,"-1",10
81,45,5,50,12,19,50,"-1",0
81,46,5,100,60,45,100,"-1",0
81,47,3,50,28,20,50,"-1",0
81,48,2,45,25,18,80,"-1",-35
81,49,4,2,35,11,2,"1",0
81,50,4,0,25,38,0,"1",0
81,51,2,0,30,26,0,"1",0
82,1,4,20,15,26,25,"1",-5
82,2,3,90,70,20,12,"-1",78
82,3,4,89,67,29,86,"-1",3
82,4,5,100,95,78,90,"-1",10
82,5,5,76,43,56,67,"-1",9
82,6,5,70,43,29,78,"-1",-8
82,7,3,12,25,45,24,"1",-12
82,8,4,78,54,75,76,"-1",2
82,9,5,67,45,29,79,"-1",-12
82,10,4,70,35,56,67,"-1",3
82,11,5,74,56,31,96,"-1",-22
82,12,4,100,90,78,99,"-1",1
82,13,4,56,25,22,79,"-1",-23
82,14,2,7,15,41,26,"1",-19
82,15,3,12,20,60,23,"1",-11
82,16,2,10,23,26,12,"1",-2
82,17,3,65,9,43,45,"-1",20
82,18,2,76,54,82,78,"1",-2
82,19,2,12,20,21,13,"1",-1
82,20,3,78,56,40,56,"-1",22
82,21,3,80,21,35,15,"-1",65
82,22,2,17,20,60,34,"1",-17
82,23,2,79,75,71,24,"-1",55
82,24,4,99,100,14,90,"-1",9
82,25,5,65,50,14,89,"-1",-24
82,26,3,100,70,29,90,"-1",10
82,27,3,78,60,45,67,"-1",11
82,28,3,25,16,20,78,"-1",-53
82,29,3,70,65,66,100,"-1",-30
82,30,3,70,45,48,88,"-1",-18
82,31,3,23,15,19,12,"-1",11
82,32,3,70,54,33,78,"-1",-8
82,33,3,12,20,15,78,"1",-66
82,34,3,80,65,80,89,"0",-9
82,35,2,70,50,17,89,"-1",-19
82,36,3,12,18,26,45,"1",-33
82,37,4,20,30,30,89,"1",-69
82,38,3,100,80,71,100,"-1",0
82,39,3,12,20,43,10,"1",2
82,40,5,90,70,21,89,"-1",1
82,41,3,98,80,17,91,"-1",7
82,42,3,60,45,13,67,"-1",-7
82,43,4,45,56,81,76,"1",-31
82,44,3,79,49,19,89,"-1",-10
82,45,5,67,25,19,67,"-1",0
82,46,4,70,50,45,78,"-1",-8
82,47,3,56,40,20,23,"-1",33
82,48,2,10,35,18,20,"1",-10
82,49,4,70,67,11,67,"-1",3
82,50,4,70,45,38,67,"-1",3
82,51,3,70,45,26,68,"-1",2
83,1,2,0,5,26,0,"1",0
83,2,5,5,10,20,5,"1",0
83,3,2,0,25,29,0,"1",0
83,4,3,100,40,78,100,"-1",0
83,5,5,50,10,56,40,"1",10
83,6,3,15,25,29,60,"1",-45
83,7,3,0,40,45,0,"1",0
83,8,2,10,65,75,5,"1",5
83,9,4,5,33,29,10,"1",-5
83,10,2,5,40,56,5,"1",0
83,11,3,5,25,31,10,"1",-5
83,12,2,10,40,78,80,"1",-70
83,13,3,0,18,22,0,"1",0
83,14,3,10,45,41,20,"1",-10
83,15,2,20,20,60,60,"1",-40
83,16,2,0,15,26,5,"1",-5
83,17,2,0,20,43,0,"1",0
83,18,2,99,85,82,95,"-1",4
83,19,2,0,60,21,0,"1",0
83,20,2,0,8,40,0,"1",0
83,21,2,50,60,35,30,"-1",20
83,22,2,100,100,60,90,"-1",10
83,23,2,80,70,71,80,"-1",0
83,24,3,5,7,14,15,"1",-10
83,25,3,10,20,14,10,"1",0
83,26,3,100,90,29,95,"-1",5
83,27,3,5,10,45,50,"1",-45
83,28,3,50,40,20,20,"-1",30
83,29,2,95,90,66,90,"-1",5
83,30,3,95,25,48,80,"-1",15
83,31,2,95,15,19,5,"-1",90
83,32,5,0,20,33,100,"1",-100
83,33,3,0,60,15,50,"1",-50
83,34,3,1,10,80,50,"1",-49
83,35,2,10,20,17,10,"1",0
83,36,2,50,50,26,30,"-1",20
83,37,3,95,90,30,50,"-1",45
83,38,2,100,90,71,95,"-1",5
83,39,2,0,55,43,5,"1",-5
83,40,5,100,70,21,95,"-1",5
83,41,3,0,25,17,10,"1",-10
83,42,3,0,45,13,10,"1",-10
83,43,3,0,10,81,60,"1",-60
83,44,3,1,10,19,3,"1",-2
83,45,4,90,50,19,95,"-1",-5
83,46,4,100,65,45,90,"-1",10
83,47,4,1,15,20,50,"1",-49
83,48,3,100,33,18,100,"-1",0
83,49,3,0,5,11,0,"1",0
83,50,3,0,30,38,0,"1",0
83,51,3,60,40,26,70,"-1",-10
84,1,5,5,2,26,10,"1",-5
84,2,5,10,30,20,5,"1",5
84,3,5,15,40,29,20,"1",-5
84,4,4,40,25,78,70,"1",-30
84,5,5,30,20,56,5,"1",25
84,6,4,15,25,29,25,"1",-10
84,7,4,0,50,45,0,"1",0
84,8,5,100,90,75,99,"-1",1
84,9,4,10,25,29,10,"1",0
84,10,4,70,60,56,90,"-1",-20
84,11,4,20,17,31,40,"1",-20
84,12,3,100,90,78,100,"-1",0
84,13,5,0,10,22,5,"1",-5
84,14,2,100,80,41,80,"-1",20
84,15,2,20,35,60,40,"1",-20
84,16,2,5,9,26,5,"1",0
84,17,2,25,20,43,30,"1",-5
84,18,2,20,35,82,25,"1",-5
84,19,2,0,40,21,0,"1",0
84,20,3,45,20,40,80,"-1",-35
84,21,2,30,19,35,15,"1",15
84,22,2,45,40,60,45,"1",0
84,23,2,95,50,71,90,"-1",5
84,24,3,10,5,14,15,"1",-5
84,25,2,0,10,14,0,"1",0
84,26,3,100,70,29,100,"-1",0
84,27,3,50,65,45,80,"-1",-30
84,28,3,30,40,20,20,"-1",10
84,29,2,90,50,66,80,"-1",10
84,30,3,0,20,48,5,"1",-5
84,31,5,100,40,19,5,"-1",95
84,32,5,0,30,33,0,"1",0
84,33,3,20,30,15,85,"-1",-65
84,34,3,5,25,80,45,"1",-40
84,35,3,10,40,17,5,"1",5
84,36,3,10,45,26,20,"1",-10
84,37,5,5,30,30,5,"1",0
84,38,2,95,85,71,90,"-1",5
84,39,2,0,30,43,0,"1",0
84,40,4,96,30,21,95,"-1",1
84,41,2,20,25,17,10,"-1",10
84,42,3,80,70,13,60,"-1",20
84,43,2,5,15,81,90,"1",-85
84,44,3,10,20,19,10,"1",0
84,45,4,80,40,19,15,"-1",65
84,46,4,30,70,45,20,"1",10
84,47,2,5,15,20,5,"1",0
84,48,2,30,80,18,5,"-1",25
84,49,3,25,9,11,15,"-1",10
84,50,3,0,40,38,0,"1",0
84,51,2,30,20,26,25,"-1",5
85,1,3,2,15,26,0,"1",2
85,2,3,0,0,20,0,"1",0
85,3,3,0,48,29,0,"1",0
85,4,3,100,75,78,99,"-1",1
85,5,3,75,56,56,75,"-1",0
85,6,3,55,60,29,17,"-1",38
85,7,3,99,90,45,99,"-1",0
85,8,3,50,50,75,75,"1",-25
85,9,3,2,5,29,4,"1",-2
85,10,3,75,75,56,75,"-1",0
85,11,3,2,25,31,0,"1",2
85,12,3,99,75,78,99,"-1",0
85,13,3,0,25,22,0,"1",0
85,14,3,2,45,41,2,"1",0
85,15,3,5,5,60,5,"1",0
85,16,3,5,25,26,5,"1",0
85,17,3,2,18,43,2,"1",0
85,18,3,50,50,82,78,"1",-28
85,19,3,1,15,21,0,"1",1
85,20,3,0,25,40,0,"1",0
85,21,3,75,75,35,25,"-1",50
85,22,3,2,10,60,66,"1",-64
85,23,3,50,75,71,55,"1",-5
85,24,3,35,35,14,56,"-1",-21
85,25,3,75,30,14,55,"-1",20
85,26,3,99,78,29,99,"-1",0
85,27,3,2,56,45,55,"1",-53
85,28,3,39,36,20,15,"-1",24
85,29,3,99,99,66,74,"-1",25
85,30,3,5,17,48,5,"1",0
85,31,3,2,25,19,56,"1",-54
85,32,3,78,75,33,0,"-1",78
85,33,3,75,56,15,99,"-1",-24
85,34,3,5,15,80,5,"1",0
85,35,3,0,5,17,0,"1",0
85,36,3,5,5,26,5,"1",0
85,37,3,5,10,30,15,"1",-10
85,38,3,5,54,71,5,"1",0
85,39,3,2,35,43,0,"1",2
85,40,3,75,75,21,25,"-1",50
85,41,3,2,35,17,0,"1",2
85,42,3,2,15,13,2,"1",0
85,43,3,2,2,81,75,"1",-73
85,44,3,2,10,19,55,"1",-53
85,45,3,50,50,19,5,"-1",45
85,46,3,0,45,45,0,"1",0
85,47,3,57,79,20,25,"-1",32
85,48,3,5,5,18,0,"1",5
85,49,3,0,15,11,0,"1",0
85,50,3,0,5,38,0,"1",0
85,51,3,0,45,26,0,"1",0
86,1,2,1,1,26,0,"1",1
86,2,3,30,30,20,20,"-1",10
86,3,3,5,60,29,10,"1",-5
86,4,3,50,80,78,20,"1",30
86,5,3,20,20,56,30,"1",-10
86,6,3,50,50,29,60,"-1",-10
86,7,3,0,50,45,0,"1",0
86,8,3,10,30,75,15,"1",-5
86,9,3,5,10,29,5,"1",0
86,10,2,1,70,56,14,"1",-13
86,11,3,1,20,31,15,"1",-14
86,12,3,90,90,78,100,"-1",-10
86,13,3,50,2,22,15,"-1",35
86,14,3,5,50,41,10,"1",-5
86,15,3,20,50,60,30,"1",-10
86,16,2,4,0,26,10,"1",-6
86,17,2,60,30,43,60,"-1",0
86,18,3,50,70,82,40,"1",10
86,19,3,10,20,21,20,"1",-10
86,20,2,0,4,40,0,"1",0
86,21,3,90,50,35,70,"-1",20
86,22,3,100,100,60,100,"-1",0
86,23,2,80,80,71,80,"-1",0
86,24,3,1,30,14,15,"1",-14
86,25,3,25,25,14,20,"-1",5
86,26,3,100,80,29,99,"-1",1
86,27,2,1,50,45,0,"1",1
86,28,3,16,15,20,15,"1",1
86,29,2,80,80,66,80,"-1",0
86,30,3,10,10,48,15,"1",-5
86,31,2,1,30,19,5,"1",-4
86,32,3,90,20,33,99,"-1",-9
86,33,3,100,25,15,100,"-1",0
86,34,3,40,60,80,60,"1",-20
86,35,4,0,30,17,2,"1",-2
86,36,3,25,25,26,25,"1",0
86,37,3,90,50,30,70,"-1",20
86,38,2,100,100,71,100,"-1",0
86,39,3,50,50,43,45,"-1",5
86,40,3,0,10,21,0,"1",0
86,41,3,0,27,17,2,"1",-2
86,42,3,10,50,13,10,"1",0
86,43,2,100,60,81,2,"-1",98
86,44,3,1,1,19,15,"1",-14
86,45,3,6,4,19,10,"1",-4
86,46,4,100,70,45,100,"-1",0
86,47,3,10,50,20,5,"1",5
86,48,2,50,50,18,20,"-1",30
86,49,3,0,20,11,10,"1",-10
86,50,3,0,5,38,5,"1",-5
86,51,3,10,50,26,10,"1",0
87,1,2,25,10,26,25,"1",0
87,2,5,5,5,20,5,"1",0
87,3,2,0,30,29,0,"1",0
87,4,4,100,60,78,100,"-1",0
87,5,5,80,45,56,85,"-1",-5
87,6,5,50,30,29,50,"-1",0
87,7,2,0,35,45,0,"1",0
87,8,3,50,70,75,40,"1",10
87,9,4,5,30,29,5,"1",0
87,10,4,50,70,56,40,"1",10
87,11,4,25,30,31,25,"1",0
87,12,3,0,40,78,0,"1",0
87,13,4,20,20,22,0,"1",20
87,14,2,10,30,41,9,"1",1
87,15,2,50,50,60,10,"1",40
87,16,2,15,5,26,5,"1",10
87,17,2,30,65,43,20,"1",10
87,18,2,5,75,82,5,"1",0
87,19,2,5,30,21,5,"1",0
87,20,2,0,15,40,5,"1",-5
87,21,2,5,40,35,20,"1",-15
87,22,2,80,80,60,30,"-1",50
87,23,2,80,80,71,70,"-1",10
87,24,4,8,8,14,15,"1",-7
87,25,3,5,25,14,5,"1",0
87,26,4,100,60,29,100,"-1",0
87,27,2,0,20,45,5,"1",-5
87,28,3,18,18,20,15,"1",3
87,29,2,50,60,66,50,"1",0
87,30,3,0,15,48,0,"1",0
87,31,3,80,30,19,15,"-1",65
87,32,4,90,10,33,85,"-1",5
87,33,3,60,40,15,95,"-1",-35
87,34,3,0,25,80,10,"1",-10
87,35,2,0,15,17,0,"1",0
87,36,3,50,50,26,25,"-1",25
87,37,3,10,60,30,10,"1",0
87,38,2,75,80,71,75,"-1",0
87,39,3,90,50,43,100,"-1",-10
87,40,4,100,80,21,100,"-1",0
87,41,3,2,50,17,5,"1",-3
87,42,3,5,30,13,5,"1",0
87,43,2,2,50,81,100,"1",-98
87,44,3,0,10,19,5,"1",-5
87,45,4,10,15,19,10,"1",0
87,46,5,100,60,45,100,"-1",0
87,47,5,20,30,20,20,"0",0
87,48,3,20,50,18,20,"-1",0
87,49,2,0,15,11,0,"1",0
87,50,3,0,40,38,0,"1",0
87,51,2,0,30,26,0,"1",0
88,1,4,20,10,26,25,"1",-5
88,2,5,2,10,20,5,"1",-3
88,3,5,95,65,29,20,"-1",75
88,4,4,5,15,78,15,"1",-10
88,5,4,80,70,56,80,"-1",0
88,6,4,20,40,29,20,"1",0
88,7,4,5,70,45,5,"1",0
88,8,4,5,10,75,15,"1",-10
88,9,4,10,40,29,10,"1",0
88,10,4,20,50,56,20,"1",0
88,11,5,10,15,31,20,"1",-10
88,12,2,0,90,78,0,"1",0
88,13,5,40,60,22,60,"-1",-20
88,14,2,5,30,41,10,"1",-5
88,15,2,30,50,60,5,"1",25
88,16,2,8,5,26,5,"1",3
88,17,2,5,3,43,5,"1",0
88,18,2,30,50,82,20,"1",10
88,19,2,1,10,21,5,"1",-4
88,20,2,5,15,40,10,"1",-5
88,21,2,5,15,35,5,"1",0
88,22,2,10,30,60,10,"1",0
88,23,2,20,70,71,25,"1",-5
88,24,3,5,5,14,15,"1",-10
88,25,4,70,20,14,70,"-1",0
88,26,3,20,80,29,20,"1",0
88,27,2,20,50,45,15,"1",5
88,28,3,15,15,20,30,"1",-15
88,29,2,20,60,66,25,"1",-5
88,30,4,50,20,48,50,"-1",0
88,31,4,100,35,19,5,"-1",95
88,32,4,100,25,33,90,"-1",10
88,33,3,70,30,15,80,"-1",-10
88,34,2,30,60,80,30,"1",0
88,35,2,30,70,17,5,"-1",25
88,36,2,5,30,26,5,"1",0
88,37,3,60,70,30,50,"-1",10
88,38,2,60,80,71,15,"1",45
88,39,3,0,40,43,0,"1",0
88,40,4,60,80,21,50,"-1",10
88,41,3,0,20,17,5,"1",-5
88,42,3,20,60,13,15,"-1",5
88,43,4,5,10,81,80,"1",-75
88,44,3,40,20,19,25,"-1",15
88,45,4,15,20,19,15,"1",0
88,46,5,100,40,45,100,"-1",0
88,47,3,0,5,20,0,"1",0
88,48,3,20,60,18,10,"-1",10
88,49,3,5,30,11,5,"1",0
88,50,5,2,5,38,10,"1",-8
88,51,4,20,30,26,20,"1",0
89,1,2,9,10,26,20,"1",-11
89,2,5,30,40,20,20,"-1",10
89,3,4,10,40,29,20,"1",-10
89,4,4,70,70,78,70,"1",0
89,5,4,90,60,56,80,"-1",10
89,6,4,20,50,29,20,"1",0
89,7,3,30,40,45,20,"1",10
89,8,3,80,60,75,90,"-1",-10
89,9,3,20,30,29,10,"1",10
89,10,4,80,80,56,80,"-1",0
89,11,4,30,20,31,20,"1",10
89,12,3,100,100,78,80,"-1",20
89,13,4,10,30,22,20,"1",-10
89,14,2,80,75,41,90,"-1",-10
89,15,2,50,30,60,50,"1",0
89,16,2,30,30,26,20,"-1",10
89,17,2,50,60,43,70,"-1",-20
89,18,2,80,70,82,80,"1",0
89,19,3,50,50,21,50,"-1",0
89,20,2,1,40,40,10,"1",-9
89,21,2,20,40,35,30,"1",-10
89,22,2,100,40,60,80,"-1",20
89,23,2,80,80,71,80,"-1",0
89,24,3,40,40,14,10,"-1",30
89,25,3,30,35,14,30,"-1",0
89,26,3,90,40,29,80,"-1",10
89,27,3,80,50,45,80,"-1",0
89,28,3,10,10,20,10,"1",0
89,29,3,99,80,66,70,"-1",29
89,30,3,90,20,48,10,"-1",80
89,31,4,100,85,19,10,"-1",90
89,32,4,80,40,33,90,"-1",-10
89,33,3,40,20,15,80,"-1",-40
89,34,3,10,10,80,50,"1",-40
89,35,2,70,30,17,80,"-1",-10
89,36,2,30,20,26,10,"-1",20
89,37,4,80,70,30,30,"-1",50
89,38,2,78,78,71,90,"-1",-12
89,39,2,20,30,43,40,"1",-20
89,40,4,10,30,21,20,"1",-10
89,41,3,20,30,17,20,"-1",0
89,42,3,80,60,13,60,"-1",20
89,43,4,60,70,81,50,"1",10
89,44,3,0,10,19,1,"1",-1
89,45,3,1,30,19,10,"1",-9
89,46,4,100,70,45,100,"-1",0
89,47,3,20,40,20,80,"0",-60
89,48,3,60,50,18,70,"-1",-10
89,49,3,1,10,11,1,"1",0
89,50,4,10,10,38,10,"1",0
89,51,3,50,60,26,50,"-1",0
90,1,5,50,32,26,50,"-1",0
90,2,5,50,50,20,33,"-1",17
90,3,4,35,62,29,25,"-1",10
90,4,5,12,15,78,78,"1",-66
90,5,5,80,20,56,80,"-1",0
90,6,5,60,70,29,50,"-1",10
90,7,5,35,56,45,30,"1",5
90,8,4,99,98,75,100,"-1",-1
90,9,5,25,25,29,25,"1",0
90,10,4,28,28,56,30,"1",-2
90,11,5,45,32,31,65,"-1",-20
90,12,3,25,25,78,80,"1",-55
90,13,5,12,33,22,60,"1",-48
90,14,2,38,52,41,40,"1",-2
90,15,2,50,50,60,50,"1",0
90,16,2,12,38,26,15,"1",-3
90,17,2,38,43,43,22,"1",16
90,18,2,50,50,82,80,"1",-30
90,19,2,62,48,21,65,"-1",-3
90,20,2,0,5,40,40,"1",-40
90,21,2,17,22,35,12,"1",5
90,22,3,80,80,60,80,"-1",0
90,23,2,40,80,71,30,"1",10
90,24,3,10,10,14,20,"1",-10
90,25,4,22,33,14,19,"-1",3
90,26,3,89,78,29,100,"-1",-11
90,27,3,60,75,45,40,"-1",20
90,28,3,20,20,20,20,"0",0
90,29,2,75,82,66,85,"-1",-10
90,30,5,100,45,48,100,"-1",0
90,31,4,56,34,19,30,"-1",26
90,32,3,20,20,33,20,"1",0
90,33,3,80,90,15,35,"-1",45
90,34,2,13,66,80,19,"1",-6
90,35,2,20,15,17,30,"-1",-10
90,36,2,20,90,26,20,"1",0
90,37,4,80,70,30,30,"-1",50
90,38,2,92,88,71,92,"-1",0
90,39,4,42,42,43,32,"1",10
90,40,4,15,30,21,32,"1",-17
90,41,3,30,70,17,40,"-1",-10
90,42,2,67,19,13,88,"-1",-21
90,43,3,80,32,81,30,"1",50
90,44,3,20,20,19,20,"-1",0
90,45,5,80,40,19,80,"-1",0
90,46,5,100,84,45,100,"-1",0
90,47,4,10,22,20,20,"1",-10
90,48,2,3,14,18,2,"1",1
90,49,5,80,65,11,90,"-1",-10
90,50,5,100,45,38,100,"-1",0
90,51,3,50,20,26,80,"-1",-30
91,1,5,80,50,26,50,"-1",30
91,2,5,30,30,20,10,"-1",20
91,3,4,30,50,29,10,"-1",20
91,4,4,100,90,78,100,"-1",0
91,5,4,80,75,56,60,"-1",20
91,6,4,20,10,29,30,"1",-10
91,7,3,40,50,45,70,"1",-30
91,8,3,20,60,75,30,"1",-10
91,9,5,100,40,29,90,"-1",10
91,10,4,60,70,56,50,"-1",10
91,11,5,20,25,31,30,"1",-10
91,12,3,50,50,78,60,"1",-10
91,13,4,0,5,22,5,"1",-5
91,14,2,40,50,41,30,"1",10
91,15,2,80,60,60,60,"-1",20
91,16,2,10,15,26,15,"1",-5
91,17,2,5,10,43,35,"1",-30
91,18,2,50,50,82,70,"1",-20
91,19,2,50,30,21,5,"-1",45
91,20,2,0,5,40,10,"1",-10
91,21,3,30,30,35,60,"1",-30
91,22,3,100,100,60,70,"-1",30
91,23,2,50,60,71,50,"1",0
91,24,3,5,5,14,8,"1",-3
91,25,3,0,25,14,1,"1",-1
91,26,2,0,35,29,0,"1",0
91,27,2,0,5,45,0,"1",0
91,28,3,10,10,20,10,"1",0
91,29,3,99,80,66,80,"-1",19
91,30,3,0,15,48,0,"1",0
91,31,2,100,40,19,0,"-1",100
91,32,5,90,70,33,80,"-1",10
91,33,3,100,60,15,99,"-1",1
91,34,3,5,10,80,20,"1",-15
91,35,2,1,15,17,2,"1",-1
91,36,3,60,60,26,40,"-1",20
91,37,4,70,70,30,50,"-1",20
91,38,2,100,100,71,80,"-1",20
91,39,2,0,60,43,0,"1",0
91,40,4,100,70,21,99,"-1",1
91,41,2,1,30,17,0,"1",1
91,42,3,20,80,13,10,"-1",10
91,43,5,80,70,81,0,"1",80
91,44,3,5,10,19,10,"1",-5
91,45,4,5,10,19,15,"1",-10
91,46,4,40,70,45,10,"1",30
91,47,3,100,30,20,100,"-1",0
91,48,4,50,40,18,30,"-1",20
91,49,3,0,15,11,0,"1",0
91,50,2,0,10,38,2,"1",-2
91,51,3,20,30,26,15,"1",5
92,1,4,45,50,26,50,"-1",-5
92,2,5,25,22,20,20,"-1",5
92,3,4,0,50,29,1,"1",-1
92,4,4,100,80,78,100,"-1",0
92,5,3,60,55,56,45,"-1",15
92,6,4,30,20,29,25,"-1",5
92,7,3,60,30,45,60,"-1",0
92,8,3,100,90,75,100,"-1",0
92,9,4,1,10,29,1,"1",0
92,10,4,25,28,56,35,"1",-10
92,11,4,0,12,31,5,"1",-5
92,12,3,100,40,78,100,"-1",0
92,13,4,0,10,22,0,"1",0
92,14,2,65,50,41,50,"-1",15
92,15,3,37,30,60,25,"1",12
92,16,2,0,10,26,5,"1",-5
92,17,2,1,5,43,5,"1",-4
92,18,2,3,10,82,5,"1",-2
92,19,2,0,6,21,0,"1",0
92,20,2,0,10,40,0,"1",0
92,21,3,75,75,35,35,"-1",40
92,22,2,5,45,60,5,"1",0
92,23,2,99,80,71,99,"-1",0
92,24,3,5,5,14,10,"1",-5
92,25,3,3,20,14,10,"1",-7
92,26,3,10,72,29,5,"1",5
92,27,2,0,5,45,0,"1",0
92,28,3,50,45,20,10,"-1",40
92,29,2,99,75,66,99,"-1",0
92,30,3,0,17,48,2,"1",-2
92,31,4,100,50,19,0,"-1",100
92,32,5,100,45,33,100,"-1",0
92,33,4,100,50,15,100,"-1",0
92,34,2,0,5,80,0,"1",0
92,35,2,0,15,17,0,"1",0
92,36,4,30,40,26,10,"-1",20
92,37,3,50,45,30,50,"-1",0
92,38,2,85,75,71,99,"-1",-14
92,39,2,0,60,43,0,"1",0
92,40,3,100,75,21,100,"-1",0
92,41,2,0,10,17,0,"1",0
92,42,2,0,40,13,0,"1",0
92,43,3,10,12,81,5,"1",5
92,44,3,7,10,19,15,"1",-8
92,45,4,5,45,19,5,"1",0
92,46,5,100,45,45,100,"-1",0
92,47,3,5,30,20,5,"1",0
92,48,2,90,75,18,80,"-1",10
92,49,2,0,7,11,0,"1",0
92,50,4,1,5,38,0,"1",1
92,51,3,0,18,26,0,"1",0
93,1,4,20,35,26,25,"1",-5
93,2,5,35,45,20,10,"-1",25
93,3,3,40,4,29,0,"-1",40
93,4,4,99,90,78,90,"-1",9
93,5,5,10,25,56,30,"1",-20
93,6,4,45,60,29,5,"-1",40
93,7,5,20,40,45,20,"1",0
93,8,4,99,95,75,65,"-1",34
93,9,4,45,50,29,25,"-1",20
93,10,5,90,65,56,99,"-1",-9
93,11,4,20,40,31,20,"1",0
93,12,2,99,99,78,99,"-1",0
93,13,4,35,5,22,1,"-1",34
93,14,2,25,20,41,98,"1",-73
93,15,2,25,45,60,8,"1",17
93,16,2,5,2,26,2,"1",3
93,17,2,1,13,43,2,"1",-1
93,18,2,99,55,82,99,"-1",0
93,19,2,0,50,21,0,"1",0
93,20,2,25,45,40,5,"1",20
93,21,2,5,5,35,8,"1",-3
93,22,2,5,15,60,5,"1",0
93,23,2,0,80,71,0,"1",0
93,24,4,1,1,14,18,"1",-17
93,25,3,0,10,14,0,"1",0
93,26,4,0,75,29,0,"1",0
93,27,3,3,5,45,5,"1",-2
93,28,3,45,45,20,45,"-1",0
93,29,3,70,85,66,10,"-1",60
93,30,3,0,30,48,2,"1",-2
93,31,2,1,15,19,15,"1",-14
93,32,3,20,35,33,25,"1",-5
93,33,3,10,40,15,15,"1",-5
93,34,3,2,5,80,40,"1",-38
93,35,4,5,12,17,10,"1",-5
93,36,2,10,40,26,2,"1",8
93,37,4,40,50,30,35,"-1",5
93,38,3,100,99,71,100,"-1",0
93,39,3,0,35,43,0,"1",0
93,40,3,35,75,21,25,"-1",10
93,41,3,1,45,17,15,"1",-14
93,42,4,90,70,13,55,"-1",35
93,43,4,10,25,81,90,"1",-80
93,44,4,0,12,19,2,"1",-2
93,45,4,1,35,19,1,"1",0
93,46,5,0,90,45,8,"1",-8
93,47,4,1,15,20,1,"1",0
93,48,2,30,30,18,1,"-1",29
93,49,3,0,25,11,0,"1",0
93,50,3,0,8,38,1,"1",-1
93,51,3,0,16,26,0,"1",0
94,1,4,90,70,26,50,"-1",40
94,2,2,5,5,20,20,"1",-15
94,3,4,0,45,29,5,"1",-5
94,4,3,100,80,78,100,"-1",0
94,5,4,5,15,56,25,"1",-20
94,6,2,10,15,29,25,"1",-15
94,7,5,100,65,45,100,"-1",0
94,8,2,15,18,75,45,"1",-30
94,9,4,10,10,29,10,"1",0
94,10,4,70,85,56,60,"-1",10
94,11,5,55,45,31,25,"-1",30
94,12,2,45,65,78,45,"1",0
94,13,4,0,15,22,0,"1",0
94,14,2,35,50,41,56,"1",-21
94,15,2,20,25,60,45,"1",-25
94,16,2,3,12,26,25,"1",-22
94,17,2,20,25,43,10,"1",10
94,18,2,100,50,82,100,"-1",0
94,19,2,0,20,21,0,"1",0
94,20,2,5,30,40,5,"1",0
94,21,2,38,50,35,35,"-1",3
94,22,2,60,40,60,63,"0",-3
94,23,2,95,90,71,85,"-1",10
94,24,3,70,35,14,20,"-1",50
94,25,2,0,15,14,0,"1",0
94,26,4,99,82,29,100,"-1",-1
94,27,3,0,25,45,15,"1",-15
94,28,3,40,40,20,50,"-1",-10
94,29,2,99,75,66,100,"-1",-1
94,30,2,0,12,48,0,"1",0
94,31,3,100,55,19,5,"-1",95
94,32,2,45,45,33,24,"-1",21
94,33,3,62,42,15,35,"-1",27
94,34,3,0,12,80,0,"1",0
94,35,4,21,40,17,23,"-1",-2
94,36,2,65,75,26,75,"-1",-10
94,37,4,35,35,30,35,"-1",0
94,38,2,100,100,71,100,"-1",0
94,39,4,55,60,43,35,"-1",20
94,40,3,100,65,21,100,"-1",0
94,41,3,5,40,17,10,"1",-5
94,42,3,50,80,13,15,"-1",35
94,43,4,80,50,81,45,"1",35
94,44,3,25,20,19,30,"-1",-5
94,45,4,0,42,19,15,"1",-15
94,46,4,45,20,45,45,"0",0
94,47,5,20,30,20,19,"0",1
94,48,4,75,50,18,75,"-1",0
94,49,4,0,24,11,0,"1",0
94,50,2,0,5,38,0,"1",0
94,51,2,0,25,26,0,"1",0
95,1,2,50,30,26,20,"-1",30
95,2,2,80,60,20,40,"-1",40
95,3,3,0,30,29,0,"1",0
95,4,4,100,80,78,100,"-1",0
95,5,4,0,20,56,10,"1",-10
95,6,4,30,12,29,25,"-1",5
95,7,4,0,35,45,0,"1",0
95,8,3,45,60,75,25,"1",20
95,9,4,10,15,29,15,"1",-5
95,10,2,10,60,56,10,"1",0
95,11,4,50,20,31,50,"-1",0
95,12,3,100,100,78,65,"-1",35
95,13,4,0,10,22,0,"1",0
95,14,2,10,10,41,10,"1",0
95,15,2,70,60,60,60,"-1",10
95,16,3,25,10,26,25,"1",0
95,17,2,0,10,43,0,"1",0
95,18,2,10,20,82,25,"1",-15
95,19,2,0,50,21,0,"1",0
95,20,2,0,20,40,0,"1",0
95,21,2,60,25,35,40,"-1",20
95,22,2,20,20,60,20,"1",0
95,23,2,20,30,71,40,"1",-20
95,24,3,5,5,14,5,"1",0
95,25,3,10,20,14,10,"1",0
95,26,3,25,80,29,45,"1",-20
95,27,2,20,30,45,20,"1",0
95,28,3,60,60,20,10,"-1",50
95,29,2,70,70,66,60,"-1",10
95,30,3,5,15,48,10,"1",-5
95,31,2,100,60,19,0,"-1",100
95,32,4,100,40,33,100,"-1",0
95,33,4,0,12,15,10,"1",-10
95,34,3,0,10,80,0,"1",0
95,35,2,0,12,17,0,"1",0
95,36,2,30,30,26,20,"-1",10
95,37,3,65,65,30,60,"-1",5
95,38,2,100,100,71,100,"-1",0
95,39,2,0,70,43,0,"1",0
95,40,5,100,70,21,100,"-1",0
95,41,3,0,71,17,0,"1",0
95,42,3,10,25,13,10,"1",0
95,43,2,95,65,81,10,"-1",85
95,44,3,0,5,19,0,"1",0
95,45,5,80,40,19,80,"-1",0
95,46,5,100,65,45,100,"-1",0
95,47,4,20,30,20,50,"0",-30
95,48,3,25,30,18,25,"-1",0
95,49,4,0,30,11,0,"1",0
95,50,3,0,25,38,0,"1",0
95,51,2,0,20,26,0,"1",0
96,1,2,3,6,26,68,"1",-65
96,2,5,46,35,20,15,"-1",31
96,3,4,10,22,29,69,"1",-59
96,4,3,19,50,78,46,"1",-27
96,5,3,10,25,56,56,"1",-46
96,6,3,78,23,29,12,"-1",66
96,7,4,30,17,45,50,"1",-20
96,8,3,60,50,75,50,"1",10
96,9,3,50,30,29,72,"-1",-22
96,10,3,60,37,56,10,"-1",50
96,11,5,33,30,31,57,"-1",-24
96,12,3,100,68,78,50,"-1",50
96,13,5,1,11,22,45,"1",-44
96,14,3,100,70,41,49,"-1",51
96,15,2,100,90,60,100,"-1",0
96,16,2,50,40,26,80,"-1",-30
96,17,2,30,20,43,30,"1",0
96,18,2,100,60,82,90,"-1",10
96,19,2,40,18,21,40,"-1",0
96,20,3,100,53,40,70,"-1",30
96,21,2,60,40,35,50,"-1",10
96,22,2,50,50,60,60,"1",-10
96,23,2,60,70,71,100,"1",-40
96,24,3,3,3,14,13,"1",-10
96,25,4,70,20,14,15,"-1",55
96,26,4,100,90,29,34,"-1",66
96,27,2,70,30,45,100,"-1",-30
96,28,3,60,50,20,3,"-1",57
96,29,2,20,18,66,58,"1",-38
96,30,3,0,10,48,30,"1",-30
96,31,2,70,67,19,49,"-1",21
96,32,5,100,100,33,100,"-1",0
96,33,2,0,10,15,10,"1",-10
96,34,2,15,23,80,67,"1",-52
96,35,2,10,15,17,45,"1",-35
96,36,2,25,25,26,75,"1",-50
96,37,3,25,24,30,70,"1",-45
96,38,2,100,90,71,70,"-1",30
96,39,3,20,30,43,30,"1",-10
96,40,4,100,45,21,100,"-1",0
96,41,2,70,30,17,85,"-1",-15
96,42,3,50,85,13,10,"-1",40
96,43,4,15,20,81,50,"1",-35
96,44,3,33,35,19,20,"-1",13
96,45,4,50,30,19,60,"-1",-10
96,46,4,100,41,45,60,"-1",40
96,47,3,20,25,20,34,"0",-14
96,48,3,0,4,18,21,"1",-21
96,49,4,1,5,11,10,"1",-9
96,50,4,100,8,38,46,"-1",54
96,51,5,0,6,26,30,"1",-30
97,1,2,5,20,26,10,"1",-5
97,2,2,85,60,20,30,"-1",55
97,3,2,1,30,29,1,"1",0
97,4,4,99,85,78,99,"-1",0
97,5,5,75,50,56,70,"-1",5
97,6,5,40,20,29,40,"-1",0
97,7,2,99,40,45,99,"-1",0
97,8,2,10,85,75,5,"1",5
97,9,2,4,25,29,5,"1",-1
97,10,2,10,75,56,5,"1",5
97,11,3,2,20,31,3,"1",-1
97,12,2,80,45,78,80,"-1",0
97,13,4,20,1,22,1,"1",19
97,14,2,5,30,41,5,"1",0
97,15,2,10,20,60,5,"1",5
97,16,2,10,5,26,5,"1",5
97,17,2,2,20,43,2,"1",0
97,18,2,99,50,82,99,"-1",0
97,19,2,1,20,21,1,"1",0
97,20,2,0,10,40,0,"1",0
97,21,2,5,40,35,5,"1",0
97,22,2,95,95,60,60,"-1",35
97,23,2,95,85,71,99,"-1",-4
97,24,3,8,15,14,15,"1",-7
97,25,3,75,35,14,70,"-1",5
97,26,4,90,90,29,80,"-1",10
97,27,2,10,10,45,10,"1",0
97,28,4,25,35,20,20,"-1",5
97,29,2,70,75,66,25,"-1",45
97,30,2,1,35,48,5,"1",-4
97,31,3,25,65,19,50,"-1",-25
97,32,4,40,70,33,5,"-1",35
97,33,3,25,25,15,35,"-1",-10
97,34,3,60,60,80,70,"1",-10
97,35,3,50,50,17,5,"-1",45
97,36,2,50,60,26,20,"-1",30
97,37,4,30,60,30,20,"0",10
97,38,2,95,95,71,95,"-1",0
97,39,2,0,50,43,0,"1",0
97,40,4,99,60,21,99,"-1",0
97,41,3,20,80,17,10,"-1",10
97,42,2,10,30,13,10,"1",0
97,43,2,50,50,81,7,"1",43
97,44,3,35,35,19,15,"-1",20
97,45,3,60,50,19,40,"-1",20
97,46,4,100,80,45,100,"-1",0
97,47,5,100,25,20,100,"-1",0
97,48,3,25,15,18,25,"-1",0
97,49,5,0,10,11,0,"1",0
97,50,4,0,10,38,0,"1",0
97,51,3,20,30,26,10,"1",10
98,1,5,10,20,26,20,"1",-10
98,2,2,100,50,20,100,"-1",0
98,3,5,10,50,29,20,"1",-10
98,4,5,99,50,78,100,"-1",-1
98,5,5,10,30,56,30,"1",-20
98,6,3,50,20,29,60,"-1",-10
98,7,3,100,50,45,100,"-1",0
98,8,4,100,60,75,100,"-1",0
98,9,4,10,30,29,50,"1",-40
98,10,3,75,80,56,50,"-1",25
98,11,5,30,20,31,30,"1",0
98,12,3,100,99,78,100,"-1",0
98,13,5,0,5,22,20,"1",-20
98,14,2,10,10,41,10,"1",0
98,15,2,60,20,60,60,"0",0
98,16,2,20,10,26,20,"1",0
98,17,2,50,20,43,50,"-1",0
98,18,2,100,30,82,60,"-1",40
98,19,2,80,50,21,60,"-1",20
98,20,2,0,20,40,20,"1",-20
98,21,3,30,50,35,30,"1",0
98,22,2,100,95,60,20,"-1",80
98,23,2,80,60,71,60,"-1",20
98,24,3,5,10,14,10,"1",-5
98,25,3,0,30,14,20,"1",-20
98,26,3,100,60,29,70,"-1",30
98,27,2,75,80,45,100,"-1",-25
98,28,3,10,5,20,10,"1",0
98,29,2,99,80,66,100,"-1",-1
98,30,3,0,5,48,0,"1",0
98,31,5,30,40,19,100,"-1",-70
98,32,5,0,0,33,0,"1",0
98,33,3,0,10,15,0,"1",0
98,34,3,50,50,80,30,"1",20
98,35,2,0,10,17,0,"1",0
98,36,2,100,75,26,100,"-1",0
98,37,5,60,70,30,60,"-1",0
98,38,2,100,95,71,100,"-1",0
98,39,3,0,60,43,50,"1",-50
98,40,5,100,70,21,90,"-1",10
98,41,3,100,60,17,100,"-1",0
98,42,3,100,60,13,100,"-1",0
98,43,5,0,5,81,100,"1",-100
98,44,3,0,3,19,0,"1",0
98,45,3,20,10,19,30,"-1",-10
98,46,5,100,70,45,100,"-1",0
98,47,3,0,10,20,0,"1",0
98,48,3,99,20,18,100,"-1",-1
98,49,5,0,20,11,0,"1",0
98,50,3,0,3,38,0,"1",0
98,51,3,0,30,26,0,"1",0
99,1,5,2,20,26,20,"1",-18
99,2,5,25,40,20,25,"-1",0
99,3,5,5,20,29,10,"1",-5
99,4,2,70,80,78,99,"1",-29
99,5,4,80,50,56,70,"-1",10
99,6,3,5,5,29,2,"1",3
99,7,4,90,33,45,90,"-1",0
99,8,3,1,25,75,65,"1",-64
99,9,5,50,15,29,50,"-1",0
99,10,4,20,50,56,25,"1",-5
99,11,4,1,4,31,5,"1",-4
99,12,2,50,60,78,50,"1",0
99,13,5,10,0,22,0,"1",10
99,14,2,5,15,41,10,"1",-5
99,15,2,40,40,60,20,"1",20
99,16,2,20,45,26,30,"1",-10
99,17,2,20,40,43,20,"1",0
99,18,2,5,28,82,5,"1",0
99,19,2,0,20,21,0,"1",0
99,20,2,80,20,40,80,"-1",0
99,21,2,20,50,35,25,"1",-5
99,22,2,95,98,60,50,"-1",45
99,23,2,95,95,71,99,"-1",-4
99,24,3,15,15,14,14,"-1",1
99,25,3,2,10,14,1,"1",1
99,26,3,95,90,29,99,"-1",-4
99,27,2,2,30,45,1,"1",1
99,28,3,18,18,20,15,"1",3
99,29,2,20,70,66,75,"1",-55
99,30,3,1,12,48,1,"1",0
99,31,2,90,80,19,50,"-1",40
99,32,5,99,60,33,100,"-1",-1
99,33,3,100,80,15,90,"-1",10
99,34,3,1,5,80,1,"1",0
99,35,3,1,25,17,0,"1",1
99,36,2,50,30,26,50,"-1",0
99,37,5,95,80,30,90,"-1",5
99,38,3,100,95,71,99,"-1",1
99,39,4,85,50,43,95,"-1",-10
99,40,5,10,75,21,0,"1",10
99,41,3,1,18,17,0,"1",1
99,42,3,70,50,13,50,"-1",20
99,43,5,0,70,81,95,"1",-95
99,44,4,2,15,19,5,"1",-3
99,45,5,50,20,19,50,"-1",0
99,46,4,20,75,45,20,"1",0
99,47,5,5,22,20,10,"1",-5
99,48,3,50,20,18,20,"-1",30
99,49,4,1,10,11,0,"1",1
99,50,5,50,34,38,75,"-1",-25
99,51,4,83,65,26,50,"-1",33
100,1,3,10,20,26,10,"1",0
100,2,2,5,20,20,30,"1",-25
100,3,2,1,19,29,1,"1",0
100,4,2,100,60,78,100,"-1",0
100,5,4,1,25,56,50,"1",-49
100,6,4,33,33,29,10,"-1",23
100,7,4,100,65,45,100,"-1",0
100,8,4,10,65,75,60,"1",-50
100,9,4,5,35,29,10,"1",-5
100,10,4,50,20,56,50,"1",0
100,11,4,5,10,31,10,"1",-5
100,12,2,70,70,78,70,"1",0
100,13,5,25,0,22,1,"-1",24
100,14,2,70,80,41,40,"-1",30
100,15,2,99,80,60,40,"-1",59
100,16,2,15,5,26,5,"1",10
100,17,2,5,15,43,25,"1",-20
100,18,2,70,30,82,95,"1",-25
100,19,2,50,25,21,60,"-1",-10
100,20,2,0,1,40,0,"1",0
100,21,3,60,50,35,50,"-1",10
100,22,2,95,95,60,60,"-1",35
100,23,2,10,40,71,10,"1",0
100,24,3,5,5,14,15,"1",-10
100,25,3,100,45,14,100,"-1",0
100,26,4,100,80,29,100,"-1",0
100,27,3,50,25,45,80,"-1",-30
100,28,3,15,15,20,15,"1",0
100,29,2,40,60,66,80,"1",-40
100,30,3,100,35,48,100,"-1",0
100,31,2,90,80,19,10,"-1",80
100,32,4,0,30,33,1,"1",-1
100,33,3,80,75,15,20,"-1",60
100,34,3,90,80,80,90,"-1",0
100,35,2,5,20,17,10,"1",-5
100,36,2,65,65,26,15,"-1",50
100,37,3,70,85,30,30,"-1",40
100,38,2,75,75,71,60,"-1",15
100,39,3,100,40,43,99,"-1",1
100,40,3,95,80,21,95,"-1",0
100,41,3,90,55,17,95,"-1",-5
100,42,3,10,10,13,20,"1",-10
100,43,3,5,65,81,50,"1",-45
100,44,3,5,5,19,20,"1",-15
100,45,4,99,10,19,95,"-1",4
100,46,5,5,35,45,40,"1",-35
100,47,3,10,20,20,10,"1",0
100,48,2,90,30,18,15,"-1",75
100,49,2,1,10,11,1,"1",0
100,50,2,0,45,38,0,"1",0
100,51,2,0,60,26,0,"1",0
