"Participant","Event","Valence","E1","eBR","BR","E2","direction","update"
1,1,5,10,15,26,25,"1",-15
1,2,4,70,23,20,25,"-1",45
1,3,4,25,100,29,100,"1",-75
1,4,2,0,10,78,20,"1",-20
1,5,5,6,14,56,2,"1",4
1,6,2,35,5,29,29,"-1",6
1,7,3,0,25,45,12,"1",-12
1,8,3,99,87,75,89,"-1",10
1,9,4,20,12,29,25,"1",-5
1,10,1,3,12,56,3,"1",0
1,11,4,6,5,31,31,"1",-25
1,12,2,80,80,78,78,"-1",2
1,13,5,12,87,22,60,"1",-48
1,14,1,23,60,41,40,"1",-17
1,15,2,77,78,60,70,"-1",7
1,16,2,28,23,26,26,"-1",2
1,17,1,80,60,43,50,"-1",30
1,18,1,18,18,82,50,"1",-32
1,19,4,90,45,21,50,"-1",40
1,20,3,12,12,40,12,"1",0
1,21,1,60,34,35,50,"-1",10
1,22,2,99,99,60,67,"-1",32
1,23,3,90,70,71,90,"-1",0
1,24,3,1,2,14,14,"1",-13
1,25,1,3,21,14,2,"1",1
1,26,4,99,50,29,99,"-1",0
1,27,3,100,57,45,100,"-1",0
1,28,3,24,50,20,20,"-1",4
1,29,1,99,70,66,99,"-1",0
1,30,3,0,12,48,0,"1",0
1,31,5,40,18,19,20,"-1",20
1,32,4,0,34,33,0,"1",0
1,33,3,0,34,15,0,"1",0
1,34,1,99,23,80,99,"-1",0
1,35,3,10,45,17,20,"1",-10
1,36,4,23,34,26,26,"1",-3
1,37,4,7,12,30,23,"1",-16
1,38,2,99,99,71,90,"-1",9
1,39,1,0,29,43,0,"1",0
1,40,4,76,76,21,50,"-1",26
1,41,4,57,34,17,90,"-1",-33
1,42,5,99,50,13,90,"-1",9
1,43,3,0,12,81,5,"1",-5
1,44,4,21,20,19,19,"-1",2
1,45,4,6,12,19,6,"1",0
1,46,2,0,50,45,0,"1",0
1,47,4,0,45,20,5,"1",-5
1,48,2,0,2,18,50,"1",-50
1,49,4,0,5,11,0,"1",0
1,50,3,0,12,38,0,"1",0
1,51,2,0,34,26,0,"1",0
2,1,1,25,25,26,26,"1",-1
2,2,5,50,25,20,50,"-1",0
2,3,3,0,25,29,0,"1",0
2,4,3,100,90,78,90,"-1",10
2,5,4,35,45,56,45,"1",-10
2,6,2,40,25,29,25,"-1",15
2,7,4,25,35,45,25,"1",0
2,8,3,90,80,75,80,"-1",10
2,9,4,10,15,29,15,"1",-5
2,10,4,20,15,56,20,"1",0
2,11,4,25,20,31,25,"1",0
2,12,3,100,80,78,100,"-1",0
2,13,5,0,4,22,0,"1",0
2,14,1,15,45,41,35,"1",-20
2,15,1,98,27,60,19,"-1",79
2,16,2,35,15,26,30,"-1",5
2,17,1,85,85,43,50,"-1",35
2,18,2,90,20,82,90,"-1",0
2,19,1,0,58,21,0,"1",0
2,20,1,0,25,40,5,"1",-5
2,21,1,90,20,35,90,"-1",0
2,22,1,90,58,60,80,"-1",10
2,23,2,90,45,71,80,"-1",10
2,24,3,50,45,14,20,"-1",30
2,25,4,45,48,14,15,"-1",30
2,26,3,90,80,29,80,"-1",10
2,27,3,20,25,45,45,"1",-25
2,28,3,15,10,20,20,"1",-5
2,29,3,85,80,66,60,"-1",25
2,30,3,100,45,48,100,"-1",0
2,31,2,90,25,19,15,"-1",75
2,32,5,15,10,33,15,"1",0
2,33,3,90,45,15,20,"-1",70
2,34,3,85,65,80,85,"-1",0
2,35,2,15,45,17,15,"1",0
2,36,2,25,25,26,26,"1",-1
2,37,5,35,35,30,30,"-1",5
2,38,2,90,87,71,80,"-1",10
2,39,3,10,10,43,10,"1",0
2,40,5,35,13,21,20,"-1",15
2,41,3,35,25,17,35,"-1",0
2,42,3,100,45,13,100,"-1",0
2,43,3,20,25,81,75,"1",-55
2,44,3,0,15,19,5,"1",-5
2,45,3,60,25,19,20,"-1",40
2,46,5,100,85,45,100,"-1",0
2,47,3,19,19,20,20,"1",-1
2,48,3,60,40,18,30,"-1",30
2,49,3,0,12,11,5,"1",-5
2,50,3,50,45,38,35,"-1",15
2,51,3,50,65,26,20,"-1",30
3,1,4,6,10,26,15,"1",-9
3,2,5,15,10,20,20,"1",-5
3,3,4,23,25,29,24,"1",-1
3,4,4,55,31,78,75,"1",-20
3,5,4,13,30,56,24,"1",-11
3,6,5,15,15,29,23,"1",-8
3,7,5,80,35,45,70,"-1",10
3,8,3,20,65,75,50,"1",-30
3,9,4,31,22,29,25,"-1",6
3,10,4,10,40,56,25,"1",-15
3,11,4,34,21,31,31,"-1",3
3,12,2,100,74,78,85,"-1",15
3,13,5,15,10,22,15,"1",0
3,14,2,5,21,41,25,"1",-20
3,15,2,100,70,60,75,"-1",25
3,16,2,5,15,26,21,"1",-16
3,17,1,35,50,43,38,"1",-3
3,18,2,12,24,82,50,"1",-38
3,19,1,5,16,21,10,"1",-5
3,20,2,10,24,40,25,"1",-15
3,21,1,70,65,35,51,"-1",19
3,22,1,66,65,60,66,"-1",0
3,23,2,40,75,71,60,"1",-20
3,24,3,15,23,14,15,"-1",0
3,25,3,15,45,14,10,"-1",5
3,26,4,80,85,29,80,"-1",0
3,27,1,15,65,45,20,"1",-5
3,28,3,21,21,20,21,"-1",0
3,29,2,45,65,66,62,"1",-17
3,30,3,5,24,48,30,"1",-25
3,31,2,80,45,19,40,"-1",40
3,32,4,15,10,33,15,"1",0
3,33,5,91,43,15,60,"-1",31
3,34,3,12,45,80,65,"1",-53
3,35,1,8,25,17,10,"1",-2
3,36,2,60,35,26,30,"-1",30
3,37,4,30,31,30,30,"0",0
3,38,3,95,86,71,85,"-1",10
3,39,3,32,16,43,35,"1",-3
3,40,4,1,21,21,14,"1",-13
3,41,3,5,35,17,5,"1",0
3,42,3,5,40,13,10,"1",-5
3,43,4,3,15,81,25,"1",-22
3,44,3,10,43,19,15,"1",-5
3,45,3,1,15,19,5,"1",-4
3,46,4,10,25,45,30,"1",-20
3,47,4,15,23,20,15,"1",0
3,48,2,15,15,18,15,"1",0
3,49,4,3,6,11,3,"1",0
3,50,3,10,30,38,25,"1",-15
3,51,3,5,15,26,15,"1",-10
4,1,4,30,30,26,30,"-1",0
4,2,5,15,20,20,15,"1",0
4,3,4,65,40,29,65,"-1",0
4,4,4,60,25,78,60,"1",0
4,5,5,80,68,56,80,"-1",0
4,6,4,70,30,29,60,"-1",10
4,7,4,80,25,45,80,"-1",0
4,8,4,100,92,75,100,"-1",0
4,9,4,20,12,29,20,"1",0
4,10,4,80,70,56,80,"-1",0
4,11,4,60,30,31,60,"-1",0
4,12,1,5,60,78,5,"1",0
4,13,4,5,12,22,5,"1",0
4,14,2,70,60,41,50,"-1",20
4,15,2,96,91,60,96,"-1",0
4,16,3,40,40,26,40,"-1",0
4,17,3,70,40,43,60,"-1",10
4,18,2,100,90,82,100,"-1",0
4,19,1,60,20,21,20,"-1",40
4,20,1,5,9,40,5,"1",0
4,21,3,100,80,35,100,"-1",0
4,22,2,90,88,60,80,"-1",10
4,23,2,90,80,71,80,"-1",10
4,24,3,12,12,14,14,"1",-2
4,25,5,100,60,14,100,"-1",0
4,26,4,100,85,29,80,"-1",20
4,27,2,95,75,45,90,"-1",5
4,28,3,60,60,20,50,"-1",10
4,29,2,60,60,66,60,"1",0
4,30,4,100,15,48,100,"-1",0
4,31,3,10,20,19,10,"1",0
4,32,4,75,55,33,75,"-1",0
4,33,2,2,4,15,2,"1",0
4,34,2,88,90,80,88,"-1",0
4,35,1,3,15,17,3,"1",0
4,36,3,90,90,26,40,"-1",50
4,37,4,70,75,30,70,"-1",0
4,38,2,90,70,71,80,"-1",10
4,39,2,7,12,43,7,"1",0
4,40,5,91,37,21,91,"-1",0
4,41,3,100,35,17,100,"-1",0
4,42,2,60,50,13,30,"-1",30
4,43,4,10,15,81,20,"1",-10
4,44,3,3,8,19,8,"1",-5
4,45,4,95,27,19,96,"-1",-1
4,46,5,100,75,45,95,"-1",5
4,47,5,100,40,20,100,"-1",0
4,48,4,70,12,18,70,"-1",0
4,49,2,80,60,11,60,"-1",20
4,50,4,20,18,38,20,"1",0
4,51,2,30,40,26,30,"-1",0
5,1,5,0,12,26,12,"1",-12
5,2,5,12,12,20,12,"1",0
5,3,4,65,65,29,60,"-1",5
5,4,5,90,90,78,90,"-1",0
5,5,5,0,45,56,0,"1",0
5,6,5,100,43,29,100,"-1",0
5,7,5,0,20,45,0,"1",0
5,8,3,50,90,75,50,"1",0
5,9,4,0,15,29,0,"1",0
5,10,5,100,70,56,100,"-1",0
5,11,5,10,37,31,10,"1",0
5,12,3,100,80,78,100,"-1",0
5,13,5,12,0,22,0,"1",12
5,14,2,5,17,41,4,"1",1
5,15,2,0,50,60,0,"1",0
5,16,5,26,26,26,26,"0",0
5,17,2,50,25,43,50,"-1",0
5,18,2,10,25,82,25,"1",-15
5,19,2,75,75,21,75,"-1",0
5,20,2,25,65,40,20,"1",5
5,21,2,10,60,35,50,"1",-40
5,22,2,100,100,60,100,"-1",0
5,23,1,80,80,71,80,"-1",0
5,24,3,4,4,14,4,"1",0
5,25,4,0,12,14,0,"1",0
5,26,3,0,90,29,0,"1",0
5,27,3,60,25,45,60,"-1",0
5,28,3,15,15,20,15,"1",0
5,29,1,99,30,66,99,"-1",0
5,30,3,0,11,48,0,"1",0
5,31,2,100,50,19,0,"-1",100
5,32,5,100,40,33,0,"-1",100
5,33,4,0,17,15,0,"1",0
5,34,3,70,24,80,80,"1",-10
5,35,2,0,14,17,0,"1",0
5,36,2,75,75,26,75,"-1",0
5,37,3,0,30,30,0,"1",0
5,38,1,100,100,71,100,"-1",0
5,39,1,0,75,43,0,"1",0
5,40,4,0,50,21,0,"1",0
5,41,3,100,50,17,100,"-1",0
5,42,3,9,15,13,10,"1",-1
5,43,3,10,77,81,10,"1",0
5,44,3,10,20,19,10,"1",0
5,45,3,0,20,19,0,"1",0
5,46,5,100,90,45,100,"-1",0
5,47,3,100,60,20,100,"-1",0
5,48,3,0,30,18,0,"1",0
5,49,5,0,8,11,0,"1",0
5,50,5,0,7,38,0,"1",0
5,51,5,0,0,26,0,"1",0
6,1,5,50,50,26,26,"-1",24
6,2,5,5,10,20,10,"1",-5
6,3,4,80,80,29,80,"-1",0
6,4,3,95,95,78,95,"-1",0
6,5,5,70,35,56,50,"-1",20
6,6,4,20,20,29,29,"1",-9
6,7,3,0,20,45,0,"1",0
6,8,3,70,70,75,75,"1",-5
6,9,4,50,50,29,50,"-1",0
6,10,3,10,50,56,10,"1",0
6,11,4,95,60,31,95,"-1",0
6,12,3,100,95,78,100,"-1",0
6,13,5,0,5,22,5,"1",-5
6,14,2,60,30,41,60,"-1",0
6,15,1,50,50,60,60,"1",-10
6,16,2,50,50,26,26,"-1",24
6,17,1,10,15,43,5,"1",5
6,18,2,50,50,82,82,"1",-32
6,19,1,0,30,21,0,"1",0
6,20,2,0,30,40,0,"1",0
6,21,2,99,80,35,99,"-1",0
6,22,1,90,90,60,60,"-1",30
6,23,1,99,99,71,71,"-1",28
6,24,3,10,10,14,14,"1",-4
6,25,5,100,50,14,100,"-1",0
6,26,3,95,85,29,85,"-1",10
6,27,1,5,5,45,45,"1",-40
6,28,3,14,14,20,20,"1",-6
6,29,3,10,20,66,20,"1",-10
6,30,5,100,45,48,100,"-1",0
6,31,1,100,40,19,0,"-1",100
6,32,5,100,60,33,100,"-1",0
6,33,3,100,50,15,100,"-1",0
6,34,3,70,60,80,75,"1",-5
6,35,2,5,10,17,5,"1",0
6,36,2,50,50,26,26,"-1",24
6,37,4,10,50,30,10,"1",0
6,38,3,99,80,71,99,"-1",0
6,39,3,99,50,43,60,"-1",39
6,40,4,0,40,21,0,"1",0
6,41,1,0,50,17,0,"1",0
6,42,3,0,30,13,0,"1",0
6,43,4,30,50,81,40,"1",-10
6,44,3,10,10,19,19,"1",-9
6,45,4,90,90,19,90,"-1",0
6,46,4,95,40,45,90,"-1",5
6,47,3,35,35,20,20,"-1",15
6,48,3,100,70,18,100,"-1",0
6,49,3,10,25,11,11,"1",-1
6,50,3,0,40,38,0,"1",0
6,51,2,0,50,26,0,"1",0
7,1,4,50,60,26,30,"-1",20
7,2,5,0,20,20,20,"1",-20
7,3,3,0,30,29,0,"1",0
7,4,5,100,60,78,100,"-1",0
7,5,5,70,80,56,60,"-1",10
7,6,3,20,40,29,30,"1",-10
7,7,5,100,50,45,90,"-1",10
7,8,5,80,80,75,80,"-1",0
7,9,4,0,30,29,0,"1",0
7,10,3,60,60,56,60,"-1",0
7,11,2,0,40,31,20,"1",-20
7,12,3,100,90,78,100,"-1",0
7,13,3,0,20,22,10,"1",-10
7,14,2,60,60,41,40,"-1",20
7,15,2,90,80,60,80,"-1",10
7,16,2,40,50,26,30,"-1",10
7,17,2,50,50,43,50,"-1",0
7,18,2,100,80,82,80,"-1",20
7,19,1,20,60,21,10,"1",10
7,20,2,20,45,40,20,"1",0
7,21,2,100,60,35,100,"-1",0
7,22,1,100,80,60,80,"-1",20
7,23,1,100,90,71,100,"-1",0
7,24,3,50,40,14,10,"-1",40
7,25,4,0,20,14,10,"1",-10
7,26,4,100,90,29,100,"-1",0
7,27,2,10,40,45,30,"1",-20
7,28,3,18,18,20,20,"1",-2
7,29,2,95,80,66,80,"-1",15
7,30,4,0,50,48,0,"1",0
7,31,4,50,40,19,30,"-1",20
7,32,4,80,40,33,40,"-1",40
7,33,4,90,90,15,90,"-1",0
7,34,3,80,80,80,80,"0",0
7,35,3,20,30,17,20,"-1",0
7,36,2,10,10,26,30,"1",-20
7,37,4,20,40,30,20,"1",0
7,38,2,100,50,71,60,"-1",40
7,39,1,0,38,43,0,"1",0
7,40,4,80,70,21,70,"-1",10
7,41,4,90,90,17,10,"-1",80
7,42,3,10,10,13,10,"1",0
7,43,4,60,50,81,80,"1",-20
7,44,3,90,30,19,90,"-1",0
7,45,4,10,30,19,10,"1",0
7,46,4,100,70,45,80,"-1",20
7,47,3,30,20,20,20,"-1",10
7,48,2,0,10,18,0,"1",0
7,49,4,0,40,11,0,"1",0
7,50,3,20,30,38,20,"1",0
7,51,2,50,60,26,20,"-1",30
8,1,2,20,25,26,26,"1",-6
8,2,5,30,30,20,20,"-1",10
8,3,4,0,50,29,0,"1",0
8,4,4,100,80,78,100,"-1",0
8,5,4,60,40,56,56,"-1",4
8,6,5,50,40,29,35,"-1",15
8,7,4,50,50,45,50,"-1",0
8,8,2,25,75,75,25,"1",0
8,9,5,50,33,29,50,"-1",0
8,10,4,50,75,56,50,"1",0
8,11,4,10,10,31,10,"1",0
8,12,3,0,10,78,10,"1",-10
8,13,3,0,33,22,0,"1",0
8,14,1,5,10,41,15,"1",-10
8,15,1,20,30,60,20,"1",0
8,16,1,0,10,26,0,"1",0
8,17,1,10,15,43,10,"1",0
8,18,1,50,50,82,82,"1",-32
8,19,1,0,27,21,0,"1",0
8,20,1,0,25,40,0,"1",0
8,21,1,0,15,35,10,"1",-10
8,22,1,70,70,60,60,"-1",10
8,23,1,80,80,71,80,"-1",0
8,24,3,15,15,14,14,"-1",1
8,25,4,20,30,14,20,"-1",0
8,26,4,100,80,29,100,"-1",0
8,27,3,50,75,45,40,"-1",10
8,28,3,20,40,20,20,"0",0
8,29,1,80,80,66,80,"-1",0
8,30,2,0,20,48,0,"1",0
8,31,3,99,80,19,80,"-1",19
8,32,5,0,10,33,90,"1",-90
8,33,2,60,50,15,20,"-1",40
8,34,2,0,0,80,10,"1",-10
8,35,3,50,50,17,50,"-1",0
8,36,2,25,25,26,26,"1",-1
8,37,4,60,75,30,10,"-1",50
8,38,1,99,99,71,99,"-1",0
8,39,3,75,90,43,60,"-1",15
8,40,5,99,50,21,99,"-1",0
8,41,2,0,50,17,0,"1",0
8,42,5,100,99,13,100,"-1",0
8,43,5,10,10,81,50,"1",-40
8,44,4,100,60,19,100,"-1",0
8,45,3,10,18,19,10,"1",0
8,46,5,100,75,45,100,"-1",0
8,47,3,0,15,20,0,"1",0
8,48,2,0,10,18,0,"1",0
8,49,3,10,10,11,11,"1",-1
8,50,3,0,50,38,0,"1",0
8,51,3,0,40,26,0,"1",0
9,1,4,1,1,26,1,"1",0
9,2,5,0,2,20,0,"1",0
9,3,2,30,0,29,0,"-1",30
9,4,5,100,98,78,100,"-1",0
9,5,4,3,3,56,40,"1",-37
9,6,4,2,23,29,2,"1",0
9,7,3,0,35,45,0,"1",0
9,8,3,53,53,75,75,"1",-22
9,9,4,0,16,29,0,"1",0
9,10,5,20,32,56,20,"1",0
9,11,4,0,62,31,0,"1",0
9,12,2,100,100,78,100,"-1",0
9,13,3,30,0,22,0,"-1",30
9,14,2,83,67,41,83,"-1",0
9,15,1,100,85,60,100,"-1",0
9,16,1,65,100,26,100,"-1",-35
9,17,2,36,63,43,50,"1",-14
9,18,2,85,82,82,85,"-1",0
9,19,1,0,42,21,0,"1",0
9,20,2,0,31,40,0,"1",0
9,21,2,100,88,35,100,"-1",0
9,22,1,76,75,60,60,"-1",16
9,23,1,100,100,71,75,"-1",25
9,24,3,0,20,14,0,"1",0
9,25,1,0,10,14,0,"1",0
9,26,3,100,100,29,100,"-1",0
9,27,3,80,75,45,65,"-1",15
9,28,3,0,30,20,0,"1",0
9,29,1,90,76,66,60,"-1",30
9,30,1,0,11,48,0,"1",0
9,31,1,0,45,19,0,"1",0
9,32,5,90,86,33,30,"-1",60
9,33,2,0,16,15,0,"1",0
9,34,3,30,40,80,80,"1",-50
9,35,4,10,15,17,10,"1",0
9,36,2,50,95,26,30,"-1",20
9,37,4,95,95,30,25,"-1",70
9,38,3,100,100,71,89,"-1",11
9,39,5,16,41,43,30,"1",-14
9,40,5,100,40,21,80,"-1",20
9,41,2,30,20,17,20,"-1",10
9,42,3,100,50,13,100,"-1",0
9,43,2,73,65,81,85,"1",-12
9,44,3,0,20,19,0,"1",0
9,45,5,50,52,19,50,"-1",0
9,46,5,100,100,45,100,"-1",0
9,47,3,0,25,20,5,"1",-5
9,48,3,100,40,18,100,"-1",0
9,49,3,0,2,11,0,"1",0
9,50,5,0,30,38,0,"1",0
9,51,3,5,20,26,20,"1",-15
10,1,4,28,15,26,30,"-1",-2
10,2,1,1,12,20,1,"1",0
10,3,1,1,38,29,1,"1",0
10,4,5,99,95,78,99,"-1",0
10,5,5,56,25,56,56,"0",0
10,6,5,56,12,29,56,"-1",0
10,7,5,100,45,45,100,"-1",0
10,8,3,45,67,75,45,"1",0
10,9,3,1,10,29,1,"1",0
10,10,3,56,35,56,55,"0",1
10,11,4,1,28,31,1,"1",0
10,12,3,100,95,78,98,"-1",2
10,13,3,1,23,22,1,"1",0
10,14,2,2,23,41,20,"1",-18
10,15,2,15,14,60,12,"1",3
10,16,2,50,25,26,50,"-1",0
10,17,1,2,5,43,5,"1",-3
10,18,1,35,21,82,35,"1",0
10,19,2,12,45,21,12,"1",0
10,20,2,1,23,40,1,"1",0
10,21,1,12,18,35,12,"1",0
10,22,1,56,65,60,56,"1",0
10,23,1,12,18,71,18,"1",-6
10,24,3,13,15,14,13,"1",0
10,25,4,24,20,14,24,"-1",0
10,26,3,1,43,29,1,"1",0
10,27,2,75,85,45,35,"-1",40
10,28,3,12,18,20,12,"1",0
10,29,1,90,75,66,56,"-1",34
10,30,3,50,32,48,50,"-1",0
10,31,2,1,48,19,1,"1",0
10,32,5,1,23,33,12,"1",-11
10,33,3,90,90,15,35,"-1",55
10,34,3,2,21,80,2,"1",0
10,35,2,95,60,17,80,"-1",15
10,36,5,23,45,26,35,"1",-12
10,37,4,95,75,30,56,"-1",39
10,38,1,95,78,71,90,"-1",5
10,39,1,1,3,43,1,"1",0
10,40,5,100,45,21,100,"-1",0
10,41,3,1,25,17,1,"1",0
10,42,3,9,15,13,8,"1",1
10,43,3,2,5,81,56,"1",-54
10,44,3,15,35,19,12,"1",3
10,45,5,100,15,19,100,"-1",0
10,46,5,2,12,45,21,"1",-19
10,47,3,34,35,20,57,"-1",-23
10,48,3,1,35,18,1,"1",0
10,49,3,1,8,11,1,"1",0
10,50,3,1,15,38,1,"1",0
10,51,3,57,34,26,54,"-1",3
11,1,3,80,15,26,80,"-1",0
11,2,4,1,15,20,1,"1",0
11,3,3,0,35,29,0,"1",0
11,4,4,100,60,78,100,"-1",0
11,5,3,100,40,56,100,"-1",0
11,6,4,1,25,29,1,"1",0
11,7,3,0,35,45,0,"1",0
11,8,2,20,25,75,20,"1",0
11,9,4,80,30,29,80,"-1",0
11,10,3,60,30,56,60,"-1",0
11,11,4,0,15,31,10,"1",-10
11,12,3,100,80,78,100,"-1",0
11,13,3,0,20,22,0,"1",0
11,14,2,80,70,41,80,"-1",0
11,15,2,99,50,60,99,"-1",0
11,16,3,99,65,26,99,"-1",0
11,17,3,80,50,43,80,"-1",0
11,18,2,90,40,82,90,"-1",0
11,19,1,0,40,21,0,"1",0
11,20,2,1,15,40,1,"1",0
11,21,3,100,75,35,100,"-1",0
11,22,2,10,65,60,10,"1",0
11,23,2,99,70,71,99,"-1",0
11,24,3,30,30,14,20,"-1",10
11,25,3,0,20,14,0,"1",0
11,26,3,100,70,29,100,"-1",0
11,27,3,30,60,45,30,"1",0
11,28,3,35,35,20,25,"-1",10
11,29,2,99,65,66,99,"-1",0
11,30,3,0,20,48,0,"1",0
11,31,1,100,30,19,0,"-1",100
11,32,5,0,15,33,0,"1",0
11,33,3,0,10,15,0,"1",0
11,34,2,99,60,80,99,"-1",0
11,35,3,15,40,17,20,"1",-5
11,36,2,90,90,26,70,"-1",20
11,37,5,90,80,30,90,"-1",0
11,38,3,100,80,71,100,"-1",0
11,39,3,0,25,43,0,"1",0
11,40,4,50,50,21,50,"-1",0
11,41,3,0,15,17,0,"1",0
11,42,3,0,30,13,0,"1",0
11,43,3,0,15,81,0,"1",0
11,44,3,20,20,19,19,"-1",1
11,45,3,1,10,19,1,"1",0
11,46,5,100,45,45,100,"-1",0
11,47,3,15,15,20,20,"1",-5
11,48,3,100,40,18,100,"-1",0
11,49,3,0,15,11,0,"1",0
11,50,3,0,30,38,1,"1",-1
11,51,3,0,30,26,0,"1",0
12,1,3,50,20,26,40,"-1",10
12,2,5,10,10,20,20,"1",-10
12,3,4,20,10,29,10,"1",10
12,4,5,100,89,78,100,"-1",0
12,5,5,20,70,56,20,"1",0
12,6,4,99,20,29,99,"-1",0
12,7,4,0,70,45,0,"1",0
12,8,4,100,89,75,100,"-1",0
12,9,5,100,40,29,100,"-1",0
12,10,4,10,35,56,10,"1",0
12,11,5,4,15,31,10,"1",-6
12,12,2,10,10,78,40,"1",-30
12,13,5,15,2,22,2,"1",13
12,14,2,16,16,41,30,"1",-14
12,15,2,90,60,60,90,"-1",0
12,16,2,15,20,26,30,"1",-15
12,17,2,5,10,43,5,"1",0
12,18,2,5,20,82,5,"1",0
12,19,2,10,60,21,10,"1",0
12,20,1,0,8,40,0,"1",0
12,21,3,60,60,35,60,"-1",0
12,22,1,10,20,60,30,"1",-20
12,23,2,66,66,71,66,"1",0
12,24,2,12,9,14,20,"1",-8
12,25,4,20,15,14,20,"-1",0
12,26,3,100,80,29,100,"-1",0
12,27,2,50,50,45,45,"-1",5
12,28,3,50,50,20,20,"-1",30
12,29,2,50,60,66,50,"1",0
12,30,3,5,15,48,5,"1",0
12,31,2,80,60,19,80,"-1",0
12,32,5,100,30,33,100,"-1",0
12,33,3,0,5,15,0,"1",0
12,34,3,85,85,80,80,"-1",5
12,35,1,1,5,17,1,"1",0
12,36,3,50,50,26,26,"-1",24
12,37,3,90,60,30,90,"-1",0
12,38,2,100,90,71,100,"-1",0
12,39,1,0,30,43,0,"1",0
12,40,4,0,8,21,0,"1",0
12,41,2,5,60,17,5,"1",0
12,42,3,5,60,13,8,"1",-3
12,43,4,100,60,81,100,"-1",0
12,44,3,2,6,19,10,"1",-8
12,45,4,70,60,19,50,"-1",20
12,46,5,100,60,45,100,"-1",0
12,47,4,100,30,20,100,"-1",0
12,48,5,100,30,18,100,"-1",0
12,49,3,0,40,11,0,"1",0
12,50,3,10,30,38,15,"1",-5
12,51,3,50,35,26,26,"-1",24
13,1,4,1,22,26,1,"1",0
13,2,4,5,15,20,5,"1",0
13,3,2,2,22,29,2,"1",0
13,4,4,100,45,78,100,"-1",0
13,5,4,70,65,56,70,"-1",0
13,6,4,9,37,29,5,"1",4
13,7,4,10,60,45,10,"1",0
13,8,3,70,68,75,79,"1",-9
13,9,3,2,10,29,2,"1",0
13,10,4,70,45,56,70,"-1",0
13,11,4,8,15,31,8,"1",0
13,12,3,75,75,78,75,"1",0
13,13,4,0,10,22,0,"1",0
13,14,2,58,58,41,41,"-1",17
13,15,1,70,75,60,55,"-1",15
13,16,2,56,56,26,10,"-1",46
13,17,2,20,56,43,10,"1",10
13,18,2,75,45,82,89,"1",-14
13,19,2,5,22,21,5,"1",0
13,20,1,2,33,40,2,"1",0
13,21,2,40,60,35,15,"-1",25
13,22,2,88,88,60,60,"-1",28
13,23,2,0,56,71,0,"1",0
13,24,3,20,20,14,14,"-1",6
13,25,2,4,22,14,4,"1",0
13,26,3,98,75,29,98,"-1",0
13,27,3,30,25,45,45,"1",-15
13,28,3,50,50,20,20,"-1",30
13,29,2,90,80,66,90,"-1",0
13,30,2,2,15,48,2,"1",0
13,31,5,100,76,19,100,"-1",0
13,32,4,100,45,33,100,"-1",0
13,33,3,10,22,15,10,"1",0
13,34,2,85,75,80,85,"-1",0
13,35,2,20,90,17,5,"-1",15
13,36,2,70,60,26,70,"-1",0
13,37,4,99,86,30,99,"-1",0
13,38,2,99,95,71,75,"-1",24
13,39,4,56,22,43,36,"-1",20
13,40,4,5,22,21,5,"1",0
13,41,3,96,85,17,75,"-1",21
13,42,3,97,95,13,97,"-1",0
13,43,3,1,2,81,1,"1",0
13,44,3,50,50,19,15,"-1",35
13,45,3,15,24,19,15,"1",0
13,46,5,100,89,45,100,"-1",0
13,47,3,0,15,20,5,"1",-5
13,48,2,2,3,18,10,"1",-8
13,49,3,0,10,11,0,"1",0
13,50,4,100,54,38,100,"-1",0
13,51,3,5,35,26,5,"1",0
14,1,4,2,12,26,2,"1",0
14,2,5,60,40,20,40,"-1",20
14,3,5,25,0,29,0,"1",25
14,4,4,100,70,78,100,"-1",0
14,5,4,100,90,56,100,"-1",0
14,6,4,80,12,29,80,"-1",0
14,7,3,0,40,45,0,"1",0
14,8,3,100,100,75,100,"-1",0
14,9,4,35,35,29,29,"-1",6
14,10,3,5,30,56,5,"1",0
14,11,4,2,12,31,2,"1",0
14,12,3,100,90,78,100,"-1",0
14,13,5,33,33,22,22,"-1",11
14,14,1,10,23,41,10,"1",0
14,15,2,45,45,60,45,"1",0
14,16,3,25,0,26,0,"1",25
14,17,1,0,43,43,0,"1",0
14,18,1,25,25,82,82,"1",-57
14,19,1,3,7,21,4,"1",-1
14,20,1,0,30,40,0,"1",0
14,21,2,80,80,35,80,"-1",0
14,22,1,100,100,60,100,"-1",0
14,23,1,0,30,71,0,"1",0
14,24,3,15,15,14,14,"-1",1
14,25,4,5,25,14,5,"1",0
14,26,4,100,95,29,100,"-1",0
14,27,2,0,20,45,0,"1",0
14,28,3,15,15,20,20,"1",-5
14,29,2,90,80,66,90,"-1",0
14,30,3,0,15,48,0,"1",0
14,31,4,25,60,19,19,"-1",6
14,32,4,100,45,33,100,"-1",0
14,33,3,0,33,15,0,"1",0
14,34,3,0,10,80,0,"1",0
14,35,1,0,5,17,0,"1",0
14,36,2,80,80,26,26,"-1",54
14,37,4,20,50,30,30,"1",-10
14,38,1,100,100,71,100,"-1",0
14,39,3,100,50,43,100,"-1",0
14,40,3,90,90,21,90,"-1",0
14,41,3,100,80,17,100,"-1",0
14,42,3,0,25,13,0,"1",0
14,43,3,0,30,81,0,"1",0
14,44,3,20,20,19,19,"-1",1
14,45,3,0,5,19,5,"1",-5
14,46,3,100,60,45,100,"-1",0
14,47,3,0,12,20,0,"1",0
14,48,3,30,30,18,18,"-1",12
14,49,4,75,25,11,75,"-1",0
14,50,3,0,15,38,0,"1",0
14,51,3,0,50,26,0,"1",0
15,1,4,8,8,26,20,"1",-12
15,2,5,10,35,20,10,"1",0
15,3,4,60,80,29,80,"-1",-20
15,4,3,60,60,78,78,"1",-18
15,5,4,60,20,56,70,"-1",-10
15,6,4,12,12,29,29,"1",-17
15,7,4,20,20,45,20,"1",0
15,8,4,80,80,75,80,"-1",0
15,9,4,45,30,29,45,"-1",0
15,10,3,30,40,56,40,"1",-10
15,11,4,30,20,31,31,"1",-1
15,12,3,70,70,78,78,"1",-8
15,13,4,7,10,22,15,"1",-8
15,14,3,10,15,41,30,"1",-20
15,15,2,20,20,60,60,"1",-40
15,16,3,40,60,26,60,"-1",-20
15,17,2,20,20,43,43,"1",-23
15,18,2,40,40,82,50,"1",-10
15,19,2,40,40,21,21,"-1",19
15,20,1,10,10,40,20,"1",-10
15,21,2,90,90,35,70,"-1",20
15,22,2,90,90,60,60,"-1",30
15,23,2,85,85,71,80,"-1",5
15,24,3,3,3,14,14,"1",-11
15,25,4,60,45,14,60,"-1",0
15,26,3,90,70,29,90,"-1",0
15,27,3,70,60,45,60,"-1",10
15,28,3,40,40,20,20,"-1",20
15,29,2,20,20,66,50,"1",-30
15,30,4,12,12,48,30,"1",-18
15,31,2,90,45,19,90,"-1",0
15,32,4,40,40,33,33,"-1",7
15,33,3,20,20,15,15,"-1",5
15,34,3,5,3,80,10,"1",-5
15,35,2,40,40,17,17,"-1",23
15,36,3,60,60,26,26,"-1",34
15,37,4,10,10,30,30,"1",-20
15,38,2,80,80,71,71,"-1",9
15,39,2,5,30,43,5,"1",0
15,40,4,70,70,21,21,"-1",49
15,41,2,45,10,17,45,"-1",0
15,42,3,20,20,13,20,"-1",0
15,43,4,10,20,81,20,"1",-10
15,44,3,10,10,19,19,"1",-9
15,45,3,30,15,19,30,"-1",0
15,46,5,70,60,45,60,"-1",10
15,47,4,10,10,20,20,"1",-10
15,48,2,30,40,18,15,"-1",15
15,49,3,20,30,11,11,"-1",9
15,50,4,20,20,38,38,"1",-18
15,51,3,40,40,26,26,"-1",14
16,1,3,15,13,26,15,"1",0
16,2,4,35,35,20,35,"-1",0
16,3,4,15,20,29,15,"1",0
16,4,4,100,80,78,100,"-1",0
16,5,4,40,25,56,40,"1",0
16,6,4,5,5,29,5,"1",0
16,7,5,100,45,45,100,"-1",0
16,8,5,100,65,75,100,"-1",0
16,9,4,10,20,29,10,"1",0
16,10,4,10,40,56,10,"1",0
16,11,4,15,25,31,15,"1",0
16,12,3,40,35,78,40,"1",0
16,13,4,5,30,22,5,"1",0
16,14,2,10,40,41,20,"1",-10
16,15,2,30,50,60,30,"1",0
16,16,3,10,15,26,10,"1",0
16,17,1,10,35,43,10,"1",0
16,18,2,35,45,82,35,"1",0
16,19,1,0,65,21,0,"1",0
16,20,1,0,25,40,0,"1",0
16,21,2,50,60,35,60,"-1",-10
16,22,1,10,35,60,10,"1",0
16,23,2,70,75,71,70,"1",0
16,24,3,65,65,14,65,"-1",0
16,25,3,10,25,14,25,"1",-15
16,26,4,100,75,29,100,"-1",0
16,27,2,25,50,45,25,"1",0
16,28,3,5,11,20,5,"1",0
16,29,3,50,50,66,50,"1",0
16,30,4,100,40,48,100,"-1",0
16,31,3,10,25,19,5,"1",5
16,32,2,100,65,33,100,"-1",0
16,33,3,10,25,15,5,"1",5
16,34,3,5,16,80,10,"1",-5
16,35,3,35,35,17,25,"-1",10
16,36,3,20,75,26,25,"1",-5
16,37,4,50,65,30,50,"-1",0
16,38,3,80,85,71,70,"-1",10
16,39,2,5,25,43,5,"1",0
16,40,4,100,75,21,100,"-1",0
16,41,3,10,35,17,5,"1",5
16,42,3,10,15,13,10,"1",0
16,43,3,10,25,81,25,"1",-15
16,44,3,10,15,19,10,"1",0
16,45,4,50,45,19,50,"-1",0
16,46,5,100,50,45,100,"-1",0
16,47,3,10,10,20,10,"1",0
16,48,2,0,15,18,0,"1",0
16,49,4,10,40,11,10,"1",0
16,50,3,0,65,38,0,"1",0
16,51,3,10,45,26,10,"1",0
17,1,5,30,50,26,15,"-1",15
17,2,5,80,70,20,40,"-1",40
17,3,4,30,0,29,0,"-1",30
17,4,4,100,70,78,100,"-1",0
17,5,4,20,40,56,20,"1",0
17,6,4,70,10,29,80,"-1",-10
17,7,5,90,50,45,90,"-1",0
17,8,3,5,20,75,10,"1",-5
17,9,3,10,20,29,10,"1",0
17,10,3,10,40,56,10,"1",0
17,11,4,5,15,31,5,"1",0
17,12,2,0,95,78,0,"1",0
17,13,5,15,0,22,0,"1",15
17,14,2,90,80,41,70,"-1",20
17,15,1,95,80,60,90,"-1",5
17,16,2,40,20,26,50,"-1",-10
17,17,1,20,70,43,10,"1",10
17,18,1,20,60,82,20,"1",0
17,19,1,30,60,21,10,"-1",20
17,20,2,70,30,40,70,"-1",0
17,21,2,95,95,35,95,"-1",0
17,22,1,90,95,60,90,"-1",0
17,23,2,5,40,71,10,"1",-5
17,24,3,20,20,14,14,"-1",6
17,25,2,50,80,14,2,"-1",48
17,26,4,100,90,29,100,"-1",0
17,27,3,80,80,45,70,"-1",10
17,28,3,20,20,20,20,"0",0
17,29,2,70,80,66,50,"-1",20
17,30,3,10,20,48,20,"1",-10
17,31,2,70,50,19,20,"-1",50
17,32,3,0,20,33,0,"1",0
17,33,3,90,70,15,90,"-1",0
17,34,2,30,20,80,30,"1",0
17,35,1,0,20,17,0,"1",0
17,36,2,70,70,26,26,"-1",44
17,37,4,95,95,30,95,"-1",0
17,38,3,100,95,71,100,"-1",0
17,39,2,90,80,43,90,"-1",0
17,40,3,0,30,21,0,"1",0
17,41,2,90,30,17,80,"-1",10
17,42,3,5,10,13,5,"1",0
17,43,3,100,70,81,100,"-1",0
17,44,3,0,30,19,0,"1",0
17,45,3,20,40,19,10,"-1",10
17,46,5,80,50,45,80,"-1",0
17,47,2,60,30,20,50,"-1",10
17,48,2,0,10,18,0,"1",0
17,49,2,10,40,11,2,"1",8
17,50,4,5,30,38,10,"1",-5
17,51,2,30,60,26,20,"-1",10
18,1,5,10,10,26,26,"1",-16
18,2,5,15,15,20,20,"1",-5
18,3,4,0,25,29,0,"1",0
18,4,5,10,75,78,5,"1",5
18,5,4,90,50,56,90,"-1",0
18,6,5,25,25,29,25,"1",0
18,7,5,90,75,45,90,"-1",0
18,8,3,15,40,75,25,"1",-10
18,9,5,80,40,29,75,"-1",5
18,10,3,0,50,56,0,"1",0
18,11,4,5,5,31,5,"1",0
18,12,3,100,95,78,100,"-1",0
18,13,5,0,40,22,0,"1",0
18,14,1,5,25,41,5,"1",0
18,15,2,50,50,60,60,"1",-10
18,16,2,50,20,26,50,"-1",0
18,17,1,60,60,43,43,"-1",17
18,18,2,15,60,82,15,"1",0
18,19,1,0,15,21,0,"1",0
18,20,1,2,11,40,2,"1",0
18,21,2,5,15,35,20,"1",-15
18,22,1,75,75,60,60,"-1",15
18,23,2,90,90,71,71,"-1",19
18,24,3,50,25,14,28,"-1",22
18,25,4,90,25,14,90,"-1",0
18,26,3,100,90,29,100,"-1",0
18,27,2,60,60,45,45,"-1",15
18,28,3,40,40,20,30,"-1",10
18,29,1,60,60,66,66,"1",-6
18,30,4,100,20,48,100,"-1",0
18,31,2,99,75,19,1,"-1",98
18,32,4,80,40,33,80,"-1",0
18,33,3,50,25,15,50,"-1",0
18,34,3,40,40,80,60,"1",-20
18,35,2,10,50,17,10,"1",0
18,36,2,75,75,26,26,"-1",49
18,37,4,90,75,30,75,"-1",15
18,38,1,100,100,71,100,"-1",0
18,39,2,0,70,43,0,"1",0
18,40,5,0,80,21,1,"1",-1
18,41,2,0,25,17,0,"1",0
18,42,3,5,60,13,5,"1",0
18,43,4,0,5,81,5,"1",-5
18,44,3,15,15,19,19,"1",-4
18,45,5,95,70,19,90,"-1",5
18,46,4,5,17,45,5,"1",0
18,47,5,80,50,20,70,"-1",10
18,48,2,80,40,18,80,"-1",0
18,49,3,1,4,11,2,"1",-1
18,50,3,0,30,38,0,"1",0
18,51,3,100,50,26,100,"-1",0
19,1,3,50,50,26,39,"-1",11
19,2,5,7,19,20,10,"1",-3
19,3,3,0,20,29,0,"1",0
19,4,4,100,90,78,100,"-1",0
19,5,3,100,70,56,90,"-1",10
19,6,4,60,30,29,60,"-1",0
19,7,4,25,35,45,25,"1",0
19,8,3,40,60,75,40,"1",0
19,9,2,2,10,29,2,"1",0
19,10,3,60,70,56,60,"-1",0
19,11,4,70,40,31,70,"-1",0
19,12,2,70,80,78,70,"1",0
19,13,2,0,13,22,0,"1",0
19,14,2,20,30,41,20,"1",0
19,15,1,5,10,60,5,"1",0
19,16,2,2,9,26,2,"1",0
19,17,2,3,10,43,3,"1",0
19,18,2,90,70,82,90,"-1",0
19,19,1,0,4,21,0,"1",0
19,20,2,1,12,40,2,"1",-1
19,21,2,10,10,35,10,"1",0
19,22,2,80,80,60,65,"-1",15
19,23,2,86,80,71,78,"-1",8
19,24,3,0,10,14,0,"1",0
19,25,3,5,5,14,5,"1",0
19,26,4,100,80,29,100,"-1",0
19,27,3,8,45,45,8,"1",0
19,28,3,33,33,20,20,"-1",13
19,29,1,90,90,66,81,"-1",9
19,30,2,0,10,48,0,"1",0
19,31,3,100,50,19,3,"-1",97
19,32,3,100,70,33,100,"-1",0
19,33,2,70,60,15,60,"-1",10
19,34,3,80,76,80,80,"0",0
19,35,2,0,10,17,0,"1",0
19,36,2,86,80,26,56,"-1",30
19,37,4,80,90,30,80,"-1",0
19,38,2,100,96,71,100,"-1",0
19,39,3,50,40,43,54,"-1",-4
19,40,4,50,60,21,50,"-1",0
19,41,3,6,22,17,6,"1",0
19,42,3,80,80,13,80,"-1",0
19,43,3,70,50,81,70,"1",0
19,44,3,10,30,19,10,"1",0
19,45,4,10,20,19,10,"1",0
19,46,4,100,78,45,100,"-1",0
19,47,4,50,45,20,40,"-1",10
19,48,2,10,40,18,10,"1",0
19,49,3,0,15,11,0,"1",0
19,50,3,0,15,38,0,"1",0
19,51,2,3,15,26,10,"1",-7
20,1,2,1,15,26,1,"1",0
20,2,5,1,12,20,5,"1",-4
20,3,4,0,18,29,0,"1",0
20,4,4,100,30,78,21,"-1",79
20,5,4,21,21,56,70,"1",-49
20,6,5,0,23,29,0,"1",0
20,7,4,90,83,45,100,"-1",-10
20,8,3,50,82,75,50,"1",0
20,9,4,25,17,29,15,"1",10
20,10,4,100,20,56,100,"-1",0
20,11,5,5,17,31,12,"1",-7
20,12,3,100,95,78,95,"-1",5
20,13,4,0,10,22,0,"1",0
20,14,5,8,47,41,7,"1",1
20,15,1,40,36,60,60,"1",-20
20,16,2,5,17,26,5,"1",0
20,17,3,99,75,43,76,"-1",23
20,18,2,18,37,82,40,"1",-22
20,19,1,22,31,21,23,"-1",-1
20,20,1,0,25,40,10,"1",-10
20,21,1,100,79,35,50,"-1",50
20,22,1,100,99,60,81,"-1",19
20,23,2,10,66,71,10,"1",0
20,24,3,10,7,14,10,"1",0
20,25,3,0,15,14,0,"1",0
20,26,3,100,79,29,100,"-1",0
20,27,2,5,8,45,30,"1",-25
20,28,3,19,19,20,20,"1",-1
20,29,2,15,68,66,42,"1",-27
20,30,3,0,20,48,1,"1",-1
20,31,2,55,31,19,20,"-1",35
20,32,5,0,10,33,0,"1",0
20,33,3,100,72,15,100,"-1",0
20,34,3,70,86,80,90,"1",-20
20,35,1,1,10,17,5,"1",-4
20,36,2,35,35,26,26,"-1",9
20,37,4,25,25,30,25,"1",0
20,38,3,100,87,71,100,"-1",0
20,39,2,0,50,43,0,"1",0
20,40,5,5,8,21,3,"1",2
20,41,3,100,25,17,100,"-1",0
20,42,2,100,11,13,100,"-1",0
20,43,3,0,76,81,0,"1",0
20,44,3,37,37,19,19,"-1",18
20,45,3,50,38,19,25,"-1",25
20,46,5,95,58,45,95,"-1",0
20,47,3,67,63,20,14,"-1",53
20,48,3,100,50,18,100,"-1",0
20,49,4,100,20,11,100,"-1",0
20,50,3,35,35,38,35,"1",0
20,51,3,50,15,26,50,"-1",0
21,1,4,0,5,26,20,"1",-20
21,2,5,0,25,20,5,"1",-5
21,3,3,40,60,29,40,"-1",0
21,4,3,100,50,78,100,"-1",0
21,5,4,70,60,56,70,"-1",0
21,6,4,70,50,29,70,"-1",0
21,7,3,0,20,45,0,"1",0
21,8,4,50,70,75,100,"1",-50
21,9,4,0,10,29,10,"1",-10
21,10,3,20,70,56,20,"1",0
21,11,4,10,5,31,10,"1",0
21,12,2,100,50,78,100,"-1",0
21,13,4,0,5,22,0,"1",0
21,14,2,30,50,41,30,"1",0
21,15,2,50,50,60,60,"1",-10
21,16,2,60,40,26,50,"-1",10
21,17,1,10,50,43,10,"1",0
21,18,2,100,80,82,100,"-1",0
21,19,2,85,50,21,80,"-1",5
21,20,2,60,40,40,60,"-1",0
21,21,2,90,70,35,90,"-1",0
21,22,2,90,90,60,90,"-1",0
21,23,2,85,75,71,85,"-1",0
21,24,3,50,30,14,10,"-1",40
21,25,3,60,60,14,50,"-1",10
21,26,4,100,90,29,100,"-1",0
21,27,3,20,20,45,50,"1",-30
21,28,3,20,14,20,20,"0",0
21,29,2,80,80,66,80,"-1",0
21,30,4,10,30,48,10,"1",0
21,31,3,20,50,19,20,"-1",0
21,32,4,50,50,33,50,"-1",0
21,33,3,100,70,15,100,"-1",0
21,34,3,0,60,80,0,"1",0
21,35,2,100,100,17,100,"-1",0
21,36,2,60,60,26,60,"-1",0
21,37,3,10,50,30,20,"1",-10
21,38,2,100,90,71,100,"-1",0
21,39,2,0,20,43,0,"1",0
21,40,3,0,60,21,0,"1",0
21,41,3,10,25,17,10,"1",0
21,42,3,50,60,13,50,"-1",0
21,43,3,0,50,81,30,"1",-30
21,44,3,60,40,19,60,"-1",0
21,45,4,80,40,19,80,"-1",0
21,46,5,100,60,45,100,"-1",0
21,47,3,0,30,20,0,"1",0
21,48,3,90,80,18,80,"-1",10
21,49,3,0,20,11,5,"1",-5
21,50,1,0,30,38,0,"1",0
21,51,1,0,30,26,0,"1",0
22,1,1,0,5,26,0,"1",0
22,2,4,20,7,20,20,"0",0
22,3,4,50,70,29,70,"-1",-20
22,4,4,100,70,78,100,"-1",0
22,5,5,50,40,56,56,"1",-6
22,6,4,10,10,29,29,"1",-19
22,7,5,20,70,45,20,"1",0
22,8,4,60,60,75,75,"1",-15
22,9,4,70,60,29,60,"-1",10
22,10,4,70,60,56,70,"-1",0
22,11,5,50,50,31,40,"-1",10
22,12,3,80,80,78,80,"-1",0
22,13,4,20,20,22,20,"1",0
22,14,2,20,20,41,30,"1",-10
22,15,3,80,70,60,70,"-1",10
22,16,1,20,20,26,26,"1",-6
22,17,1,30,50,43,40,"1",-10
22,18,2,50,50,82,82,"1",-32
22,19,2,100,70,21,100,"-1",0
22,20,1,0,20,40,0,"1",0
22,21,2,100,60,35,100,"-1",0
22,22,2,100,100,60,100,"-1",0
22,23,2,100,70,71,71,"-1",29
22,24,3,5,5,14,14,"1",-9
22,25,5,100,20,14,100,"-1",0
22,26,3,100,100,29,100,"-1",0
22,27,3,20,20,45,40,"1",-20
22,28,3,30,30,20,20,"-1",10
22,29,2,5,50,66,50,"1",-45
22,30,4,100,50,48,100,"-1",0
22,31,3,20,15,19,20,"-1",0
22,32,3,100,30,33,90,"-1",10
22,33,3,0,20,15,0,"1",0
22,34,2,50,50,80,80,"1",-30
22,35,3,0,5,17,0,"1",0
22,36,2,100,100,26,50,"-1",50
22,37,4,30,30,30,30,"0",0
22,38,2,100,100,71,80,"-1",20
22,39,3,40,50,43,40,"1",0
22,40,3,100,60,21,100,"-1",0
22,41,3,20,15,17,17,"-1",3
22,42,3,100,70,13,100,"-1",0
22,43,2,5,10,81,60,"1",-55
22,44,3,10,10,19,5,"1",5
22,45,3,20,20,19,20,"-1",0
22,46,5,70,40,45,70,"-1",0
22,47,3,0,20,20,0,"1",0
22,48,2,5,5,18,10,"1",-5
22,49,4,30,20,11,30,"-1",0
22,50,4,80,60,38,80,"-1",0
22,51,3,20,50,26,20,"1",0
23,1,5,5,10,26,5,"1",0
23,2,5,10,5,20,10,"1",0
23,3,3,0,28,29,0,"1",0
23,4,2,100,100,78,100,"-1",0
23,5,5,20,38,56,20,"1",0
23,6,3,5,15,29,5,"1",0
23,7,4,75,55,45,75,"-1",0
23,8,3,99,87,75,99,"-1",0
23,9,5,11,11,29,15,"1",-4
23,10,4,25,50,56,25,"1",0
23,11,3,5,24,31,5,"1",0
23,12,2,100,90,78,100,"-1",0
23,13,4,0,27,22,0,"1",0
23,14,2,100,43,41,99,"-1",1
23,15,1,100,28,60,100,"-1",0
23,16,2,22,56,26,46,"1",-24
23,17,1,10,98,43,10,"1",0
23,18,2,89,47,82,89,"-1",0
23,19,2,88,49,21,88,"-1",0
23,20,1,2,25,40,2,"1",0
23,21,3,95,78,35,95,"-1",0
23,22,1,99,99,60,99,"-1",0
23,23,2,100,99,71,100,"-1",0
23,24,3,17,17,14,17,"-1",0
23,25,2,10,50,14,10,"1",0
23,26,3,100,86,29,100,"-1",0
23,27,1,10,10,45,15,"1",-5
23,28,3,19,23,20,20,"1",-1
23,29,2,66,66,66,66,"0",0
23,30,4,0,35,48,4,"1",-4
23,31,1,0,0,19,0,"1",0
23,32,5,25,60,33,25,"1",0
23,33,3,20,20,15,10,"-1",10
23,34,1,0,0,80,0,"1",0
23,35,2,25,36,17,20,"-1",5
23,36,3,80,88,26,50,"-1",30
23,37,3,25,58,30,30,"1",-5
23,38,3,95,95,71,95,"-1",0
23,39,1,0,65,43,0,"1",0
23,40,3,99,78,21,99,"-1",0
23,41,1,50,57,17,25,"-1",25
23,42,3,95,86,13,99,"-1",-4
23,43,4,70,63,81,70,"1",0
23,44,3,0,17,19,1,"1",-1
23,45,4,10,21,19,10,"1",0
23,46,5,100,70,45,100,"-1",0
23,47,2,0,20,20,1,"1",-1
23,48,3,100,63,18,100,"-1",0
23,49,3,0,22,11,1,"1",-1
23,50,1,0,22,38,0,"1",0
23,51,3,50,88,26,50,"-1",0
24,1,5,50,30,26,50,"-1",0
24,2,3,20,30,20,20,"0",0
24,3,4,45,45,29,30,"-1",15
24,4,4,60,40,78,60,"1",0
24,5,4,80,70,56,70,"-1",10
24,6,5,25,15,29,25,"1",0
24,7,3,15,45,45,20,"1",-5
24,8,1,70,67,75,70,"1",0
24,9,5,100,55,29,100,"-1",0
24,10,2,10,20,56,30,"1",-20
24,11,5,30,15,31,25,"1",5
24,12,3,100,100,78,80,"-1",20
24,13,5,30,40,22,35,"-1",-5
24,14,2,45,55,41,45,"-1",0
24,15,3,0,34,60,30,"1",-30
24,16,2,50,50,26,30,"-1",20
24,17,2,15,70,43,25,"1",-10
24,18,2,100,100,82,85,"-1",15
24,19,1,0,43,21,0,"1",0
24,20,3,100,45,40,50,"-1",50
24,21,2,25,45,35,25,"1",0
24,22,2,60,65,60,65,"0",-5
24,23,2,80,70,71,80,"-1",0
24,24,3,19,19,14,10,"-1",9
24,25,4,100,13,14,100,"-1",0
24,26,3,100,100,29,100,"-1",0
24,27,1,70,65,45,50,"-1",20
24,28,3,19,19,20,19,"1",0
24,29,2,50,34,66,50,"1",0
24,30,5,80,45,48,75,"-1",5
24,31,1,15,30,19,30,"1",-15
24,32,4,80,65,33,80,"-1",0
24,33,4,15,5,15,5,"0",10
24,34,3,60,50,80,60,"1",0
24,35,2,0,15,17,10,"1",-10
24,36,3,100,65,26,40,"-1",60
24,37,4,25,25,30,25,"1",0
24,38,2,100,100,71,100,"-1",0
24,39,2,0,60,43,5,"1",-5
24,40,5,100,78,21,100,"-1",0
24,41,3,80,80,17,30,"-1",50
24,42,3,20,20,13,10,"-1",10
24,43,4,0,45,81,30,"1",-30
24,44,3,33,33,19,25,"-1",8
24,45,3,15,19,19,10,"1",5
24,46,5,100,60,45,100,"-1",0
24,47,1,50,50,20,30,"-1",20
24,48,3,10,15,18,15,"1",-5
24,49,3,10,30,11,5,"1",5
24,50,3,75,65,38,100,"-1",-25
24,51,3,70,50,26,40,"-1",30
25,1,4,50,60,26,50,"-1",0
25,2,5,10,60,20,10,"1",0
25,3,1,0,20,29,0,"1",0
25,4,5,100,100,78,100,"-1",0
25,5,5,85,70,56,70,"-1",15
25,6,3,2,30,29,5,"1",-3
25,7,4,50,45,45,50,"-1",0
25,8,5,100,90,75,100,"-1",0
25,9,1,0,2,29,0,"1",0
25,10,5,100,75,56,100,"-1",0
25,11,2,0,27,31,0,"1",0
25,12,4,20,60,78,40,"1",-20
25,13,3,0,20,22,0,"1",0
25,14,1,5,15,41,5,"1",0
25,15,1,1,5,60,1,"1",0
25,16,2,2,15,26,2,"1",0
25,17,1,0,35,43,0,"1",0
25,18,1,1,24,82,2,"1",-1
25,19,1,0,10,21,0,"1",0
25,20,2,0,15,40,10,"1",-10
25,21,1,2,15,35,2,"1",0
25,22,1,5,15,60,30,"1",-25
25,23,2,90,80,71,90,"-1",0
25,24,3,1,2,14,1,"1",0
25,25,4,40,30,14,40,"-1",0
25,26,4,15,70,29,15,"1",0
25,27,1,0,5,45,0,"1",0
25,28,3,15,15,20,15,"1",0
25,29,1,30,40,66,40,"1",-10
25,30,4,5,10,48,5,"1",0
25,31,1,4,24,19,5,"1",-1
25,32,2,80,80,33,80,"-1",0
25,33,3,90,90,15,90,"-1",0
25,34,3,5,23,80,5,"1",0
25,35,1,0,35,17,0,"1",0
25,36,3,30,60,26,26,"-1",4
25,37,3,80,80,30,30,"-1",50
25,38,2,90,90,71,71,"-1",19
25,39,2,100,50,43,45,"-1",55
25,40,5,100,70,21,100,"-1",0
25,41,3,2,40,17,2,"1",0
25,42,3,10,20,13,10,"1",0
25,43,3,0,22,81,0,"1",0
25,44,3,5,9,19,5,"1",0
25,45,4,10,10,19,10,"1",0
25,46,1,0,35,45,0,"1",0
25,47,2,0,19,20,1,"1",-1
25,48,5,100,20,18,100,"-1",0
25,49,3,0,15,11,0,"1",0
25,50,1,0,2,38,0,"1",0
25,51,3,0,23,26,0,"1",0
26,1,4,0,50,26,0,"1",0
26,2,5,25,5,20,10,"-1",15
26,3,2,55,0,29,0,"-1",55
26,4,3,100,99,78,100,"-1",0
26,5,5,20,12,56,20,"1",0
26,6,2,22,30,29,17,"1",5
26,7,4,50,40,45,50,"-1",0
26,8,2,5,60,75,15,"1",-10
26,9,3,0,13,29,0,"1",0
26,10,5,30,65,56,30,"1",0
26,11,4,5,45,31,5,"1",0
26,12,2,99,85,78,99,"-1",0
26,13,3,45,50,22,10,"-1",35
26,14,2,65,50,41,50,"-1",15
26,15,1,5,17,60,5,"1",0
26,16,2,26,5,26,5,"0",21
26,17,1,10,25,43,20,"1",-10
26,18,2,50,45,82,50,"1",0
26,19,1,0,35,21,0,"1",0
26,20,3,1,60,40,5,"1",-4
26,21,1,2,22,35,2,"1",0
26,22,1,25,50,60,25,"1",0
26,23,2,80,70,71,80,"-1",0
26,24,3,5,25,14,5,"1",0
26,25,3,0,50,14,0,"1",0
26,26,3,100,98,29,90,"-1",10
26,27,3,100,70,45,75,"-1",25
26,28,3,50,50,20,10,"-1",40
26,29,3,99,50,66,99,"-1",0
26,30,2,0,45,48,0,"1",0
26,31,2,0,10,19,0,"1",0
26,32,3,10,45,33,10,"1",0
26,33,3,30,50,15,30,"-1",0
26,34,2,5,25,80,30,"1",-25
26,35,1,50,35,17,40,"-1",10
26,36,2,0,25,26,0,"1",0
26,37,4,95,90,30,60,"-1",35
26,38,2,99,95,71,99,"-1",0
26,39,4,10,45,43,10,"1",0
26,40,4,100,85,21,100,"-1",0
26,41,2,50,55,17,25,"-1",25
26,42,3,99,75,13,50,"-1",49
26,43,4,30,45,81,45,"1",-15
26,44,3,0,35,19,1,"1",-1
26,45,4,50,45,19,50,"-1",0
26,46,4,100,75,45,100,"-1",0
26,47,3,10,30,20,5,"1",5
26,48,3,0,15,18,0,"1",0
26,49,3,5,43,11,5,"1",0
26,50,3,0,35,38,0,"1",0
26,51,3,1,25,26,5,"1",-4
27,1,3,50,50,26,50,"-1",0
27,2,5,0,10,20,0,"1",0
27,3,5,100,79,29,100,"-1",0
27,4,4,100,80,78,100,"-1",0
27,5,5,50,10,56,50,"1",0
27,6,4,40,30,29,40,"-1",0
27,7,4,0,30,45,0,"1",0
27,8,3,100,60,75,100,"-1",0
27,9,3,1,9,29,3,"1",-2
27,10,3,50,50,56,50,"1",0
27,11,4,10,10,31,10,"1",0
27,12,2,100,80,78,100,"-1",0
27,13,5,60,70,22,60,"-1",0
27,14,2,10,2,41,10,"1",0
27,15,2,100,50,60,100,"-1",0
27,16,2,1,2,26,5,"1",-4
27,17,1,0,10,43,0,"1",0
27,18,2,50,50,82,50,"1",0
27,19,1,0,5,21,0,"1",0
27,20,4,3,1,40,3,"1",0
27,21,2,20,20,35,20,"1",0
27,22,2,100,100,60,100,"-1",0
27,23,2,5,6,71,2,"1",3
27,24,2,5,5,14,9,"1",-4
27,25,5,50,20,14,50,"-1",0
27,26,4,100,50,29,100,"-1",0
27,27,2,0,5,45,0,"1",0
27,28,3,10,10,20,15,"1",-5
27,29,2,99,60,66,99,"-1",0
27,30,2,0,6,48,0,"1",0
27,31,3,20,30,19,20,"-1",0
27,32,4,100,10,33,0,"-1",100
27,33,3,100,50,15,100,"-1",0
27,34,2,50,50,80,50,"1",0
27,35,2,0,3,17,0,"1",0
27,36,2,70,50,26,30,"-1",40
27,37,5,30,33,30,30,"0",0
27,38,2,100,100,71,100,"-1",0
27,39,2,0,5,43,0,"1",0
27,40,4,0,50,21,0,"1",0
27,41,2,30,30,17,10,"-1",20
27,42,3,10,20,13,10,"1",0
27,43,4,50,50,81,70,"1",-20
27,44,3,0,30,19,0,"1",0
27,45,4,100,30,19,100,"-1",0
27,46,5,100,50,45,100,"-1",0
27,47,4,0,25,20,0,"1",0
27,48,4,100,50,18,100,"-1",0
27,49,2,0,1,11,0,"1",0
27,50,2,0,10,38,0,"1",0
27,51,2,0,10,26,0,"1",0
28,1,1,10,5,26,20,"1",-10
28,2,5,80,40,20,80,"-1",0
28,3,3,30,65,29,10,"-1",20
28,4,4,100,40,78,100,"-1",0
28,5,2,0,35,56,0,"1",0
28,6,4,50,35,29,50,"-1",0
28,7,3,10,55,45,5,"1",5
28,8,3,10,50,75,10,"1",0
28,9,4,15,35,29,15,"1",0
28,10,4,25,65,56,25,"1",0
28,11,4,20,30,31,20,"1",0
28,12,3,100,95,78,100,"-1",0
28,13,4,10,35,22,5,"1",5
28,14,2,5,10,41,10,"1",-5
28,15,2,40,80,60,30,"1",10
28,16,1,20,10,26,10,"1",10
28,17,2,20,80,43,10,"1",10
28,18,2,2,35,82,2,"1",0
28,19,1,0,15,21,0,"1",0
28,20,2,100,60,40,100,"-1",0
28,21,2,100,70,35,100,"-1",0
28,22,2,100,100,60,100,"-1",0
28,23,2,100,80,71,90,"-1",10
28,24,4,0,8,14,0,"1",0
28,25,4,30,40,14,30,"-1",0
28,26,4,100,90,29,100,"-1",0
28,27,3,100,80,45,100,"-1",0
28,28,3,35,35,20,20,"-1",15
28,29,2,30,70,66,30,"1",0
28,30,3,0,40,48,0,"1",0
28,31,2,100,60,19,100,"-1",0
28,32,4,100,60,33,100,"-1",0
28,33,2,0,5,15,0,"1",0
28,34,3,50,80,80,20,"1",30
28,35,1,0,20,17,0,"1",0
28,36,2,40,40,26,26,"-1",14
28,37,4,100,60,30,100,"-1",0
28,38,2,100,100,71,100,"-1",0
28,39,3,0,40,43,0,"1",0
28,40,4,60,85,21,10,"-1",50
28,41,3,50,15,17,50,"-1",0
28,42,3,100,90,13,100,"-1",0
28,43,4,10,80,81,10,"1",0
28,44,2,0,30,19,0,"1",0
28,45,3,70,70,19,19,"-1",51
28,46,3,20,50,45,20,"1",0
28,47,2,20,20,20,20,"0",0
28,48,3,70,15,18,70,"-1",0
28,49,3,0,20,11,0,"1",0
28,50,4,0,5,38,0,"1",0
28,51,2,10,20,26,10,"1",0
29,1,2,5,10,26,30,"1",-25
29,2,2,10,20,20,20,"1",-10
29,3,3,20,36,29,20,"1",0
29,4,4,0,85,78,0,"1",0
29,5,4,20,90,56,40,"1",-20
29,6,4,60,46,29,20,"-1",40
29,7,5,100,70,45,100,"-1",0
29,8,4,100,70,75,100,"-1",0
29,9,4,0,18,29,0,"1",0
29,10,5,70,46,56,60,"-1",10
29,11,4,5,27,31,5,"1",0
29,12,2,0,97,78,0,"1",0
29,13,3,0,12,22,0,"1",0
29,14,1,30,57,41,30,"1",0
29,15,2,80,40,60,60,"-1",20
29,16,1,73,73,26,40,"-1",33
29,17,2,60,40,43,60,"-1",0
29,18,1,100,97,82,70,"-1",30
29,19,1,90,70,21,90,"-1",0
29,20,2,100,75,40,100,"-1",0
29,21,2,80,70,35,40,"-1",40
29,22,2,100,85,60,80,"-1",20
29,23,2,20,90,71,20,"1",0
29,24,3,20,20,14,15,"-1",5
29,25,3,0,24,14,0,"1",0
29,26,5,100,65,29,100,"-1",0
29,27,2,40,65,45,100,"1",-60
29,28,3,50,37,20,20,"-1",30
29,29,2,99,97,66,100,"-1",-1
29,30,3,0,35,48,0,"1",0
29,31,2,100,50,19,0,"-1",100
29,32,5,100,20,33,100,"-1",0
29,33,2,100,16,15,100,"-1",0
29,34,3,30,50,80,70,"1",-40
29,35,1,20,45,17,20,"-1",0
29,36,3,95,95,26,15,"-1",80
29,37,4,90,79,30,50,"-1",40
29,38,2,30,97,71,50,"1",-20
29,39,2,0,45,43,0,"1",0
29,40,4,0,4,21,0,"1",0
29,41,3,100,40,17,100,"-1",0
29,42,3,100,45,13,100,"-1",0
29,43,3,0,6,81,15,"1",-15
29,44,4,35,34,19,45,"-1",-10
29,45,3,60,30,19,60,"-1",0
29,46,5,100,46,45,100,"-1",0
29,47,4,100,84,20,100,"-1",0
29,48,3,10,9,18,10,"1",0
29,49,2,0,40,11,0,"1",0
29,50,4,30,60,38,30,"1",0
29,51,2,40,45,26,25,"-1",15
30,1,4,20,20,26,25,"1",-5
30,2,5,10,10,20,10,"1",0
30,3,4,60,0,29,0,"-1",60
30,4,5,70,70,78,70,"1",0
30,5,3,20,10,56,20,"1",0
30,6,4,10,25,29,15,"1",-5
30,7,3,0,20,45,10,"1",-10
30,8,3,90,55,75,80,"-1",10
30,9,4,10,10,29,10,"1",0
30,10,4,30,45,56,30,"1",0
30,11,3,0,10,31,0,"1",0
30,12,2,70,70,78,70,"1",0
30,13,5,12,2,22,2,"1",10
30,14,2,50,10,41,10,"-1",40
30,15,2,60,60,60,60,"0",0
30,16,2,40,40,26,40,"-1",0
30,17,2,20,30,43,20,"1",0
30,18,1,70,30,82,80,"1",-10
30,19,2,80,18,21,80,"-1",0
30,20,2,0,20,40,0,"1",0
30,21,3,60,60,35,60,"-1",0
30,22,1,50,60,60,50,"1",0
30,23,2,90,70,71,90,"-1",0
30,24,3,2,2,14,10,"1",-8
30,25,4,30,15,14,30,"-1",0
30,26,3,80,80,29,80,"-1",0
30,27,2,50,50,45,50,"-1",0
30,28,3,40,50,20,20,"-1",20
30,29,2,99,80,66,99,"-1",0
30,30,3,0,47,48,0,"1",0
30,31,3,15,23,19,15,"1",0
30,32,4,10,40,33,10,"1",0
30,33,3,99,60,15,0,"-1",99
30,34,2,20,50,80,30,"1",-10
30,35,2,0,45,17,0,"1",0
30,36,2,50,80,26,50,"-1",0
30,37,4,30,50,30,30,"0",0
30,38,2,75,75,71,75,"-1",0
30,39,2,0,30,43,0,"1",0
30,40,4,10,45,21,10,"1",0
30,41,3,70,60,17,60,"-1",10
30,42,3,0,70,13,0,"1",0
30,43,4,10,50,81,10,"1",0
30,44,3,5,25,19,5,"1",0
30,45,3,10,40,19,10,"1",0
30,46,5,100,70,45,100,"-1",0
30,47,3,15,11,20,20,"1",-5
30,48,3,30,15,18,30,"-1",0
30,49,2,0,12,11,0,"1",0
30,50,3,2,40,38,2,"1",0
30,51,2,20,60,26,10,"1",10
31,1,4,50,50,26,40,"-1",10
31,2,5,70,50,20,60,"-1",10
31,3,5,10,30,29,20,"1",-10
31,4,5,100,100,78,100,"-1",0
31,5,4,0,30,56,10,"1",-10
31,6,4,0,30,29,0,"1",0
31,7,4,20,40,45,20,"1",0
31,8,5,90,60,75,90,"-1",0
31,9,5,30,50,29,30,"-1",0
31,10,5,50,60,56,50,"1",0
31,11,5,50,40,31,40,"-1",10
31,12,3,100,100,78,100,"-1",0
31,13,5,10,30,22,10,"1",0
31,14,3,20,40,41,20,"1",0
31,15,3,100,80,60,80,"-1",20
31,16,3,10,10,26,10,"1",0
31,17,2,50,70,43,30,"-1",20
31,18,2,10,10,82,10,"1",0
31,19,1,0,20,21,0,"1",0
31,20,2,100,40,40,100,"-1",0
31,21,2,10,30,35,30,"1",-20
31,22,1,20,40,60,30,"1",-10
31,23,3,60,90,71,50,"1",10
31,24,3,30,30,14,14,"-1",16
31,25,5,100,80,14,100,"-1",0
31,26,5,100,100,29,100,"-1",0
31,27,3,100,70,45,100,"-1",0
31,28,3,30,40,20,20,"-1",10
31,29,3,40,70,66,40,"1",0
31,30,5,60,50,48,60,"-1",0
31,31,2,40,40,19,15,"-1",25
31,32,3,50,30,33,50,"-1",0
31,33,3,100,100,15,60,"-1",40
31,34,3,90,100,80,70,"-1",20
31,35,1,0,10,17,0,"1",0
31,36,3,100,80,26,60,"-1",40
31,37,3,70,70,30,50,"-1",20
31,38,3,100,100,71,100,"-1",0
31,39,1,20,60,43,20,"1",0
31,40,5,80,50,21,80,"-1",0
31,41,4,10,70,17,10,"1",0
31,42,3,0,40,13,0,"1",0
31,43,4,0,0,81,20,"1",-20
31,44,3,30,50,19,19,"-1",11
31,45,4,100,80,19,60,"-1",40
31,46,4,50,50,45,50,"-1",0
31,47,3,40,40,20,30,"-1",10
31,48,2,10,10,18,5,"1",5
31,49,5,100,50,11,100,"-1",0
31,50,3,0,50,38,0,"1",0
31,51,3,50,50,26,50,"-1",0
32,1,1,80,20,26,80,"-1",0
32,2,5,30,70,20,15,"-1",15
32,3,3,25,15,29,15,"1",10
32,4,3,60,75,78,65,"1",-5
32,5,5,45,40,56,48,"1",-3
32,6,4,20,60,29,15,"1",5
32,7,5,60,40,45,60,"-1",0
32,8,4,75,75,75,75,"0",0
32,9,4,25,25,29,30,"1",-5
32,10,5,80,80,56,80,"-1",0
32,11,4,15,12,31,23,"1",-8
32,12,3,20,60,78,30,"1",-10
32,13,4,15,0,22,15,"1",0
32,14,2,60,30,41,61,"-1",-1
32,15,2,20,10,60,30,"1",-10
32,16,2,15,10,26,18,"1",-3
32,17,2,20,20,43,25,"1",-5
32,18,2,60,70,82,62,"1",-2
32,19,1,0,20,21,5,"1",-5
32,20,2,12,26,40,15,"1",-3
32,21,4,90,90,35,85,"-1",5
32,22,1,75,75,60,65,"-1",10
32,23,1,80,80,71,75,"-1",5
32,24,2,12,12,14,14,"1",-2
32,25,4,30,30,14,25,"-1",5
32,26,4,85,85,29,85,"-1",0
32,27,2,55,55,45,50,"-1",5
32,28,4,40,40,20,20,"-1",20
32,29,2,65,65,66,65,"1",0
32,30,2,0,15,48,0,"1",0
32,31,2,28,30,19,25,"-1",3
32,32,3,80,20,33,83,"-1",-3
32,33,4,80,70,15,70,"-1",10
32,34,2,10,10,80,30,"1",-20
32,35,2,5,25,17,4,"1",1
32,36,3,80,80,26,56,"-1",24
32,37,5,75,60,30,45,"-1",30
32,38,4,80,80,71,75,"-1",5
32,39,4,80,75,43,75,"-1",5
32,40,4,10,25,21,8,"1",2
32,41,4,80,75,17,75,"-1",5
32,42,4,80,65,13,50,"-1",30
32,43,4,15,25,81,30,"1",-15
32,44,4,15,35,19,12,"1",3
32,45,4,20,40,19,15,"-1",5
32,46,4,95,65,45,95,"-1",0
32,47,3,5,25,20,5,"1",0
32,48,2,20,30,18,16,"-1",4
32,49,2,2,20,11,2,"1",0
32,50,4,15,20,38,20,"1",-5
32,51,3,15,15,26,22,"1",-7
33,1,5,1,1,26,5,"1",-4
33,2,5,10,40,20,5,"1",5
33,3,5,70,0,29,0,"-1",70
33,4,5,99,90,78,99,"-1",0
33,5,4,90,30,56,90,"-1",0
33,6,4,10,10,29,35,"1",-25
33,7,5,99,55,45,99,"-1",0
33,8,3,99,80,75,99,"-1",0
33,9,5,95,65,29,95,"-1",0
33,10,4,80,80,56,80,"-1",0
33,11,5,2,15,31,2,"1",0
33,12,3,99,90,78,99,"-1",0
33,13,5,30,0,22,0,"-1",30
33,14,2,5,10,41,5,"1",0
33,15,3,90,85,60,90,"-1",0
33,16,3,15,5,26,10,"1",5
33,17,2,70,70,43,50,"-1",20
33,18,1,5,60,82,5,"1",0
33,19,1,0,40,21,0,"1",0
33,20,1,1,5,40,1,"1",0
33,21,3,20,20,35,35,"1",-15
33,22,2,50,50,60,60,"1",-10
33,23,2,90,90,71,90,"-1",0
33,24,3,20,20,14,14,"-1",6
33,25,3,50,40,14,50,"-1",0
33,26,3,99,80,29,99,"-1",0
33,27,1,10,65,45,10,"1",0
33,28,3,30,30,20,20,"-1",10
33,29,2,95,95,66,95,"-1",0
33,30,3,50,30,48,50,"-1",0
33,31,2,10,30,19,10,"1",0
33,32,4,99,10,33,99,"-1",0
33,33,3,5,5,15,5,"1",0
33,34,1,70,70,80,80,"1",-10
33,35,2,95,20,17,95,"-1",0
33,36,2,35,35,26,26,"-1",9
33,37,3,10,10,30,10,"1",0
33,38,2,95,90,71,95,"-1",0
33,39,1,1,70,43,1,"1",0
33,40,4,1,15,21,1,"1",0
33,41,3,1,80,17,1,"1",0
33,42,3,100,45,13,100,"-1",0
33,43,3,20,50,81,20,"1",0
33,44,3,0,35,19,1,"1",-1
33,45,3,10,5,19,10,"1",0
33,46,2,5,40,45,5,"1",0
33,47,3,100,55,20,100,"-1",0
33,48,3,100,5,18,100,"-1",0
33,49,3,100,20,11,100,"-1",0
33,50,3,1,35,38,1,"1",0
33,51,3,1,50,26,1,"1",0
34,1,1,5,7,26,22,"1",-17
34,2,5,1,11,20,5,"1",-4
34,3,4,55,10,29,10,"-1",45
34,4,4,100,77,78,100,"-1",0
34,5,4,75,75,56,75,"-1",0
34,6,5,23,33,29,23,"1",0
34,7,4,85,75,45,85,"-1",0
34,8,4,60,60,75,75,"1",-15
34,9,4,77,55,29,77,"-1",0
34,10,5,89,73,56,89,"-1",0
34,11,5,10,25,31,10,"1",0
34,12,2,88,88,78,88,"-1",0
34,13,4,44,33,22,11,"-1",33
34,14,2,60,50,41,50,"-1",10
34,15,2,95,82,60,92,"-1",3
34,16,2,8,10,26,26,"1",-18
34,17,1,55,78,43,55,"-1",0
34,18,1,100,66,82,100,"-1",0
34,19,2,90,65,21,90,"-1",0
34,20,3,80,45,40,80,"-1",0
34,21,1,45,45,35,45,"-1",0
34,22,1,88,88,60,60,"-1",28
34,23,1,90,90,71,71,"-1",19
34,24,3,8,8,14,14,"1",-6
34,25,3,0,17,14,0,"1",0
34,26,5,100,90,29,100,"-1",0
34,27,2,55,22,45,55,"-1",0
34,28,3,66,66,20,20,"-1",46
34,29,2,55,55,66,66,"1",-11
34,30,3,0,10,48,0,"1",0
34,31,2,22,44,19,10,"-1",12
34,32,4,11,33,33,11,"1",0
34,33,3,0,19,15,0,"1",0
34,34,1,66,66,80,80,"1",-14
34,35,2,82,82,17,25,"-1",57
34,36,2,45,45,26,26,"-1",19
34,37,4,89,89,30,30,"-1",59
34,38,1,82,82,71,82,"-1",0
34,39,3,35,55,43,35,"1",0
34,40,4,90,76,21,80,"-1",10
34,41,2,15,15,17,15,"1",0
34,42,3,35,35,13,10,"-1",25
34,43,2,88,77,81,88,"-1",0
34,44,3,22,22,19,19,"-1",3
34,45,5,55,55,19,55,"-1",0
34,46,5,80,80,45,70,"-1",10
34,47,3,20,30,20,20,"0",0
34,48,4,20,20,18,20,"-1",0
34,49,3,0,35,11,0,"1",0
34,50,2,11,22,38,11,"1",0
34,51,3,50,50,26,50,"-1",0
35,1,2,5,5,26,26,"1",-21
35,2,5,8,16,20,20,"1",-12
35,3,2,15,0,29,0,"1",15
35,4,4,100,65,78,100,"-1",0
35,5,4,15,60,56,15,"1",0
35,6,4,40,40,29,29,"-1",11
35,7,4,0,53,45,0,"1",0
35,8,2,0,90,75,0,"1",0
35,9,4,1,5,29,1,"1",0
35,10,3,80,80,56,80,"-1",0
35,11,4,20,10,31,31,"1",-11
35,12,3,0,45,78,0,"1",0
35,13,3,12,0,22,0,"1",12
35,14,2,32,25,41,25,"1",7
35,15,1,10,35,60,10,"1",0
35,16,2,12,0,26,0,"1",12
35,17,1,0,8,43,10,"1",-10
35,18,1,80,30,82,80,"1",0
35,19,1,0,15,21,0,"1",0
35,20,2,5,15,40,20,"1",-15
35,21,1,95,95,35,95,"-1",0
35,22,2,40,80,60,40,"1",0
35,23,2,54,54,71,54,"1",0
35,24,3,32,32,14,14,"-1",18
35,25,4,5,15,14,5,"1",0
35,26,3,70,75,29,70,"-1",0
35,27,2,0,6,45,0,"1",0
35,28,3,45,45,20,20,"-1",25
35,29,3,85,85,66,85,"-1",0
35,30,3,0,15,48,0,"1",0
35,31,1,100,78,19,0,"-1",100
35,32,4,100,15,33,100,"-1",0
35,33,3,100,32,15,100,"-1",0
35,34,3,0,5,80,5,"1",-5
35,35,2,0,10,17,0,"1",0
35,36,3,0,60,26,26,"1",-26
35,37,4,32,65,30,30,"-1",2
35,38,2,80,80,71,80,"-1",0
35,39,3,65,60,43,65,"-1",0
35,40,5,0,63,21,0,"1",0
35,41,1,0,65,17,0,"1",0
35,42,3,0,25,13,0,"1",0
35,43,3,0,20,81,0,"1",0
35,44,3,0,4,19,0,"1",0
35,45,3,0,21,19,0,"1",0
35,46,5,100,65,45,100,"-1",0
35,47,3,0,40,20,0,"1",0
35,48,3,0,24,18,0,"1",0
35,49,3,0,8,11,0,"1",0
35,50,3,0,5,38,0,"1",0
35,51,3,0,54,26,0,"1",0
36,1,4,30,14,26,20,"-1",10
36,2,5,10,15,20,15,"1",-5
36,3,3,0,38,29,0,"1",0
36,4,2,100,50,78,100,"-1",0
36,5,5,0,25,56,0,"1",0
36,6,3,95,20,29,95,"-1",0
36,7,3,0,25,45,10,"1",-10
36,8,3,100,85,75,100,"-1",0
36,9,4,12,20,29,12,"1",0
36,10,3,80,35,56,80,"-1",0
36,11,5,40,22,31,40,"-1",0
36,12,3,100,80,78,100,"-1",0
36,13,3,0,17,22,0,"1",0
36,14,2,5,19,41,5,"1",0
36,15,1,78,80,60,78,"-1",0
36,16,2,62,37,26,45,"-1",17
36,17,1,10,15,43,25,"1",-15
36,18,2,90,33,82,95,"-1",-5
36,19,2,2,40,21,5,"1",-3
36,20,2,50,38,40,45,"-1",5
36,21,2,100,50,35,100,"-1",0
36,22,2,100,65,60,100,"-1",0
36,23,2,8,67,71,5,"1",3
36,24,3,3,3,14,10,"1",-7
36,25,4,70,13,14,70,"-1",0
36,26,3,100,70,29,100,"-1",0
36,27,2,80,90,45,60,"-1",20
36,28,3,19,19,20,20,"1",-1
36,29,2,99,60,66,99,"-1",0
36,30,3,100,40,48,100,"-1",0
36,31,3,100,70,19,60,"-1",40
36,32,3,10,10,33,10,"1",0
36,33,3,0,48,15,12,"1",-12
36,34,2,14,8,80,15,"1",-1
36,35,1,0,45,17,0,"1",0
36,36,4,95,65,26,70,"-1",25
36,37,3,90,40,30,90,"-1",0
36,38,2,100,80,71,100,"-1",0
36,39,3,0,68,43,0,"1",0
36,40,3,0,15,21,0,"1",0
36,41,3,100,70,17,100,"-1",0
36,42,3,99,37,13,99,"-1",0
36,43,3,0,13,81,15,"1",-15
36,44,3,20,20,19,19,"-1",1
36,45,3,95,50,19,95,"-1",0
36,46,5,99,70,45,99,"-1",0
36,47,3,10,20,20,15,"1",-5
36,48,3,100,30,18,100,"-1",0
36,49,3,60,20,11,25,"-1",35
36,50,2,0,33,38,0,"1",0
36,51,3,1,12,26,1,"1",0
37,1,4,20,20,26,26,"1",-6
37,2,5,25,25,20,20,"-1",5
37,3,4,60,60,29,30,"-1",30
37,4,4,10,45,78,10,"1",0
37,5,3,40,40,56,56,"1",-16
37,6,4,25,25,29,29,"1",-4
37,7,4,75,40,45,75,"-1",0
37,8,3,75,75,75,75,"0",0
37,9,4,30,40,29,30,"-1",0
37,10,4,80,75,56,60,"-1",20
37,11,5,4,8,31,15,"1",-11
37,12,3,70,70,78,78,"1",-8
37,13,5,20,10,22,15,"1",5
37,14,2,40,60,41,40,"1",0
37,15,1,60,60,60,60,"0",0
37,16,2,15,15,26,26,"1",-11
37,17,2,15,15,43,25,"1",-10
37,18,2,70,70,82,82,"1",-12
37,19,2,95,75,21,90,"-1",5
37,20,3,15,15,40,30,"1",-15
37,21,2,75,75,35,60,"-1",15
37,22,2,80,85,60,60,"-1",20
37,23,2,95,95,71,95,"-1",0
37,24,3,5,5,14,14,"1",-9
37,25,4,20,20,14,14,"-1",6
37,26,4,95,95,29,95,"-1",0
37,27,3,80,75,45,60,"-1",20
37,28,3,10,10,20,20,"1",-10
37,29,2,70,70,66,66,"-1",4
37,30,4,25,35,48,45,"1",-20
37,31,2,25,25,19,19,"-1",6
37,32,4,80,60,33,60,"-1",20
37,33,3,70,70,15,15,"-1",55
37,34,3,40,40,80,80,"1",-40
37,35,3,15,20,17,17,"1",-2
37,36,2,70,70,26,26,"-1",44
37,37,4,40,40,30,30,"-1",10
37,38,3,95,95,71,90,"-1",5
37,39,3,30,50,43,40,"1",-10
37,40,3,90,90,21,45,"-1",45
37,41,3,40,40,17,17,"-1",23
37,42,3,75,75,13,45,"-1",30
37,43,3,25,25,81,75,"1",-50
37,44,3,8,8,19,19,"1",-11
37,45,4,60,60,19,25,"-1",35
37,46,5,100,70,45,100,"-1",0
37,47,3,15,15,20,20,"1",-5
37,48,2,15,15,18,15,"1",0
37,49,5,5,10,11,10,"1",-5
37,50,3,30,40,38,35,"1",-5
37,51,3,25,25,26,26,"1",-1
38,1,5,10,20,26,10,"1",0
38,2,5,5,20,20,5,"1",0
38,3,4,10,20,29,10,"1",0
38,4,2,10,60,78,10,"1",0
38,5,5,95,80,56,80,"-1",15
38,6,3,95,90,29,90,"-1",5
38,7,4,99,50,45,99,"-1",0
38,8,4,75,80,75,75,"0",0
38,9,3,10,10,29,10,"1",0
38,10,3,20,40,56,20,"1",0
38,11,4,80,60,31,80,"-1",0
38,12,1,0,60,78,0,"1",0
38,13,5,2,10,22,2,"1",0
38,14,2,10,20,41,10,"1",0
38,15,2,40,40,60,40,"1",0
38,16,3,25,40,26,15,"1",10
38,17,1,20,40,43,20,"1",0
38,18,2,60,70,82,60,"1",0
38,19,2,70,40,21,40,"-1",30
38,20,3,20,70,40,20,"1",0
38,21,2,40,40,35,35,"-1",5
38,22,3,100,100,60,100,"-1",0
38,23,2,80,90,71,60,"-1",20
38,24,3,10,10,14,14,"1",-4
38,25,3,70,70,14,30,"-1",40
38,26,3,70,90,29,70,"-1",0
38,27,3,100,98,45,98,"-1",2
38,28,3,20,20,20,20,"0",0
38,29,2,80,80,66,66,"-1",14
38,30,3,0,6,48,0,"1",0
38,31,4,5,25,19,5,"1",0
38,32,3,50,20,33,50,"-1",0
38,33,3,1,10,15,1,"1",0
38,34,3,5,10,80,5,"1",0
38,35,2,10,20,17,10,"1",0
38,36,2,90,90,26,26,"-1",64
38,37,4,40,40,30,40,"-1",0
38,38,3,90,80,71,90,"-1",0
38,39,3,0,40,43,0,"1",0
38,40,3,80,80,21,21,"-1",59
38,41,3,20,30,17,8,"-1",12
38,42,3,5,30,13,5,"1",0
38,43,3,5,30,81,15,"1",-10
38,44,3,30,30,19,19,"-1",11
38,45,4,70,60,19,70,"-1",0
38,46,5,95,80,45,90,"-1",5
38,47,5,20,30,20,30,"0",-10
38,48,4,20,10,18,20,"-1",0
38,49,3,0,5,11,0,"1",0
38,50,4,5,20,38,5,"1",0
38,51,3,80,30,26,80,"-1",0
39,1,4,10,10,26,0,"1",10
39,2,5,0,20,20,0,"1",0
39,3,4,10,45,29,10,"1",0
39,4,3,100,100,78,100,"-1",0
39,5,4,100,75,56,70,"-1",30
39,6,4,80,20,29,80,"-1",0
39,7,4,70,50,45,45,"-1",25
39,8,2,100,90,75,100,"-1",0
39,9,4,10,10,29,15,"1",-5
39,10,4,80,25,56,30,"-1",50
39,11,4,50,50,31,50,"-1",0
39,12,3,0,25,78,0,"1",0
39,13,4,0,30,22,10,"1",-10
39,14,2,10,40,41,10,"1",0
39,15,2,75,50,60,60,"-1",15
39,16,2,30,30,26,30,"-1",0
39,17,2,10,33,43,20,"1",-10
39,18,2,50,40,82,40,"1",10
39,19,2,0,30,21,0,"1",0
39,20,2,0,20,40,0,"1",0
39,21,1,50,50,35,50,"-1",0
39,22,2,100,100,60,60,"-1",40
39,23,2,100,70,71,100,"-1",0
39,24,2,40,20,14,14,"-1",26
39,25,4,100,10,14,100,"-1",0
39,26,3,100,80,29,100,"-1",0
39,27,2,100,100,45,100,"-1",0
39,28,3,12,12,20,20,"1",-8
39,29,2,99,70,66,99,"-1",0
39,30,4,100,50,48,100,"-1",0
39,31,3,0,50,19,10,"1",-10
39,32,4,100,50,33,100,"-1",0
39,33,3,90,70,15,20,"-1",70
39,34,3,15,15,80,80,"1",-65
39,35,2,0,70,17,0,"1",0
39,36,3,80,80,26,26,"-1",54
39,37,4,50,30,30,30,"-1",20
39,38,2,100,100,71,71,"-1",29
39,39,3,10,40,43,15,"1",-5
39,40,4,0,50,21,0,"1",0
39,41,3,100,90,17,100,"-1",0
39,42,3,0,10,13,10,"1",-10
39,43,2,0,30,81,0,"1",0
39,44,3,20,20,19,19,"-1",1
39,45,4,100,40,19,100,"-1",0
39,46,5,100,75,45,100,"-1",0
39,47,5,30,30,20,20,"-1",10
39,48,2,10,80,18,10,"1",0
39,49,3,0,30,11,0,"1",0
39,50,3,0,40,38,0,"1",0
39,51,2,10,10,26,10,"1",0
40,1,4,16,16,26,26,"1",-10
40,2,5,0,35,20,0,"1",0
40,3,5,86,100,29,100,"-1",-14
40,4,3,100,97,78,100,"-1",0
40,5,4,40,45,56,45,"1",-5
40,6,2,17,17,29,29,"1",-12
40,7,4,95,95,45,95,"-1",0
40,8,3,100,73,75,100,"-1",0
40,9,3,36,36,29,29,"-1",7
40,10,4,86,86,56,56,"-1",30
40,11,5,30,30,31,31,"1",-1
40,12,2,100,98,78,100,"-1",0
40,13,5,32,15,22,10,"-1",22
40,14,2,26,37,41,37,"1",-11
40,15,3,87,87,60,60,"-1",27
40,16,3,32,75,26,62,"-1",-30
40,17,2,60,60,43,60,"-1",0
40,18,2,84,84,82,82,"-1",2
40,19,2,65,45,21,30,"-1",35
40,20,3,75,60,40,60,"-1",15
40,21,3,100,96,35,100,"-1",0
40,22,2,98,98,60,60,"-1",38
40,23,2,50,67,71,55,"1",-5
40,24,3,49,49,14,14,"-1",35
40,25,3,5,32,14,5,"1",0
40,26,3,100,97,29,100,"-1",0
40,27,3,2,23,45,3,"1",-1
40,28,3,67,67,20,20,"-1",47
40,29,3,87,87,66,66,"-1",21
40,30,3,0,48,48,0,"1",0
40,31,1,100,75,19,0,"-1",100
40,32,4,85,34,33,85,"-1",0
40,33,3,43,52,15,12,"-1",31
40,34,3,20,20,80,20,"1",0
40,35,2,5,23,17,5,"1",0
40,36,3,92,92,26,26,"-1",66
40,37,4,85,85,30,30,"-1",55
40,38,3,100,95,71,95,"-1",5
40,39,2,0,89,43,0,"1",0
40,40,3,0,67,21,0,"1",0
40,41,3,100,85,17,100,"-1",0
40,42,3,100,79,13,100,"-1",0
40,43,3,56,68,81,56,"1",0
40,44,3,70,15,19,70,"-1",0
40,45,4,80,76,19,80,"-1",0
40,46,5,100,69,45,100,"-1",0
40,47,3,61,61,20,20,"-1",41
40,48,2,100,60,18,100,"-1",0
40,49,2,0,28,11,0,"1",0
40,50,3,43,76,38,25,"-1",18
40,51,3,45,45,26,26,"-1",19
41,1,5,5,10,26,8,"1",-3
41,2,5,60,20,20,35,"-1",25
41,3,2,12,5,29,5,"1",7
41,4,2,95,85,78,85,"-1",10
41,5,4,30,40,56,50,"1",-20
41,6,4,35,35,29,30,"-1",5
41,7,4,2,21,45,2,"1",0
41,8,2,95,75,75,90,"-1",5
41,9,4,80,60,29,45,"-1",35
41,10,5,10,35,56,8,"1",2
41,11,4,2,8,31,3,"1",-1
41,12,2,100,90,78,100,"-1",0
41,13,5,25,5,22,5,"-1",20
41,14,2,30,50,41,40,"1",-10
41,15,2,90,60,60,85,"-1",5
41,16,2,30,50,26,30,"-1",0
41,17,1,10,40,43,12,"1",-2
41,18,1,12,28,82,12,"1",0
41,19,1,56,34,21,40,"-1",16
41,20,1,1,12,40,2,"1",-1
41,21,1,45,30,35,39,"-1",6
41,22,1,80,60,60,75,"-1",5
41,23,2,100,80,71,80,"-1",20
41,24,3,4,4,14,10,"1",-6
41,25,3,3,18,14,6,"1",-3
41,26,4,100,95,29,80,"-1",20
41,27,2,20,30,45,30,"1",-10
41,28,3,19,19,20,20,"1",-1
41,29,2,80,80,66,72,"-1",8
41,30,2,5,15,48,5,"1",0
41,31,2,40,60,19,25,"-1",15
41,32,5,80,40,33,30,"-1",50
41,33,2,2,5,15,8,"1",-6
41,34,2,5,10,80,50,"1",-45
41,35,2,2,28,17,2,"1",0
41,36,2,60,40,26,26,"-1",34
41,37,4,65,65,30,35,"-1",30
41,38,1,100,100,71,90,"-1",10
41,39,2,65,35,43,85,"-1",-20
41,40,4,95,95,21,85,"-1",10
41,41,3,80,50,17,60,"-1",20
41,42,3,85,65,13,40,"-1",45
41,43,4,5,10,81,50,"1",-45
41,44,3,30,30,19,20,"-1",10
41,45,5,100,10,19,100,"-1",0
41,46,5,100,75,45,100,"-1",0
41,47,3,40,32,20,30,"-1",10
41,48,2,60,30,18,30,"-1",30
41,49,4,0,5,11,0,"1",0
41,50,3,2,40,38,2,"1",0
41,51,3,40,40,26,20,"-1",20
42,1,5,85,60,26,70,"-1",15
42,2,5,99,31,20,99,"-1",0
42,3,4,18,5,29,18,"1",0
42,4,5,100,100,78,100,"-1",0
42,5,4,100,80,56,56,"-1",44
42,6,4,50,15,29,50,"-1",0
42,7,4,50,80,45,50,"-1",0
42,8,2,100,100,75,100,"-1",0
42,9,4,40,15,29,40,"-1",0
42,10,2,50,45,56,56,"1",-6
42,11,4,10,26,31,10,"1",0
42,12,5,100,85,78,78,"-1",22
42,13,5,12,100,22,100,"1",-88
42,14,1,2,28,41,2,"1",0
42,15,1,50,50,60,50,"1",0
42,16,1,41,0,26,0,"-1",41
42,17,2,15,29,43,15,"1",0
42,18,1,5,23,82,5,"1",0
42,19,1,15,42,21,15,"1",0
42,20,1,0,31,40,0,"1",0
42,21,1,50,30,35,35,"-1",15
42,22,1,67,67,60,60,"-1",7
42,23,1,70,45,71,71,"1",-1
42,24,3,16,16,14,14,"-1",2
42,25,3,17,17,14,14,"-1",3
42,26,4,100,70,29,100,"-1",0
42,27,2,5,40,45,5,"1",0
42,28,3,16,16,20,20,"1",-4
42,29,1,60,40,66,66,"1",-6
42,30,4,2,28,48,2,"1",0
42,31,1,100,10,19,100,"-1",0
42,32,5,0,37,33,0,"1",0
42,33,5,100,20,15,100,"-1",0
42,34,2,65,75,80,80,"1",-15
42,35,1,8,32,17,8,"1",0
42,36,2,80,80,26,26,"-1",54
42,37,4,60,60,30,30,"-1",30
42,38,1,100,95,71,95,"-1",5
42,39,3,30,50,43,43,"1",-13
42,40,5,100,70,21,100,"-1",0
42,41,3,0,82,17,0,"1",0
42,42,5,100,82,13,100,"-1",0
42,43,3,0,27,81,0,"1",0
42,44,3,60,60,19,19,"-1",41
42,45,4,50,17,19,19,"-1",31
42,46,5,100,45,45,100,"-1",0
42,47,3,0,26,20,0,"1",0
42,48,2,100,15,18,100,"-1",0
42,49,3,0,17,11,0,"1",0
42,50,5,100,33,38,100,"-1",0
42,51,3,100,30,26,100,"-1",0
43,1,1,15,15,26,26,"1",-11
43,2,4,60,55,20,60,"-1",0
43,3,1,50,0,29,0,"-1",50
43,4,5,100,95,78,100,"-1",0
43,5,5,80,80,56,80,"-1",0
43,6,4,88,88,29,29,"-1",59
43,7,5,99,25,45,99,"-1",0
43,8,5,100,90,75,100,"-1",0
43,9,4,50,50,29,29,"-1",21
43,10,4,50,35,56,46,"1",4
43,11,5,80,70,31,80,"-1",0
43,12,3,30,30,78,78,"1",-48
43,13,1,20,0,22,0,"1",20
43,14,3,60,50,41,60,"-1",0
43,15,4,55,40,60,60,"1",-5
43,16,4,25,50,26,50,"1",-25
43,17,2,50,50,43,43,"-1",7
43,18,1,10,33,82,10,"1",0
43,19,2,5,33,21,10,"1",-5
43,20,1,0,20,40,0,"1",0
43,21,5,75,55,35,75,"-1",0
43,22,3,100,100,60,60,"-1",40
43,23,1,50,50,71,71,"1",-21
43,24,3,25,25,14,14,"-1",11
43,25,5,100,40,14,100,"-1",0
43,26,5,100,85,29,100,"-1",0
43,27,1,0,85,45,0,"1",0
43,28,3,15,15,20,20,"1",-5
43,29,5,95,95,66,66,"-1",29
43,30,5,100,15,48,100,"-1",0
43,31,4,20,90,19,19,"-1",1
43,32,5,100,50,33,100,"-1",0
43,33,4,99,33,15,99,"-1",0
43,34,2,30,30,80,80,"1",-50
43,35,1,20,30,17,10,"-1",10
43,36,3,20,50,26,26,"1",-6
43,37,3,80,60,30,30,"-1",50
43,38,1,95,95,71,71,"-1",24
43,39,4,90,80,43,90,"-1",0
43,40,5,100,60,21,100,"-1",0
43,41,1,25,65,17,17,"-1",8
43,42,3,10,50,13,13,"1",-3
43,43,4,90,70,81,90,"-1",0
43,44,3,35,35,19,19,"-1",16
43,45,5,100,40,19,100,"-1",0
43,46,5,100,60,45,100,"-1",0
43,47,3,0,40,20,0,"1",0
43,48,3,100,50,18,100,"-1",0
43,49,3,0,25,11,0,"1",0
43,50,2,0,30,38,0,"1",0
43,51,3,0,50,26,0,"1",0
44,1,5,25,25,26,25,"1",0
44,2,5,8,12,20,10,"1",-2
44,3,4,25,0,29,0,"1",25
44,4,4,95,76,78,95,"-1",0
44,5,5,50,45,56,50,"1",0
44,6,5,15,12,29,20,"1",-5
44,7,4,10,35,45,10,"1",0
44,8,4,95,75,75,95,"-1",0
44,9,5,50,36,29,50,"-1",0
44,10,4,85,80,56,80,"-1",5
44,11,4,45,48,31,35,"-1",10
44,12,2,95,85,78,80,"-1",15
44,13,4,20,0,22,0,"1",20
44,14,2,15,22,41,20,"1",-5
44,15,1,45,55,60,50,"1",-5
44,16,3,50,40,26,30,"-1",20
44,17,1,5,21,43,20,"1",-15
44,18,2,50,47,82,55,"1",-5
44,19,1,20,37,21,20,"1",0
44,20,2,40,37,40,35,"0",5
44,21,1,5,30,35,5,"1",0
44,22,1,35,45,60,50,"1",-15
44,23,1,32,67,71,32,"1",0
44,24,3,14,17,14,14,"0",0
44,25,4,45,31,14,25,"-1",20
44,26,4,95,65,29,95,"-1",0
44,27,2,5,8,45,25,"1",-20
44,28,3,40,40,20,20,"-1",20
44,29,1,80,80,66,66,"-1",14
44,30,2,0,38,48,0,"1",0
44,31,2,78,61,19,35,"-1",43
44,32,4,25,25,33,33,"1",-8
44,33,3,65,67,15,15,"-1",50
44,34,3,60,72,80,70,"1",-10
44,35,3,20,18,17,16,"-1",4
44,36,2,40,30,26,30,"-1",10
44,37,4,10,20,30,20,"1",-10
44,38,2,80,80,71,71,"-1",9
44,39,3,45,47,43,45,"-1",0
44,40,3,50,40,21,25,"-1",25
44,41,2,85,65,17,45,"-1",40
44,42,3,15,19,13,13,"-1",2
44,43,3,40,40,81,80,"1",-40
44,44,3,12,16,19,15,"1",-3
44,45,5,35,23,19,25,"-1",10
44,46,4,50,45,45,45,"-1",5
44,47,3,30,60,20,20,"-1",10
44,48,2,25,15,18,20,"-1",5
44,49,3,0,39,11,0,"1",0
44,50,3,0,10,38,0,"1",0
44,51,2,0,35,26,0,"1",0
45,1,4,40,35,26,35,"-1",5
45,2,4,30,15,20,30,"-1",0
45,3,4,30,52,29,30,"-1",0
45,4,3,70,62,78,70,"1",0
45,5,4,30,57,56,45,"1",-15
45,6,4,10,28,29,15,"1",-5
45,7,4,20,40,45,35,"1",-15
45,8,4,40,54,75,59,"1",-19
45,9,4,40,30,29,35,"-1",5
45,10,3,70,61,56,65,"-1",5
45,11,5,45,38,31,40,"-1",5
45,12,2,20,70,78,25,"1",-5
45,13,4,20,43,22,19,"1",1
45,14,2,45,67,41,32,"-1",13
45,15,3,45,37,60,50,"1",-5
45,16,3,26,42,26,21,"0",5
45,17,2,30,46,43,30,"1",0
45,18,2,60,57,82,85,"1",-25
45,19,2,25,45,21,25,"-1",0
45,20,3,90,60,40,90,"-1",0
45,21,3,80,60,35,50,"-1",30
45,22,1,45,67,60,42,"1",3
45,23,2,10,70,71,30,"1",-20
45,24,3,10,13,14,12,"1",-2
45,25,4,60,27,14,40,"-1",20
45,26,3,90,80,29,50,"-1",40
45,27,2,35,46,45,39,"1",-4
45,28,3,60,65,20,20,"-1",40
45,29,2,34,45,66,50,"1",-16
45,30,4,30,24,48,48,"1",-18
45,31,2,20,30,19,20,"-1",0
45,32,4,20,43,33,17,"1",3
45,33,3,20,30,15,10,"-1",10
45,34,3,50,67,80,67,"1",-17
45,35,2,10,13,17,10,"1",0
45,36,2,67,70,26,45,"-1",22
45,37,4,70,70,30,45,"-1",25
45,38,2,50,70,71,65,"1",-15
45,39,3,10,45,43,15,"1",-5
45,40,4,21,52,21,10,"0",11
45,41,3,70,60,17,40,"-1",30
45,42,3,10,78,13,2,"1",8
45,43,4,20,12,81,56,"1",-36
45,44,3,20,43,19,20,"-1",0
45,45,4,90,72,19,40,"-1",50
45,46,5,90,70,45,70,"-1",20
45,47,3,10,24,20,10,"1",0
45,48,3,10,20,18,10,"1",0
45,49,3,5,30,11,2,"1",3
45,50,3,10,57,38,15,"1",-5
45,51,3,20,42,26,20,"1",0
46,1,4,5,5,26,26,"1",-21
46,2,5,60,60,20,40,"-1",20
46,3,2,10,20,29,10,"1",0
46,4,4,50,75,78,50,"1",0
46,5,4,20,35,56,10,"1",10
46,6,5,80,80,29,49,"-1",31
46,7,4,90,75,45,90,"-1",0
46,8,4,90,80,75,80,"-1",10
46,9,4,25,35,29,25,"1",0
46,10,4,80,80,56,80,"-1",0
46,11,4,10,10,31,20,"1",-10
46,12,3,25,50,78,25,"1",0
46,13,4,10,15,22,22,"1",-12
46,14,2,30,60,41,30,"1",0
46,15,2,40,35,60,40,"1",0
46,16,2,20,20,26,26,"1",-6
46,17,2,75,60,43,50,"-1",25
46,18,2,60,60,82,82,"1",-22
46,19,2,25,20,21,25,"-1",0
46,20,2,5,18,40,5,"1",0
46,21,2,75,65,35,55,"-1",20
46,22,1,90,90,60,90,"-1",0
46,23,2,80,65,71,80,"-1",0
46,24,3,5,5,14,14,"1",-9
46,25,3,5,15,14,5,"1",0
46,26,4,100,85,29,100,"-1",0
46,27,2,35,35,45,45,"1",-10
46,28,3,25,25,20,20,"-1",5
46,29,2,95,90,66,80,"-1",15
46,30,3,2,5,48,5,"1",-3
46,31,2,40,40,19,40,"-1",0
46,32,4,50,60,33,40,"-1",10
46,33,4,25,25,15,15,"-1",10
46,34,2,80,60,80,80,"0",0
46,35,2,10,10,17,10,"1",0
46,36,3,70,70,26,26,"-1",44
46,37,4,70,70,30,30,"-1",40
46,38,2,90,80,71,75,"-1",15
46,39,3,20,15,43,40,"1",-20
46,40,4,10,20,21,20,"1",-10
46,41,2,20,25,17,17,"-1",3
46,42,3,10,25,13,10,"1",0
46,43,4,0,10,81,0,"1",0
46,44,3,25,25,19,19,"-1",6
46,45,4,40,20,19,19,"-1",21
46,46,5,100,80,45,100,"-1",0
46,47,3,40,40,20,20,"-1",20
46,48,2,20,20,18,18,"-1",2
46,49,4,20,25,11,11,"-1",9
46,50,3,0,15,38,0,"1",0
46,51,3,0,5,26,0,"1",0
47,1,1,10,10,26,10,"1",0
47,2,5,5,5,20,5,"1",0
47,3,4,3,20,29,3,"1",0
47,4,4,75,85,78,75,"1",0
47,5,5,50,50,56,50,"1",0
47,6,4,80,75,29,80,"-1",0
47,7,4,3,15,45,3,"1",0
47,8,3,100,90,75,95,"-1",5
47,9,4,99,30,29,99,"-1",0
47,10,3,70,70,56,70,"-1",0
47,11,4,15,8,31,15,"1",0
47,12,3,0,75,78,0,"1",0
47,13,4,0,18,22,0,"1",0
47,14,2,5,5,41,5,"1",0
47,15,2,20,20,60,20,"1",0
47,16,3,5,5,26,5,"1",0
47,17,2,5,8,43,5,"1",0
47,18,2,15,20,82,15,"1",0
47,19,2,75,30,21,75,"-1",0
47,20,3,20,20,40,20,"1",0
47,21,3,80,65,35,80,"-1",0
47,22,2,25,25,60,25,"1",0
47,23,2,30,65,71,45,"1",-15
47,24,3,5,5,14,5,"1",0
47,25,3,10,13,14,10,"1",0
47,26,3,100,80,29,100,"-1",0
47,27,3,90,65,45,90,"-1",0
47,28,3,10,10,20,15,"1",-5
47,29,2,30,20,66,30,"1",0
47,30,3,2,10,48,2,"1",0
47,31,3,5,40,19,5,"1",0
47,32,4,100,20,33,100,"-1",0
47,33,3,70,30,15,70,"-1",0
47,34,3,90,80,80,90,"-1",0
47,35,1,0,5,17,0,"1",0
47,36,3,25,25,26,26,"1",-1
47,37,3,25,50,30,25,"1",0
47,38,2,90,80,71,90,"-1",0
47,39,3,25,15,43,25,"1",0
47,40,3,0,10,21,0,"1",0
47,41,3,50,50,17,50,"-1",0
47,42,3,10,50,13,5,"1",5
47,43,4,0,20,81,10,"1",-10
47,44,3,5,5,19,5,"1",0
47,45,4,90,65,19,80,"-1",10
47,46,4,100,80,45,100,"-1",0
47,47,3,20,20,20,20,"0",0
47,48,3,15,10,18,15,"1",0
47,49,4,90,8,11,90,"-1",0
47,50,3,0,45,38,0,"1",0
47,51,3,25,55,26,25,"1",0
48,1,5,10,20,26,10,"1",0
48,2,5,3,10,20,10,"1",-7
48,3,4,10,10,29,5,"1",5
48,4,4,0,18,78,10,"1",-10
48,5,5,2,21,56,2,"1",0
48,6,4,10,20,29,10,"1",0
48,7,3,85,75,45,95,"-1",-10
48,8,3,25,75,75,20,"1",5
48,9,3,1,10,29,1,"1",0
48,10,2,10,48,56,10,"1",0
48,11,4,1,3,31,2,"1",-1
48,12,2,88,92,78,80,"-1",8
48,13,4,5,15,22,5,"1",0
48,14,2,10,15,41,10,"1",0
48,15,4,100,75,60,100,"-1",0
48,16,3,15,20,26,15,"1",0
48,17,2,5,50,43,0,"1",5
48,18,2,50,75,82,50,"1",0
48,19,2,75,25,21,66,"-1",9
48,20,3,18,15,40,15,"1",3
48,21,4,96,90,35,95,"-1",1
48,22,2,100,100,60,100,"-1",0
48,23,2,66,75,71,66,"1",0
48,24,3,2,2,14,2,"1",0
48,25,2,0,25,14,0,"1",0
48,26,3,98,82,29,92,"-1",6
48,27,1,0,40,45,0,"1",0
48,28,3,5,5,20,10,"1",-5
48,29,2,95,95,66,90,"-1",5
48,30,3,0,12,48,2,"1",-2
48,31,3,25,75,19,20,"-1",5
48,32,4,100,20,33,100,"-1",0
48,33,4,0,15,15,0,"1",0
48,34,2,0,5,80,5,"1",-5
48,35,2,0,10,17,0,"1",0
48,36,2,25,25,26,26,"1",-1
48,37,4,90,75,30,80,"-1",10
48,38,2,100,90,71,92,"-1",8
48,39,2,0,50,43,0,"1",0
48,40,4,0,25,21,0,"1",0
48,41,1,0,50,17,0,"1",0
48,42,2,0,20,13,0,"1",0
48,43,3,50,50,81,50,"1",0
48,44,3,10,15,19,25,"1",-15
48,45,4,75,35,19,50,"-1",25
48,46,5,100,65,45,100,"-1",0
48,47,4,100,15,20,100,"-1",0
48,48,2,5,9,18,5,"1",0
48,49,2,0,15,11,0,"1",0
48,50,2,0,5,38,0,"1",0
48,51,3,0,50,26,0,"1",0
49,1,5,50,50,26,50,"-1",0
49,2,5,0,0,20,0,"1",0
49,3,5,0,40,29,0,"1",0
49,4,5,70,70,78,75,"1",-5
49,5,5,0,20,56,56,"1",-56
49,6,4,42,42,29,29,"-1",13
49,7,4,0,28,45,20,"1",-20
49,8,4,100,100,75,75,"-1",25
49,9,4,100,33,29,100,"-1",0
49,10,4,63,63,56,56,"-1",7
49,11,5,100,50,31,31,"-1",69
49,12,3,100,100,78,100,"-1",0
49,13,4,0,12,22,10,"1",-10
49,14,2,15,15,41,15,"1",0
49,15,1,80,80,60,60,"-1",20
49,16,3,85,85,26,74,"-1",11
49,17,1,10,10,43,43,"1",-33
49,18,2,50,50,82,50,"1",0
49,19,1,5,43,21,5,"1",0
49,20,2,0,25,40,0,"1",0
49,21,1,5,15,35,5,"1",0
49,22,1,50,50,60,60,"1",-10
49,23,2,80,75,71,75,"-1",5
49,24,3,20,20,14,14,"-1",6
49,25,2,0,20,14,14,"1",-14
49,26,5,100,100,29,100,"-1",0
49,27,2,70,70,45,45,"-1",25
49,28,3,40,40,20,20,"-1",20
49,29,3,75,75,66,66,"-1",9
49,30,2,0,25,48,20,"1",-20
49,31,2,20,20,19,20,"-1",0
49,32,5,80,25,33,80,"-1",0
49,33,4,10,10,15,15,"1",-5
49,34,2,60,60,80,80,"1",-20
49,35,2,100,50,17,20,"-1",80
49,36,3,70,70,26,26,"-1",44
49,37,5,70,70,30,30,"-1",40
49,38,2,100,80,71,100,"-1",0
49,39,1,0,60,43,0,"1",0
49,40,3,0,25,21,10,"1",-10
49,41,2,100,50,17,100,"-1",0
49,42,3,100,100,13,100,"-1",0
49,43,4,20,20,81,81,"1",-61
49,44,3,0,20,19,20,"1",-20
49,45,5,0,100,19,100,"1",-100
49,46,5,100,85,45,100,"-1",0
49,47,5,0,80,20,0,"1",0
49,48,3,100,30,18,100,"-1",0
49,49,4,0,30,11,0,"1",0
49,50,4,0,10,38,0,"1",0
49,51,2,0,10,26,10,"1",-10
50,1,4,12,12,26,20,"1",-8
50,2,4,12,12,20,18,"1",-6
50,3,4,58,23,29,24,"-1",34
50,4,4,98,74,78,94,"-1",4
50,5,5,14,13,56,49,"1",-35
50,6,2,10,12,29,12,"1",-2
50,7,4,22,35,45,22,"1",0
50,8,4,53,56,75,53,"1",0
50,9,4,10,22,29,10,"1",0
50,10,4,64,78,56,64,"-1",0
50,11,4,12,23,31,23,"1",-11
50,12,2,97,95,78,98,"-1",-1
50,13,4,29,1,22,1,"-1",28
50,14,2,15,26,41,24,"1",-9
50,15,2,10,23,60,10,"1",0
50,16,2,5,5,26,5,"1",0
50,17,2,1,21,43,1,"1",0
50,18,2,12,23,82,45,"1",-33
50,19,2,2,65,21,0,"1",2
50,20,2,1,23,40,1,"1",0
50,21,2,1,23,35,1,"1",0
50,22,1,5,42,60,10,"1",-5
50,23,1,23,52,71,42,"1",-19
50,24,3,2,11,14,5,"1",-3
50,25,4,10,12,14,10,"1",0
50,26,4,98,95,29,85,"-1",13
50,27,1,12,63,45,20,"1",-8
50,28,3,13,23,20,20,"1",-7
50,29,1,64,84,66,64,"1",0
50,30,4,99,25,48,99,"-1",0
50,31,2,79,46,19,79,"-1",0
50,32,4,63,46,33,45,"-1",18
50,33,4,89,26,15,86,"-1",3
50,34,2,2,12,80,2,"1",0
50,35,3,24,86,17,3,"-1",21
50,36,2,23,23,26,23,"1",0
50,37,4,36,36,30,30,"-1",6
50,38,2,96,95,71,74,"-1",22
50,39,1,0,45,43,0,"1",0
50,40,4,79,64,21,79,"-1",0
50,41,4,94,85,17,85,"-1",9
50,42,2,78,68,13,46,"-1",32
50,43,4,35,22,81,62,"1",-27
50,44,3,15,15,19,15,"1",0
50,45,4,10,30,19,10,"1",0
50,46,5,46,79,45,45,"-1",1
50,47,4,0,9,20,0,"1",0
50,48,1,0,14,18,0,"1",0
50,49,3,1,12,11,1,"1",0
50,50,3,0,24,38,0,"1",0
50,51,3,1,9,26,1,"1",0
51,1,4,70,20,26,70,"-1",0
51,2,5,5,15,20,5,"1",0
51,3,4,5,35,29,5,"1",0
51,4,5,100,95,78,100,"-1",0
51,5,5,75,60,56,70,"-1",5
51,6,4,20,15,29,20,"1",0
51,7,5,99,45,45,99,"-1",0
51,8,4,70,45,75,70,"1",0
51,9,5,50,65,29,50,"-1",0
51,10,4,90,95,56,50,"-1",40
51,11,5,20,35,31,25,"1",-5
51,12,2,60,45,78,60,"1",0
51,13,5,1,15,22,1,"1",0
51,14,2,15,10,41,10,"1",5
51,15,2,15,20,60,15,"1",0
51,16,1,5,10,26,10,"1",-5
51,17,1,5,10,43,10,"1",-5
51,18,1,100,95,82,100,"-1",0
51,19,2,5,34,21,5,"1",0
51,20,2,5,25,40,5,"1",0
51,21,1,65,54,35,55,"-1",10
51,22,1,80,75,60,50,"-1",30
51,23,2,40,56,71,50,"1",-10
51,24,3,15,10,14,10,"-1",5
51,25,4,80,40,14,35,"-1",45
51,26,3,99,89,29,99,"-1",0
51,27,2,30,65,45,30,"1",0
51,28,3,90,90,20,30,"-1",60
51,29,2,99,99,66,90,"-1",9
51,30,4,99,75,48,99,"-1",0
51,31,3,60,65,19,35,"-1",25
51,32,4,95,15,33,85,"-1",10
51,33,3,65,20,15,50,"-1",15
51,34,3,30,45,80,55,"1",-25
51,35,2,20,35,17,15,"-1",5
51,36,1,70,80,26,25,"-1",45
51,37,4,75,80,30,45,"-1",30
51,38,2,99,80,71,99,"-1",0
51,39,2,5,30,43,10,"1",-5
51,40,5,100,80,21,100,"-1",0
51,41,2,1,20,17,1,"1",0
51,42,3,10,25,13,10,"1",0
51,43,4,70,20,81,85,"1",-15
51,44,3,30,15,19,20,"-1",10
51,45,5,80,65,19,85,"-1",-5
51,46,3,0,75,45,0,"1",0
51,47,3,5,10,20,5,"1",0
51,48,3,70,60,18,30,"-1",40
51,49,5,30,15,11,30,"-1",0
51,50,3,0,40,38,0,"1",0
51,51,5,50,45,26,50,"-1",0
52,1,4,0,10,26,15,"1",-15
52,2,5,0,3,20,0,"1",0
52,3,3,20,40,29,45,"1",-25
52,4,1,100,95,78,100,"-1",0
52,5,4,40,45,56,41,"1",-1
52,6,2,10,20,29,15,"1",-5
52,7,4,0,30,45,0,"1",0
52,8,4,100,100,75,100,"-1",0
52,9,4,40,60,29,50,"-1",-10
52,10,4,20,40,56,30,"1",-10
52,11,3,100,50,31,100,"-1",0
52,12,1,5,15,78,30,"1",-25
52,13,3,0,20,22,5,"1",-5
52,14,1,10,15,41,20,"1",-10
52,15,2,60,67,60,60,"0",0
52,16,2,10,20,26,15,"1",-5
52,17,1,0,20,43,0,"1",0
52,18,1,100,80,82,100,"-1",0
52,19,1,5,27,21,5,"1",0
52,20,1,0,29,40,0,"1",0
52,21,1,10,50,35,20,"1",-10
52,22,2,100,70,60,100,"-1",0
52,23,1,100,90,71,100,"-1",0
52,24,4,10,20,14,28,"1",-18
52,25,1,0,50,14,0,"1",0
52,26,4,100,80,29,100,"-1",0
52,27,1,60,65,45,30,"-1",30
52,28,4,80,71,20,30,"-1",50
52,29,1,98,98,66,98,"-1",0
52,30,2,0,25,48,0,"1",0
52,31,3,50,30,19,40,"-1",10
52,32,2,100,60,33,80,"-1",20
52,33,1,60,40,15,40,"-1",20
52,34,2,0,15,80,10,"1",-10
52,35,3,0,10,17,10,"1",-10
52,36,1,60,65,26,50,"-1",10
52,37,5,70,60,30,45,"-1",25
52,38,1,100,90,71,100,"-1",0
52,39,1,0,19,43,0,"1",0
52,40,2,0,10,21,0,"1",0
52,41,3,100,80,17,80,"-1",20
52,42,3,90,93,13,95,"-1",-5
52,43,1,100,90,81,100,"-1",0
52,44,4,10,20,19,15,"1",-5
52,45,5,100,40,19,100,"-1",0
52,46,5,100,80,45,100,"-1",0
52,47,2,60,80,20,40,"-1",20
52,48,1,0,10,18,3,"1",-3
52,49,4,0,16,11,0,"1",0
52,50,1,0,20,38,0,"1",0
52,51,3,0,20,26,0,"1",0
53,1,4,10,10,26,26,"1",-16
53,2,4,15,15,20,20,"1",-5
53,3,3,25,0,29,0,"1",25
53,4,3,25,60,78,40,"1",-15
53,5,5,5,35,56,5,"1",0
53,6,3,35,30,29,35,"-1",0
53,7,4,22,60,45,22,"1",0
53,8,4,99,50,75,99,"-1",0
53,9,4,25,25,29,29,"1",-4
53,10,3,25,25,56,25,"1",0
53,11,3,5,25,31,5,"1",0
53,12,3,90,90,78,80,"-1",10
53,13,3,5,0,22,0,"1",5
53,14,2,20,20,41,30,"1",-10
53,15,2,25,25,60,60,"1",-35
53,16,2,20,20,26,20,"1",0
53,17,1,10,25,43,0,"1",10
53,18,2,40,40,82,82,"1",-42
53,19,2,0,30,21,0,"1",0
53,20,2,5,10,40,5,"1",0
53,21,1,50,50,35,40,"-1",10
53,22,2,18,18,60,25,"1",-7
53,23,2,80,80,71,80,"-1",0
53,24,3,5,5,14,14,"1",-9
53,25,3,20,40,14,14,"-1",6
53,26,3,90,30,29,90,"-1",0
53,27,2,60,50,45,50,"-1",10
53,28,3,40,40,20,20,"-1",20
53,29,1,70,80,66,66,"-1",4
53,30,3,5,28,48,5,"1",0
53,31,2,90,80,19,10,"-1",80
53,32,3,100,55,33,100,"-1",0
53,33,3,68,68,15,40,"-1",28
53,34,3,15,15,80,20,"1",-5
53,35,2,60,50,17,40,"-1",20
53,36,2,40,40,26,26,"-1",14
53,37,3,35,35,30,30,"-1",5
53,38,2,80,80,71,80,"-1",0
53,39,3,5,20,43,5,"1",0
53,40,3,0,2,21,10,"1",-10
53,41,2,5,75,17,5,"1",0
53,42,2,99,50,13,99,"-1",0
53,43,3,20,20,81,81,"1",-61
53,44,3,5,5,19,19,"1",-14
53,45,4,60,25,19,60,"-1",0
53,46,3,80,65,45,80,"-1",0
53,47,4,100,18,20,100,"-1",0
53,48,3,25,25,18,18,"-1",7
53,49,3,80,18,11,80,"-1",0
53,50,3,20,20,38,38,"1",-18
53,51,3,50,50,26,26,"-1",24
54,1,3,0,20,26,10,"1",-10
54,2,5,10,15,20,10,"1",0
54,3,3,90,60,29,80,"-1",10
54,4,4,90,80,78,80,"-1",10
54,5,5,80,50,56,70,"-1",10
54,6,2,10,5,29,10,"1",0
54,7,4,70,40,45,60,"-1",10
54,8,4,100,80,75,100,"-1",0
54,9,5,80,70,29,60,"-1",20
54,10,5,80,40,56,30,"-1",50
54,11,4,100,20,31,100,"-1",0
54,12,1,10,90,78,50,"1",-40
54,13,5,0,20,22,10,"1",-10
54,14,2,60,40,41,40,"-1",20
54,15,2,100,80,60,70,"-1",30
54,16,1,5,15,26,5,"1",0
54,17,1,20,40,43,30,"1",-10
54,18,1,80,70,82,80,"1",0
54,19,2,80,60,21,70,"-1",10
54,20,2,0,20,40,10,"1",-10
54,21,2,90,50,35,80,"-1",10
54,22,2,20,70,60,30,"1",-10
54,23,3,10,70,71,10,"1",0
54,24,3,5,10,14,10,"1",-5
54,25,3,2,13,14,3,"1",-1
54,26,5,100,90,29,80,"-1",20
54,27,2,90,90,45,70,"-1",20
54,28,3,40,50,20,10,"-1",30
54,29,2,70,60,66,70,"-1",0
54,30,4,0,30,48,30,"1",-30
54,31,2,60,90,19,30,"-1",30
54,32,2,100,30,33,80,"-1",20
54,33,3,80,30,15,70,"-1",10
54,34,3,10,40,80,60,"1",-50
54,35,3,10,15,17,10,"1",0
54,36,2,40,60,26,20,"-1",20
54,37,5,60,80,30,40,"-1",20
54,38,2,90,80,71,70,"-1",20
54,39,3,10,70,43,30,"1",-20
54,40,4,0,5,21,10,"1",-10
54,41,2,30,60,17,30,"-1",0
54,42,3,0,20,13,10,"1",-10
54,43,4,100,60,81,100,"-1",0
54,44,3,0,20,19,10,"1",-10
54,45,3,80,40,19,10,"-1",70
54,46,5,100,80,45,70,"-1",30
54,47,3,10,30,20,10,"1",0
54,48,3,100,60,18,30,"-1",70
54,49,4,80,60,11,40,"-1",40
54,50,3,0,20,38,20,"1",-20
54,51,1,0,20,26,0,"1",0
55,1,3,1,2,26,10,"1",-9
55,2,5,5,30,20,15,"1",-10
55,3,4,40,10,29,8,"-1",32
55,4,4,100,42,78,100,"-1",0
55,5,4,25,24,56,30,"1",-5
55,6,4,75,80,29,32,"-1",43
55,7,4,5,25,45,20,"1",-15
55,8,4,86,56,75,95,"-1",-9
55,9,4,7,25,29,15,"1",-8
55,10,5,65,32,56,79,"-1",-14
55,11,4,55,10,31,25,"-1",30
55,12,3,90,89,78,89,"-1",1
55,13,5,30,15,22,18,"-1",12
55,14,2,20,45,41,10,"1",10
55,15,2,55,65,60,55,"1",0
55,16,2,20,21,26,9,"1",11
55,17,2,30,36,43,35,"1",-5
55,18,1,5,20,82,25,"1",-20
55,19,1,15,20,21,15,"1",0
55,20,2,2,5,40,1,"1",1
55,21,2,55,20,35,25,"-1",30
55,22,1,70,80,60,75,"-1",-5
55,23,1,56,30,71,75,"1",-19
55,24,3,5,20,14,5,"1",0
55,25,3,2,5,14,3,"1",-1
55,26,4,100,82,29,100,"-1",0
55,27,2,29,60,45,40,"1",-11
55,28,3,20,45,20,30,"0",-10
55,29,1,95,78,66,75,"-1",20
55,30,4,100,8,48,100,"-1",0
55,31,2,95,10,19,20,"-1",75
55,32,2,0,33,33,0,"1",0
55,33,3,88,78,15,95,"-1",-7
55,34,3,10,15,80,65,"1",-55
55,35,2,8,80,17,5,"1",3
55,36,2,20,40,26,20,"1",0
55,37,4,40,55,30,32,"-1",8
55,38,2,100,68,71,100,"-1",0
55,39,3,42,20,43,58,"1",-16
55,40,4,55,40,21,30,"-1",25
55,41,2,96,89,17,80,"-1",16
55,42,3,10,45,13,5,"1",5
55,43,4,9,25,81,75,"1",-66
55,44,3,4,12,19,3,"1",1
55,45,3,37,35,19,8,"-1",29
55,46,5,100,65,45,100,"-1",0
55,47,3,2,15,20,5,"1",-3
55,48,3,100,70,18,100,"-1",0
55,49,4,5,15,11,4,"1",1
55,50,4,20,65,38,25,"1",-5
55,51,3,99,70,26,100,"-1",-1
56,1,1,1,5,26,1,"1",0
56,2,5,5,10,20,2,"1",3
56,3,4,20,30,29,15,"1",5
56,4,2,20,33,78,40,"1",-20
56,5,4,0,25,56,0,"1",0
56,6,4,20,25,29,25,"1",-5
56,7,4,100,50,45,50,"-1",50
56,8,3,10,31,75,40,"1",-30
56,9,3,2,5,29,2,"1",0
56,10,3,50,33,56,50,"1",0
56,11,4,5,12,31,20,"1",-15
56,12,1,50,85,78,60,"1",-10
56,13,5,5,10,22,2,"1",3
56,14,3,25,35,41,20,"1",5
56,15,2,20,45,60,35,"1",-15
56,16,1,5,15,26,3,"1",2
56,17,4,90,70,43,90,"-1",0
56,18,2,25,20,82,30,"1",-5
56,19,4,100,50,21,100,"-1",0
56,20,2,33,14,40,33,"1",0
56,21,2,95,86,35,86,"-1",9
56,22,3,80,75,60,60,"-1",20
56,23,1,99,90,71,99,"-1",0
56,24,1,10,10,14,9,"1",1
56,25,2,10,33,14,5,"1",5
56,26,2,0,65,29,0,"1",0
56,27,3,80,80,45,60,"-1",20
56,28,3,25,25,20,20,"-1",5
56,29,3,10,10,66,15,"1",-5
56,30,2,2,15,48,5,"1",-3
56,31,3,50,50,19,50,"-1",0
56,32,4,75,40,33,75,"-1",0
56,33,3,50,50,15,50,"-1",0
56,34,2,95,90,80,95,"-1",0
56,35,3,5,10,17,10,"1",-5
56,36,3,85,84,26,80,"-1",5
56,37,4,95,90,30,50,"-1",45
56,38,2,50,50,71,50,"1",0
56,39,1,5,6,43,5,"1",0
56,40,3,0,24,21,0,"1",0
56,41,3,50,50,17,10,"-1",40
56,42,3,0,50,13,0,"1",0
56,43,3,20,20,81,50,"1",-30
56,44,3,20,20,19,20,"-1",0
56,45,4,95,50,19,95,"-1",0
56,46,5,100,75,45,100,"-1",0
56,47,4,5,5,20,5,"1",0
56,48,1,10,15,18,5,"1",5
56,49,4,1,15,11,5,"1",-4
56,50,3,15,20,38,15,"1",0
56,51,3,85,40,26,60,"-1",25
57,1,5,70,70,26,30,"-1",40
57,2,5,10,10,20,17,"1",-7
57,3,4,5,45,29,10,"1",-5
57,4,5,100,80,78,90,"-1",10
57,5,5,60,60,56,60,"-1",0
57,6,5,40,30,29,30,"-1",10
57,7,4,20,30,45,20,"1",0
57,8,5,70,70,75,80,"1",-10
57,9,4,7,15,29,17,"1",-10
57,10,4,20,60,56,20,"1",0
57,11,5,10,5,31,15,"1",-5
57,12,2,0,30,78,0,"1",0
57,13,5,39,15,22,15,"-1",24
57,14,2,30,30,41,30,"1",0
57,15,1,30,30,60,30,"1",0
57,16,2,30,30,26,25,"-1",5
57,17,2,20,14,43,20,"1",0
57,18,2,60,70,82,70,"1",-10
57,19,2,70,70,21,60,"-1",10
57,20,2,10,50,40,10,"1",0
57,21,1,50,50,35,35,"-1",15
57,22,1,40,70,60,60,"1",-20
57,23,2,60,60,71,60,"1",0
57,24,3,3,3,14,14,"1",-11
57,25,5,60,60,14,40,"-1",20
57,26,3,100,90,29,100,"-1",0
57,27,2,53,53,45,35,"-1",18
57,28,3,40,40,20,20,"-1",20
57,29,1,70,70,66,65,"-1",5
57,30,3,0,30,48,0,"1",0
57,31,2,20,30,19,16,"-1",4
57,32,1,20,80,33,10,"1",10
57,33,4,90,30,15,18,"-1",72
57,34,3,10,50,80,30,"1",-20
57,35,2,40,50,17,11,"-1",29
57,36,3,80,80,26,35,"-1",45
57,37,3,80,80,30,40,"-1",40
57,38,2,60,60,71,60,"1",0
57,39,4,40,60,43,40,"1",0
57,40,4,15,20,21,11,"1",4
57,41,3,20,80,17,7,"-1",13
57,42,3,10,30,13,5,"1",5
57,43,5,70,80,81,80,"1",-10
57,44,3,5,5,19,20,"1",-15
57,45,5,15,30,19,12,"1",3
57,46,5,100,65,45,100,"-1",0
57,47,3,5,5,20,10,"1",-5
57,48,3,50,17,18,40,"-1",10
57,49,5,10,10,11,4,"1",6
57,50,3,20,40,38,20,"1",0
57,51,1,10,30,26,10,"1",0
58,1,4,9,15,26,15,"1",-6
58,2,4,9,28,20,15,"1",-6
58,3,4,62,85,29,85,"-1",-23
58,4,4,68,72,78,72,"1",-4
58,5,4,72,76,56,72,"-1",0
58,6,4,26,15,29,26,"1",0
58,7,4,100,68,45,100,"-1",0
58,8,4,100,96,75,100,"-1",0
58,9,4,36,19,29,26,"-1",10
58,10,4,78,68,56,68,"-1",10
58,11,4,15,25,31,15,"1",0
58,12,2,72,85,78,72,"1",0
58,13,4,50,20,22,20,"-1",30
58,14,2,15,24,41,15,"1",0
58,15,2,15,19,60,15,"1",0
58,16,3,32,25,26,24,"-1",8
58,17,2,18,26,43,18,"1",0
58,18,3,45,86,82,72,"1",-27
58,19,2,18,86,21,15,"1",3
58,20,2,12,62,40,12,"1",0
58,21,2,90,85,35,85,"-1",5
58,22,2,36,57,60,45,"1",-9
58,23,2,82,95,71,68,"-1",14
58,24,3,58,45,14,18,"-1",40
58,25,4,10,24,14,10,"1",0
58,26,3,100,99,29,100,"-1",0
58,27,2,25,57,45,45,"1",-20
58,28,3,12,13,20,20,"1",-8
58,29,2,16,15,66,68,"1",-52
58,30,3,9,25,48,9,"1",0
58,31,3,12,12,19,25,"1",-13
58,32,4,92,28,33,92,"-1",0
58,33,3,15,15,15,15,"0",0
58,34,3,9,12,80,9,"1",0
58,35,2,9,12,17,6,"1",3
58,36,2,21,52,26,21,"1",0
58,37,4,17,24,30,15,"1",2
58,38,2,72,82,71,72,"-1",0
58,39,3,65,47,43,45,"-1",20
58,40,4,99,82,21,99,"-1",0
58,41,3,68,75,17,25,"-1",43
58,42,3,10,12,13,10,"1",0
58,43,4,36,15,81,52,"1",-16
58,44,3,15,29,19,15,"1",0
58,45,3,48,85,19,48,"-1",0
58,46,4,68,85,45,68,"-1",0
58,47,3,10,42,20,10,"1",0
58,48,2,0,16,18,0,"1",0
58,49,3,34,24,11,24,"-1",10
58,50,3,0,27,38,0,"1",0
58,51,3,45,76,26,45,"-1",0
59,1,2,2,5,26,4,"1",-2
59,2,5,1,8,20,4,"1",-3
59,3,2,2,70,29,4,"1",-2
59,4,2,3,55,78,9,"1",-6
59,5,4,66,32,56,60,"-1",6
59,6,3,40,50,29,30,"-1",10
59,7,4,44,60,45,40,"1",4
59,8,4,99,60,75,99,"-1",0
59,9,4,33,20,29,33,"-1",0
59,10,4,77,50,56,76,"-1",1
59,11,5,12,23,31,16,"1",-4
59,12,2,2,45,78,2,"1",0
59,13,4,1,7,22,1,"1",0
59,14,2,14,30,41,17,"1",-3
59,15,2,10,15,60,30,"1",-20
59,16,2,34,45,26,30,"-1",4
59,17,1,10,25,43,14,"1",-4
59,18,2,11,23,82,24,"1",-13
59,19,2,3,27,21,5,"1",-2
59,20,2,6,37,40,9,"1",-3
59,21,2,13,43,35,19,"1",-6
59,22,1,19,25,60,25,"1",-6
59,23,2,76,56,71,60,"-1",16
59,24,3,40,60,14,14,"-1",26
59,25,3,6,30,14,8,"1",-2
59,26,3,97,65,29,97,"-1",0
59,27,2,5,21,45,15,"1",-10
59,28,3,70,34,20,60,"-1",10
59,29,3,99,70,66,80,"-1",19
59,30,3,4,21,48,9,"1",-5
59,31,4,80,40,19,60,"-1",20
59,32,3,88,44,33,88,"-1",0
59,33,4,60,50,15,30,"-1",30
59,34,3,50,60,80,60,"1",-10
59,35,3,56,11,17,31,"-1",25
59,36,2,20,30,26,21,"1",-1
59,37,4,32,45,30,39,"-1",-7
59,38,3,88,90,71,80,"-1",8
59,39,2,1,48,43,2,"1",-1
59,40,4,60,50,21,30,"-1",30
59,41,3,88,99,17,78,"-1",10
59,42,3,88,67,13,77,"-1",11
59,43,4,75,35,81,79,"1",-4
59,44,3,4,30,19,8,"1",-4
59,45,4,9,25,19,15,"1",-6
59,46,4,1,50,45,1,"1",0
59,47,3,4,9,20,10,"1",-6
59,48,3,6,32,18,14,"1",-8
59,49,5,2,33,11,2,"1",0
59,50,4,5,50,38,7,"1",-2
59,51,3,20,40,26,20,"1",0
60,1,2,50,20,26,50,"-1",0
60,2,5,20,20,20,20,"0",0
60,3,1,40,0,29,0,"-1",40
60,4,4,60,40,78,60,"1",0
60,5,5,80,70,56,80,"-1",0
60,6,3,60,60,29,29,"-1",31
60,7,4,80,80,45,45,"-1",35
60,8,3,80,80,75,75,"-1",5
60,9,4,5,10,29,5,"1",0
60,10,2,60,60,56,56,"-1",4
60,11,4,20,20,31,31,"1",-11
60,12,3,60,60,78,60,"1",0
60,13,1,15,0,22,0,"1",15
60,14,1,5,20,41,5,"1",0
60,15,2,80,80,60,80,"-1",0
60,16,1,10,20,26,10,"1",0
60,17,2,5,30,43,5,"1",0
60,18,1,80,80,82,82,"1",-2
60,19,2,20,70,21,10,"1",10
60,20,2,1,15,40,1,"1",0
60,21,1,2,50,35,2,"1",0
60,22,2,70,70,60,60,"-1",10
60,23,1,80,80,71,71,"-1",9
60,24,3,20,10,14,20,"-1",0
60,25,1,0,40,14,0,"1",0
60,26,3,80,80,29,29,"-1",51
60,27,1,1,70,45,1,"1",0
60,28,3,80,60,20,80,"-1",0
60,29,1,85,85,66,66,"-1",19
60,30,1,0,20,48,0,"1",0
60,31,3,20,20,19,19,"-1",1
60,32,5,0,30,33,0,"1",0
60,33,4,80,60,15,80,"-1",0
60,34,3,1,5,80,1,"1",0
60,35,2,10,60,17,10,"1",0
60,36,2,60,60,26,26,"-1",34
60,37,3,80,80,30,30,"-1",50
60,38,2,40,60,71,40,"1",0
60,39,1,1,30,43,1,"1",0
60,40,4,20,75,21,20,"1",0
60,41,3,0,60,17,0,"1",0
60,42,3,10,60,13,5,"1",5
60,43,3,20,30,81,80,"1",-60
60,44,3,10,10,19,19,"1",-9
60,45,5,30,10,19,30,"-1",0
60,46,5,100,70,45,100,"-1",0
60,47,3,5,70,20,10,"1",-5
60,48,2,10,40,18,10,"1",0
60,49,4,15,15,11,11,"-1",4
60,50,3,5,40,38,5,"1",0
60,51,3,50,40,26,50,"-1",0
61,1,5,40,30,26,40,"-1",0
61,2,5,10,40,20,10,"1",0
61,3,3,50,10,29,10,"-1",40
61,4,4,90,50,78,90,"-1",0
61,5,5,5,50,56,10,"1",-5
61,6,5,40,10,29,40,"-1",0
61,7,3,100,40,45,100,"-1",0
61,8,2,95,90,75,95,"-1",0
61,9,4,10,30,29,10,"1",0
61,10,4,40,80,56,40,"1",0
61,11,5,5,20,31,8,"1",-3
61,12,2,0,70,78,0,"1",0
61,13,4,5,0,22,1,"1",4
61,14,2,50,85,41,30,"-1",20
61,15,2,80,70,60,70,"-1",10
61,16,2,20,5,26,5,"1",15
61,17,1,10,40,43,10,"1",0
61,18,2,10,40,82,30,"1",-20
61,19,2,60,30,21,30,"-1",30
61,20,2,0,20,40,0,"1",0
61,21,1,20,40,35,20,"1",0
61,22,2,95,95,60,60,"-1",35
61,23,1,50,50,71,71,"1",-21
61,24,3,5,5,14,20,"1",-15
61,25,4,90,40,14,80,"-1",10
61,26,3,100,98,29,100,"-1",0
61,27,2,5,25,45,20,"1",-15
61,28,3,10,10,20,20,"1",-10
61,29,2,90,90,66,70,"-1",20
61,30,4,100,30,48,100,"-1",0
61,31,4,90,50,19,80,"-1",10
61,32,5,100,80,33,100,"-1",0
61,33,3,10,40,15,30,"1",-20
61,34,3,70,70,80,80,"1",-10
61,35,1,0,20,17,0,"1",0
61,36,2,70,70,26,30,"-1",40
61,37,3,70,70,30,30,"-1",40
61,38,3,95,95,71,71,"-1",24
61,39,1,0,30,43,0,"1",0
61,40,4,90,70,21,80,"-1",10
61,41,3,20,70,17,10,"-1",10
61,42,3,70,30,13,20,"-1",50
61,43,4,50,40,81,81,"1",-31
61,44,3,5,15,19,5,"1",0
61,45,4,100,60,19,100,"-1",0
61,46,5,95,40,45,95,"-1",0
61,47,4,100,70,20,100,"-1",0
61,48,4,100,50,18,100,"-1",0
61,49,3,15,35,11,5,"-1",10
61,50,3,10,30,38,10,"1",0
61,51,3,0,20,26,0,"1",0
62,1,2,10,10,26,26,"1",-16
62,2,5,32,38,20,20,"-1",12
62,3,2,0,12,29,0,"1",0
62,4,5,100,88,78,100,"-1",0
62,5,5,25,40,56,25,"1",0
62,6,4,85,62,29,85,"-1",0
62,7,5,0,62,45,0,"1",0
62,8,3,100,100,75,100,"-1",0
62,9,3,0,8,29,0,"1",0
62,10,4,25,32,56,38,"1",-13
62,11,4,15,15,31,20,"1",-5
62,12,3,5,65,78,5,"1",0
62,13,3,0,15,22,0,"1",0
62,14,2,100,72,41,100,"-1",0
62,15,1,40,22,60,40,"1",0
62,16,4,45,22,26,35,"-1",10
62,17,2,12,32,43,12,"1",0
62,18,2,30,42,82,25,"1",5
62,19,1,0,12,21,0,"1",0
62,20,1,0,7,40,0,"1",0
62,21,3,100,85,35,85,"-1",15
62,22,2,85,85,60,60,"-1",25
62,23,2,100,100,71,85,"-1",15
62,24,3,12,19,14,14,"1",-2
62,25,4,35,22,14,25,"-1",10
62,26,3,100,74,29,100,"-1",0
62,27,1,0,22,45,0,"1",0
62,28,3,14,14,20,20,"1",-6
62,29,1,99,99,66,100,"-1",-1
62,30,4,50,18,48,35,"-1",15
62,31,2,25,12,19,40,"-1",-15
62,32,5,100,37,33,100,"-1",0
62,33,4,0,42,15,10,"1",-10
62,34,3,0,12,80,0,"1",0
62,35,1,0,42,17,0,"1",0
62,36,3,100,85,26,50,"-1",50
62,37,3,0,42,30,0,"1",0
62,38,2,100,95,71,100,"-1",0
62,39,2,100,52,43,85,"-1",15
62,40,2,0,38,21,0,"1",0
62,41,4,5,37,17,10,"1",-5
62,42,3,5,15,13,2,"1",3
62,43,3,0,28,81,0,"1",0
62,44,3,50,50,19,19,"-1",31
62,45,4,0,17,19,0,"1",0
62,46,5,100,14,45,100,"-1",0
62,47,5,100,32,20,100,"-1",0
62,48,3,0,27,18,10,"1",-10
62,49,4,0,3,11,8,"1",-8
62,50,3,0,7,38,0,"1",0
62,51,2,0,12,26,0,"1",0
63,1,5,58,23,26,44,"-1",14
63,2,4,12,43,20,9,"1",3
63,3,4,45,23,29,18,"-1",27
63,4,4,86,78,78,86,"-1",0
63,5,5,25,54,56,25,"1",0
63,6,4,23,53,29,13,"1",10
63,7,4,32,67,45,22,"1",10
63,8,2,11,53,75,11,"1",0
63,9,3,41,63,29,13,"-1",28
63,10,4,89,72,56,78,"-1",11
63,11,5,87,45,31,87,"-1",0
63,12,2,0,74,78,0,"1",0
63,13,5,13,1,22,1,"1",12
63,14,2,75,43,41,75,"-1",0
63,15,1,85,76,60,76,"-1",9
63,16,2,68,89,26,54,"-1",14
63,17,2,35,55,43,35,"1",0
63,18,2,98,87,82,98,"-1",0
63,19,1,5,29,21,5,"1",0
63,20,3,86,56,40,86,"-1",0
63,21,2,65,55,35,55,"-1",10
63,22,1,89,89,60,75,"-1",14
63,23,2,90,90,71,90,"-1",0
63,24,3,5,12,14,8,"1",-3
63,25,3,59,36,14,37,"-1",22
63,26,3,12,68,29,5,"1",7
63,27,3,32,55,45,32,"1",0
63,28,3,45,45,20,20,"-1",25
63,29,2,75,75,66,66,"-1",9
63,30,4,98,98,48,96,"-1",2
63,31,4,87,41,19,47,"-1",40
63,32,4,98,65,33,98,"-1",0
63,33,3,78,35,15,65,"-1",13
63,34,2,11,25,80,65,"1",-54
63,35,1,0,15,17,0,"1",0
63,36,2,78,78,26,30,"-1",48
63,37,4,65,65,30,30,"-1",35
63,38,2,67,67,71,71,"1",-4
63,39,3,10,32,43,10,"1",0
63,40,4,95,75,21,92,"-1",3
63,41,3,42,63,17,32,"-1",10
63,42,3,89,56,13,86,"-1",3
63,43,5,7,55,81,36,"1",-29
63,44,3,5,13,19,5,"1",0
63,45,3,14,25,19,14,"1",0
63,46,4,100,32,45,100,"-1",0
63,47,3,21,68,20,10,"-1",11
63,48,2,0,6,18,2,"1",-2
63,49,3,0,12,11,0,"1",0
63,50,4,30,15,38,40,"1",-10
63,51,1,12,56,26,8,"1",4
64,1,3,1,5,26,4,"1",-3
64,2,3,30,39,20,9,"-1",21
64,3,4,70,50,29,3,"-1",67
64,4,3,20,50,78,30,"1",-10
64,5,4,46,26,56,24,"1",22
64,6,4,7,19,29,7,"1",0
64,7,4,20,30,45,19,"1",1
64,8,4,46,75,75,40,"1",6
64,9,3,3,10,29,18,"1",-15
64,10,3,70,80,56,65,"-1",5
64,11,3,5,17,31,7,"1",-2
64,12,3,75,54,78,65,"1",10
64,13,3,4,10,22,4,"1",0
64,14,2,5,20,41,6,"1",-1
64,15,2,25,20,60,30,"1",-5
64,16,2,2,66,26,6,"1",-4
64,17,1,24,48,43,10,"1",14
64,18,2,30,40,82,60,"1",-30
64,19,3,15,4,21,69,"1",-54
64,20,2,10,15,40,12,"1",-2
64,21,1,12,45,35,15,"1",-3
64,22,3,4,10,60,40,"1",-36
64,23,2,10,56,71,12,"1",-2
64,24,3,1,10,14,2,"1",-1
64,25,3,0,59,14,0,"1",0
64,26,3,40,60,29,10,"-1",30
64,27,3,56,50,45,50,"-1",6
64,28,3,3,34,20,23,"1",-20
64,29,3,50,45,66,34,"1",16
64,30,3,10,16,48,12,"1",-2
64,31,2,10,15,19,11,"1",-1
64,32,3,4,45,33,12,"1",-8
64,33,3,10,25,15,5,"1",5
64,34,2,10,12,80,60,"1",-50
64,35,3,3,2,17,1,"1",2
64,36,3,70,50,26,35,"-1",35
64,37,3,38,30,30,1,"-1",37
64,38,3,85,65,71,63,"-1",22
64,39,3,10,15,43,10,"1",0
64,40,3,70,70,21,10,"-1",60
64,41,3,54,78,17,54,"-1",0
64,42,2,56,75,13,5,"-1",51
64,43,3,1,5,81,17,"1",-16
64,44,3,5,10,19,7,"1",-2
64,45,3,0,19,19,2,"1",-2
64,46,3,6,13,45,7,"1",-1
64,47,3,30,25,20,15,"-1",15
64,48,2,5,10,18,6,"1",-1
64,49,3,1,20,11,1,"1",0
64,50,3,4,40,38,6,"1",-2
64,51,3,2,15,26,3,"1",-1
65,1,5,3,5,26,4,"1",-1
65,2,5,10,10,20,20,"1",-10
65,3,3,0,39,29,0,"1",0
65,4,4,99,76,78,88,"-1",11
65,5,5,80,34,56,88,"-1",-8
65,6,4,60,60,29,40,"-1",20
65,7,5,50,34,45,60,"-1",-10
65,8,4,100,80,75,100,"-1",0
65,9,5,55,24,29,29,"-1",26
65,10,4,100,67,56,100,"-1",0
65,11,4,90,56,31,88,"-1",2
65,12,3,1,90,78,2,"1",-1
65,13,5,0,40,22,0,"1",0
65,14,2,80,75,41,80,"-1",0
65,15,1,100,58,60,100,"-1",0
65,16,2,100,40,26,100,"-1",0
65,17,1,12,47,43,23,"1",-11
65,18,2,60,60,82,70,"1",-10
65,19,1,89,56,21,89,"-1",0
65,20,1,12,16,40,15,"1",-3
65,21,1,14,14,35,30,"1",-16
65,22,1,18,18,60,50,"1",-32
65,23,2,90,90,71,80,"-1",10
65,24,3,1,1,14,10,"1",-9
65,25,4,25,15,14,19,"-1",6
65,26,4,100,80,29,100,"-1",0
65,27,3,88,34,45,99,"-1",-11
65,28,3,78,78,20,34,"-1",44
65,29,3,70,70,66,65,"-1",5
65,30,3,0,15,48,0,"1",0
65,31,2,100,89,19,10,"-1",90
65,32,5,100,30,33,100,"-1",0
65,33,3,70,30,15,15,"-1",55
65,34,3,0,30,80,60,"1",-60
65,35,5,14,25,17,17,"1",-3
65,36,3,60,45,26,30,"-1",30
65,37,5,50,50,30,40,"-1",10
65,38,2,99,99,71,80,"-1",19
65,39,1,0,22,43,0,"1",0
65,40,5,75,66,21,56,"-1",19
65,41,2,80,60,17,20,"-1",60
65,42,3,50,40,13,19,"-1",31
65,43,5,0,17,81,0,"1",0
65,44,3,60,45,19,45,"-1",15
65,45,4,99,50,19,20,"-1",79
65,46,5,100,60,45,100,"-1",0
65,47,3,0,10,20,10,"1",-10
65,48,4,95,25,18,99,"-1",-4
65,49,3,0,17,11,0,"1",0
65,50,3,0,30,38,0,"1",0
65,51,2,25,45,26,45,"1",-20
66,1,5,40,30,26,40,"-1",0
66,2,4,20,10,20,20,"0",0
66,3,5,60,60,29,40,"-1",20
66,4,5,50,35,78,60,"1",-10
66,5,4,30,10,56,30,"1",0
66,6,4,40,60,29,40,"-1",0
66,7,4,10,60,45,10,"1",0
66,8,5,10,20,75,30,"1",-20
66,9,5,70,30,29,70,"-1",0
66,10,5,90,75,56,70,"-1",20
66,11,4,30,30,31,30,"1",0
66,12,4,20,40,78,50,"1",-30
66,13,5,30,40,22,30,"-1",0
66,14,2,40,40,41,40,"1",0
66,15,1,0,0,60,5,"1",-5
66,16,1,10,5,26,10,"1",0
66,17,1,30,30,43,30,"1",0
66,18,2,60,45,82,60,"1",0
66,19,1,0,60,21,0,"1",0
66,20,2,10,20,40,10,"1",0
66,21,1,50,60,35,50,"-1",0
66,22,2,50,40,60,50,"1",0
66,23,4,20,60,71,60,"1",-40
66,24,4,10,10,14,10,"1",0
66,25,5,100,75,14,100,"-1",0
66,26,5,90,60,29,90,"-1",0
66,27,4,40,30,45,40,"1",0
66,28,4,30,30,20,30,"-1",0
66,29,3,20,30,66,50,"1",-30
66,30,4,10,30,48,40,"1",-30
66,31,1,75,50,19,75,"-1",0
66,32,5,75,30,33,75,"-1",0
66,33,4,60,45,15,60,"-1",0
66,34,3,20,15,80,30,"1",-10
66,35,2,20,20,17,20,"-1",0
66,36,2,50,50,26,30,"-1",20
66,37,4,40,30,30,30,"-1",10
66,38,1,100,85,71,100,"-1",0
66,39,4,60,60,43,60,"-1",0
66,40,3,10,30,21,30,"1",-20
66,41,4,40,30,17,30,"-1",10
66,42,4,75,80,13,65,"-1",10
66,43,2,30,30,81,60,"1",-30
66,44,3,30,30,19,30,"-1",0
66,45,5,60,10,19,40,"-1",20
66,46,4,10,40,45,10,"1",0
66,47,4,0,10,20,0,"1",0
66,48,4,50,60,18,50,"-1",0
66,49,4,5,20,11,5,"1",0
66,50,1,0,20,38,0,"1",0
66,51,3,70,80,26,60,"-1",10
67,1,5,17,15,26,19,"1",-2
67,2,4,17,15,20,18,"1",-1
67,3,4,38,38,29,34,"-1",4
67,4,4,56,42,78,78,"1",-22
67,5,4,50,35,56,65,"1",-15
67,6,4,20,30,29,25,"1",-5
67,7,4,20,40,45,22,"1",-2
67,8,4,99,80,75,99,"-1",0
67,9,4,12,23,29,24,"1",-12
67,10,4,80,70,56,70,"-1",10
67,11,4,25,20,31,25,"1",0
67,12,3,70,50,78,75,"1",-5
67,13,4,3,0,22,3,"1",0
67,14,2,40,60,41,41,"1",-1
67,15,2,80,80,60,65,"-1",15
67,16,2,50,60,26,40,"-1",10
67,17,1,45,23,43,48,"-1",-3
67,18,2,26,24,82,56,"1",-30
67,19,2,36,23,21,25,"-1",11
67,20,1,15,25,40,20,"1",-5
67,21,2,72,65,35,48,"-1",24
67,22,2,47,43,60,56,"1",-9
67,23,2,20,35,71,40,"1",-20
67,24,3,2,3,14,11,"1",-9
67,25,4,20,23,14,20,"-1",0
67,26,4,80,67,29,40,"-1",40
67,27,2,92,76,45,55,"-1",37
67,28,3,18,16,20,20,"1",-2
67,29,2,66,42,66,66,"0",0
67,30,4,10,8,48,43,"1",-33
67,31,2,78,60,19,40,"-1",38
67,32,4,70,35,33,50,"-1",20
67,33,4,100,80,15,50,"-1",50
67,34,3,65,70,80,75,"1",-10
67,35,2,30,40,17,23,"-1",7
67,36,2,85,85,26,40,"-1",45
67,37,4,26,36,30,32,"1",-6
67,38,2,87,85,71,75,"-1",12
67,39,2,8,12,43,12,"1",-4
67,40,4,80,70,21,70,"-1",10
67,41,4,67,45,17,30,"-1",37
67,42,3,45,45,13,15,"-1",30
67,43,4,30,46,81,60,"1",-30
67,44,3,18,17,19,18,"1",0
67,45,4,56,45,19,25,"-1",31
67,46,5,60,65,45,50,"-1",10
67,47,4,1,3,20,10,"1",-9
67,48,2,40,35,18,30,"-1",10
67,49,2,13,15,11,13,"-1",0
67,50,4,12,35,38,32,"1",-20
67,51,2,60,45,26,33,"-1",27
68,1,5,3,12,26,5,"1",-2
68,2,5,10,20,20,10,"1",0
68,3,5,40,100,29,100,"-1",-60
68,4,5,100,90,78,100,"-1",0
68,5,5,10,12,56,56,"1",-46
68,6,5,60,20,29,50,"-1",10
68,7,5,60,60,45,60,"-1",0
68,8,4,100,90,75,100,"-1",0
68,9,5,56,36,29,56,"-1",0
68,10,4,60,60,56,56,"-1",4
68,11,5,16,13,31,31,"1",-15
68,12,4,50,99,78,78,"1",-28
68,13,5,30,30,22,22,"-1",8
68,14,2,13,13,41,41,"1",-28
68,15,4,100,90,60,99,"-1",1
68,16,4,15,80,26,80,"1",-65
68,17,1,30,30,43,43,"1",-13
68,18,2,100,60,82,100,"-1",0
68,19,1,0,32,21,0,"1",0
68,20,1,2,30,40,2,"1",0
68,21,3,100,70,35,95,"-1",5
68,22,2,95,95,60,60,"-1",35
68,23,3,80,60,71,71,"-1",9
68,24,3,15,15,14,14,"-1",1
68,25,5,90,40,14,90,"-1",0
68,26,3,30,90,29,30,"-1",0
68,27,3,23,23,45,45,"1",-22
68,28,3,19,19,20,20,"1",-1
68,29,2,40,40,66,66,"1",-26
68,30,2,5,20,48,5,"1",0
68,31,5,60,27,19,50,"-1",10
68,32,5,60,43,33,40,"-1",20
68,33,3,36,26,15,15,"-1",21
68,34,3,90,90,80,80,"-1",10
68,35,1,0,16,17,0,"1",0
68,36,3,35,35,26,26,"-1",9
68,37,4,20,30,30,20,"1",0
68,38,2,90,90,71,81,"-1",9
68,39,1,0,46,43,0,"1",0
68,40,3,3,42,21,3,"1",0
68,41,3,5,45,17,5,"1",0
68,42,3,90,70,13,90,"-1",0
68,43,4,12,45,81,25,"1",-13
68,44,3,36,36,19,25,"-1",11
68,45,5,20,20,19,19,"-1",1
68,46,4,10,50,45,10,"1",0
68,47,4,30,30,20,20,"-1",10
68,48,2,10,15,18,16,"1",-6
68,49,4,5,10,11,5,"1",0
68,50,4,10,32,38,10,"1",0
68,51,4,45,60,26,30,"-1",15
69,1,5,15,15,26,26,"1",-11
69,2,5,50,60,20,20,"-1",30
69,3,4,0,45,29,0,"1",0
69,4,5,100,90,78,100,"-1",0
69,5,4,15,15,56,56,"1",-41
69,6,4,10,15,29,10,"1",0
69,7,5,35,35,45,45,"1",-10
69,8,3,65,90,75,60,"1",5
69,9,3,0,10,29,0,"1",0
69,10,5,80,55,56,80,"-1",0
69,11,3,5,15,31,5,"1",0
69,12,3,100,80,78,100,"-1",0
69,13,3,0,5,22,0,"1",0
69,14,2,5,45,41,5,"1",0
69,15,1,75,75,60,65,"-1",10
69,16,2,5,25,26,5,"1",0
69,17,1,15,15,43,43,"1",-28
69,18,1,20,20,82,20,"1",0
69,19,1,80,75,21,50,"-1",30
69,20,2,0,10,40,0,"1",0
69,21,1,10,70,35,15,"1",-5
69,22,1,90,90,60,60,"-1",30
69,23,1,80,88,71,80,"-1",0
69,24,3,65,50,14,45,"-1",20
69,25,4,40,65,14,10,"-1",30
69,26,3,100,90,29,50,"-1",50
69,27,2,50,90,45,50,"-1",0
69,28,3,50,50,20,20,"-1",30
69,29,1,95,95,66,90,"-1",5
69,30,4,0,8,48,0,"1",0
69,31,3,25,35,19,15,"-1",10
69,32,5,5,8,33,30,"1",-25
69,33,3,5,15,15,5,"1",0
69,34,3,0,10,80,50,"1",-50
69,35,1,5,50,17,5,"1",0
69,36,3,25,15,26,25,"1",0
69,37,4,50,90,30,30,"-1",20
69,38,1,55,55,71,70,"1",-15
69,39,1,85,85,43,0,"-1",85
69,40,5,100,85,21,90,"-1",10
69,41,3,10,75,17,5,"1",5
69,42,3,0,65,13,0,"1",0
69,43,3,80,55,81,80,"1",0
69,44,3,0,45,19,0,"1",0
69,45,3,0,60,19,0,"1",0
69,46,5,90,35,45,90,"-1",0
69,47,5,100,30,20,100,"-1",0
69,48,2,0,20,18,0,"1",0
69,49,4,0,10,11,0,"1",0
69,50,3,0,60,38,0,"1",0
69,51,3,0,75,26,0,"1",0
70,1,5,10,10,26,26,"1",-16
70,2,5,10,10,20,20,"1",-10
70,3,1,0,55,29,0,"1",0
70,4,2,50,22,78,55,"1",-5
70,5,4,95,75,56,95,"-1",0
70,6,4,17,17,29,17,"1",0
70,7,2,0,50,45,0,"1",0
70,8,3,50,50,75,75,"1",-25
70,9,4,15,15,29,29,"1",-14
70,10,3,45,45,56,56,"1",-11
70,11,4,72,72,31,50,"-1",22
70,12,3,95,95,78,78,"-1",17
70,13,1,0,45,22,0,"1",0
70,14,2,50,50,41,50,"-1",0
70,15,2,50,50,60,60,"1",-10
70,16,2,0,35,26,0,"1",0
70,17,2,50,50,43,43,"-1",7
70,18,2,50,85,82,50,"1",0
70,19,3,0,50,21,0,"1",0
70,20,1,0,35,40,0,"1",0
70,21,2,35,35,35,35,"0",0
70,22,1,60,60,60,60,"0",0
70,23,1,19,19,71,45,"1",-26
70,24,3,5,5,14,14,"1",-9
70,25,4,35,35,14,35,"-1",0
70,26,3,95,95,29,95,"-1",0
70,27,1,35,75,45,25,"1",10
70,28,3,19,19,20,20,"1",-1
70,29,2,85,85,66,66,"-1",19
70,30,5,100,19,48,100,"-1",0
70,31,2,85,85,19,19,"-1",66
70,32,3,0,56,33,0,"1",0
70,33,3,5,5,15,15,"1",-10
70,34,3,0,19,80,0,"1",0
70,35,1,85,85,17,17,"-1",68
70,36,1,0,55,26,0,"1",0
70,37,5,75,75,30,30,"-1",45
70,38,3,85,85,71,71,"-1",14
70,39,3,50,75,43,25,"-1",25
70,40,3,0,55,21,0,"1",0
70,41,3,0,50,17,0,"1",0
70,42,3,0,50,13,0,"1",0
70,43,3,75,75,81,81,"1",-6
70,44,3,60,60,19,19,"-1",41
70,45,1,0,12,19,0,"1",0
70,46,5,100,95,45,100,"-1",0
70,47,3,1,50,20,1,"1",0
70,48,3,0,50,18,0,"1",0
70,49,4,25,25,11,25,"-1",0
70,50,3,0,35,38,0,"1",0
70,51,3,0,50,26,0,"1",0
71,1,4,0,10,26,0,"1",0
71,2,4,70,50,20,70,"-1",0
71,3,5,100,75,29,100,"-1",0
71,4,3,100,89,78,100,"-1",0
71,5,4,50,25,56,50,"1",0
71,6,3,10,15,29,10,"1",0
71,7,3,100,80,45,100,"-1",0
71,8,3,5,25,75,5,"1",0
71,9,4,30,20,29,30,"-1",0
71,10,3,25,85,56,15,"1",10
71,11,4,30,10,31,30,"1",0
71,12,1,100,100,78,100,"-1",0
71,13,5,0,10,22,0,"1",0
71,14,2,10,10,41,10,"1",0
71,15,2,5,10,60,5,"1",0
71,16,2,5,45,26,5,"1",0
71,17,2,10,10,43,10,"1",0
71,18,2,100,25,82,100,"-1",0
71,19,2,0,14,21,0,"1",0
71,20,2,0,14,40,0,"1",0
71,21,2,5,20,35,5,"1",0
71,22,1,15,55,60,15,"1",0
71,23,2,10,75,71,10,"1",0
71,24,3,10,10,14,10,"1",0
71,25,2,0,25,14,0,"1",0
71,26,4,100,85,29,100,"-1",0
71,27,2,15,40,45,15,"1",0
71,28,3,40,40,20,20,"-1",20
71,29,2,99,50,66,99,"-1",0
71,30,4,100,15,48,100,"-1",0
71,31,2,0,10,19,0,"1",0
71,32,3,0,20,33,0,"1",0
71,33,3,100,20,15,100,"-1",0
71,34,2,0,10,80,0,"1",0
71,35,2,10,15,17,10,"1",0
71,36,2,25,50,26,25,"1",0
71,37,4,25,25,30,25,"1",0
71,38,2,100,75,71,100,"-1",0
71,39,2,0,15,43,0,"1",0
71,40,3,75,75,21,75,"-1",0
71,41,3,100,47,17,100,"-1",0
71,42,3,100,40,13,100,"-1",0
71,43,4,50,40,81,50,"1",0
71,44,3,25,45,19,15,"-1",10
71,45,4,5,25,19,5,"1",0
71,46,4,0,20,45,0,"1",0
71,47,3,0,10,20,0,"1",0
71,48,2,5,10,18,5,"1",0
71,49,3,0,12,11,0,"1",0
71,50,3,0,45,38,0,"1",0
71,51,3,0,5,26,0,"1",0
72,1,5,80,25,26,80,"-1",0
72,2,5,30,45,20,30,"-1",0
72,3,2,23,1,29,1,"1",22
72,4,3,100,80,78,100,"-1",0
72,5,5,99,75,56,99,"-1",0
72,6,4,5,5,29,5,"1",0
72,7,4,75,75,45,75,"-1",0
72,8,3,10,75,75,5,"1",5
72,9,4,2,5,29,2,"1",0
72,10,5,10,75,56,10,"1",0
72,11,4,2,12,31,2,"1",0
72,12,2,5,30,78,75,"1",-70
72,13,4,10,0,22,0,"1",10
72,14,1,5,20,41,5,"1",0
72,15,1,3,10,60,3,"1",0
72,16,2,10,10,26,10,"1",0
72,17,1,1,10,43,1,"1",0
72,18,1,99,75,82,99,"-1",0
72,19,1,0,5,21,0,"1",0
72,20,1,0,2,40,0,"1",0
72,21,2,3,25,35,3,"1",0
72,22,1,5,5,60,5,"1",0
72,23,2,80,80,71,80,"-1",0
72,24,3,5,14,14,5,"1",0
72,25,3,1,15,14,1,"1",0
72,26,3,5,80,29,5,"1",0
72,27,1,0,25,45,0,"1",0
72,28,3,75,60,20,65,"-1",10
72,29,1,99,99,66,90,"-1",9
72,30,3,0,20,48,0,"1",0
72,31,3,10,5,19,10,"1",0
72,32,5,99,45,33,99,"-1",0
72,33,5,100,50,15,100,"-1",0
72,34,2,0,3,80,0,"1",0
72,35,1,1,12,17,1,"1",0
72,36,2,10,35,26,10,"1",0
72,37,4,60,60,30,25,"-1",35
72,38,2,99,99,71,99,"-1",0
72,39,2,0,50,43,0,"1",0
72,40,4,99,70,21,99,"-1",0
72,41,1,0,50,17,0,"1",0
72,42,2,0,75,13,0,"1",0
72,43,4,99,10,81,99,"-1",0
72,44,3,2,19,19,2,"1",0
72,45,4,85,75,19,85,"-1",0
72,46,3,0,45,45,0,"1",0
72,47,3,5,60,20,2,"1",3
72,48,1,1,9,18,1,"1",0
72,49,3,0,3,11,0,"1",0
72,50,2,0,50,38,0,"1",0
72,51,2,80,56,26,80,"-1",0
73,1,5,20,20,26,25,"1",-5
73,2,5,10,10,20,20,"1",-10
73,3,2,30,0,29,0,"-1",30
73,4,5,100,60,78,100,"-1",0
73,5,5,60,60,56,60,"-1",0
73,6,5,15,15,29,15,"1",0
73,7,4,10,15,45,10,"1",0
73,8,3,90,90,75,80,"-1",10
73,9,4,50,50,29,29,"-1",21
73,10,4,20,15,56,20,"1",0
73,11,4,15,15,31,20,"1",-5
73,12,2,50,56,78,80,"1",-30
73,13,4,5,0,22,0,"1",5
73,14,2,50,50,41,40,"-1",10
73,15,1,90,90,60,75,"-1",15
73,16,2,40,20,26,25,"-1",15
73,17,1,20,20,43,30,"1",-10
73,18,1,60,75,82,80,"1",-20
73,19,1,10,10,21,21,"1",-11
73,20,2,10,15,40,10,"1",0
73,21,1,70,70,35,40,"-1",30
73,22,2,30,40,60,60,"1",-30
73,23,1,80,80,71,71,"-1",9
73,24,3,10,10,14,14,"1",-4
73,25,5,25,25,14,20,"-1",5
73,26,3,100,90,29,100,"-1",0
73,27,3,40,45,45,40,"1",0
73,28,3,65,65,20,20,"-1",45
73,29,3,80,75,66,60,"-1",20
73,30,4,5,40,48,5,"1",0
73,31,3,70,65,19,30,"-1",40
73,32,4,60,40,33,60,"-1",0
73,33,3,40,40,15,15,"-1",25
73,34,3,5,10,80,50,"1",-45
73,35,1,5,5,17,15,"1",-10
73,36,2,50,50,26,26,"-1",24
73,37,5,100,99,30,40,"-1",60
73,38,2,80,80,71,70,"-1",10
73,39,2,50,50,43,40,"-1",10
73,40,5,90,80,21,90,"-1",0
73,41,3,70,55,17,20,"-1",50
73,42,3,10,15,13,10,"1",0
73,43,5,40,25,81,70,"1",-30
73,44,3,0,10,19,5,"1",-5
73,45,3,15,15,19,15,"1",0
73,46,4,40,60,45,30,"1",10
73,47,4,20,15,20,20,"0",0
73,48,3,50,50,18,25,"-1",25
73,49,4,10,12,11,10,"1",0
73,50,3,0,15,38,0,"1",0
73,51,2,0,50,26,0,"1",0
74,1,3,20,5,26,20,"1",0
74,2,5,80,10,20,80,"-1",0
74,3,5,100,35,29,100,"-1",0
74,4,5,100,95,78,100,"-1",0
74,5,3,50,50,56,50,"1",0
74,6,4,5,5,29,5,"1",0
74,7,4,100,70,45,90,"-1",10
74,8,4,100,95,75,100,"-1",0
74,9,4,10,30,29,10,"1",0
74,10,4,75,55,56,75,"-1",0
74,11,5,15,35,31,15,"1",0
74,12,3,100,95,78,100,"-1",0
74,13,5,100,30,22,100,"-1",0
74,14,3,2,25,41,2,"1",0
74,15,3,20,50,60,20,"1",0
74,16,3,5,15,26,5,"1",0
74,17,2,5,15,43,5,"1",0
74,18,2,5,75,82,5,"1",0
74,19,2,0,25,21,0,"1",0
74,20,3,100,50,40,100,"-1",0
74,21,3,30,20,35,30,"1",0
74,22,2,70,80,60,70,"-1",0
74,23,3,75,95,71,70,"-1",5
74,24,3,5,2,14,5,"1",0
74,25,1,0,10,14,0,"1",0
74,26,3,100,40,29,100,"-1",0
74,27,3,100,85,45,100,"-1",0
74,28,3,15,15,20,15,"1",0
74,29,2,10,25,66,20,"1",-10
74,30,1,0,5,48,0,"1",0
74,31,5,5,20,19,5,"1",0
74,32,5,5,90,33,5,"1",0
74,33,3,10,40,15,10,"1",0
74,34,3,1,1,80,1,"1",0
74,35,1,0,70,17,0,"1",0
74,36,3,60,60,26,60,"-1",0
74,37,4,35,20,30,35,"-1",0
74,38,3,95,95,71,95,"-1",0
74,39,4,90,50,43,90,"-1",0
74,40,5,100,80,21,100,"-1",0
74,41,3,90,90,17,90,"-1",0
74,42,3,100,90,13,100,"-1",0
74,43,3,0,10,81,0,"1",0
74,44,3,10,8,19,10,"1",0
74,45,4,90,30,19,90,"-1",0
74,46,5,100,90,45,100,"-1",0
74,47,3,3,3,20,3,"1",0
74,48,2,1,5,18,1,"1",0
74,49,5,10,5,11,10,"1",0
74,50,5,25,20,38,25,"1",0
74,51,1,0,20,26,0,"1",0
75,1,5,0,0,26,0,"1",0
75,2,5,0,30,20,0,"1",0
75,3,4,0,35,29,0,"1",0
75,4,4,100,75,78,100,"-1",0
75,5,4,50,50,56,56,"1",-6
75,6,4,25,25,29,29,"1",-4
75,7,4,0,25,45,0,"1",0
75,8,2,0,70,75,0,"1",0
75,9,4,0,25,29,0,"1",0
75,10,4,50,40,56,50,"1",0
75,11,4,10,20,31,10,"1",0
75,12,2,30,30,78,30,"1",0
75,13,4,0,10,22,0,"1",0
75,14,2,5,20,41,10,"1",-5
75,15,3,25,25,60,40,"1",-15
75,16,2,5,5,26,5,"1",0
75,17,2,10,10,43,10,"1",0
75,18,2,70,70,82,82,"1",-12
75,19,1,0,25,21,0,"1",0
75,20,2,0,10,40,0,"1",0
75,21,3,20,25,35,20,"1",0
75,22,2,50,50,60,60,"1",-10
75,23,1,60,60,71,71,"1",-11
75,24,3,5,5,14,14,"1",-9
75,25,4,50,20,14,50,"-1",0
75,26,4,100,80,29,100,"-1",0
75,27,3,50,50,45,50,"-1",0
75,28,3,19,19,20,20,"1",-1
75,29,1,99,99,66,100,"-1",-1
75,30,3,0,15,48,15,"1",-15
75,31,3,100,75,19,100,"-1",0
75,32,5,100,50,33,100,"-1",0
75,33,3,0,10,15,0,"1",0
75,34,3,0,0,80,0,"1",0
75,35,3,0,10,17,0,"1",0
75,36,2,50,50,26,26,"-1",24
75,37,5,50,50,30,30,"-1",20
75,38,1,100,100,71,100,"-1",0
75,39,3,0,30,43,0,"1",0
75,40,4,100,70,21,80,"-1",20
75,41,3,0,25,17,0,"1",0
75,42,3,25,50,13,25,"-1",0
75,43,3,90,95,81,90,"-1",0
75,44,3,10,10,19,19,"1",-9
75,45,4,10,10,19,19,"1",-9
75,46,5,100,85,45,100,"-1",0
75,47,3,10,10,20,20,"1",-10
75,48,2,5,25,18,5,"1",0
75,49,3,0,10,11,0,"1",0
75,50,3,20,35,38,20,"1",0
75,51,3,50,50,26,50,"-1",0
76,1,4,6,15,26,15,"1",-9
76,2,5,12,21,20,20,"1",-8
76,3,4,5,10,29,5,"1",0
76,4,4,100,89,78,99,"-1",1
76,5,5,1,13,56,3,"1",-2
76,6,4,68,57,29,38,"-1",30
76,7,4,70,54,45,40,"-1",30
76,8,4,90,95,75,90,"-1",0
76,9,4,7,23,29,6,"1",1
76,10,3,34,40,56,34,"1",0
76,11,4,5,23,31,15,"1",-10
76,12,3,95,95,78,78,"-1",17
76,13,4,1,10,22,5,"1",-4
76,14,2,23,23,41,35,"1",-12
76,15,3,10,25,60,20,"1",-10
76,16,2,10,25,26,21,"1",-11
76,17,1,29,30,43,35,"1",-6
76,18,2,30,32,82,50,"1",-20
76,19,1,10,27,21,10,"1",0
76,20,1,1,5,40,2,"1",-1
76,21,2,89,79,35,70,"-1",19
76,22,2,10,16,60,29,"1",-19
76,23,2,20,47,71,47,"1",-27
76,24,3,20,12,14,10,"-1",10
76,25,4,55,67,14,15,"-1",40
76,26,4,100,95,29,100,"-1",0
76,27,2,4,12,45,30,"1",-26
76,28,3,67,60,20,20,"-1",47
76,29,3,80,80,66,70,"-1",10
76,30,4,3,12,48,4,"1",-1
76,31,2,50,65,19,25,"-1",25
76,32,4,4,11,33,4,"1",0
76,33,2,1,17,15,1,"1",0
76,34,3,1,3,80,3,"1",-2
76,35,3,1,24,17,15,"1",-14
76,36,3,60,60,26,20,"-1",40
76,37,3,90,90,30,90,"-1",0
76,38,2,90,89,71,89,"-1",1
76,39,3,10,28,43,12,"1",-2
76,40,4,2,7,21,3,"1",-1
76,41,3,78,85,17,60,"-1",18
76,42,3,24,35,13,12,"-1",12
76,43,4,20,24,81,60,"1",-40
76,44,4,6,13,19,10,"1",-4
76,45,4,89,70,19,79,"-1",10
76,46,5,1,25,45,1,"1",0
76,47,5,70,20,20,70,"-1",0
76,48,3,5,12,18,13,"1",-8
76,49,3,1,5,11,2,"1",-1
76,50,3,1,5,38,1,"1",0
76,51,2,1,17,26,1,"1",0
77,1,1,10,23,26,10,"1",0
77,2,5,8,13,20,9,"1",-1
77,3,4,42,80,29,80,"-1",-38
77,4,3,70,65,78,65,"1",5
77,5,5,80,60,56,75,"-1",5
77,6,4,10,9,29,10,"1",0
77,7,4,60,40,45,60,"-1",0
77,8,3,80,87,75,80,"-1",0
77,9,4,20,12,29,20,"1",0
77,10,4,60,48,56,60,"-1",0
77,11,4,10,14,31,21,"1",-11
77,12,3,50,70,78,50,"1",0
77,13,4,19,30,22,50,"1",-31
77,14,2,25,42,41,25,"1",0
77,15,2,90,69,60,82,"-1",8
77,16,2,30,50,26,50,"-1",-20
77,17,2,20,42,43,29,"1",-9
77,18,2,98,25,82,98,"-1",0
77,19,2,15,22,21,15,"1",0
77,20,1,8,32,40,5,"1",3
77,21,2,50,40,35,50,"-1",0
77,22,1,62,64,60,60,"-1",2
77,23,2,90,80,71,90,"-1",0
77,24,2,15,15,14,15,"-1",0
77,25,4,50,24,14,50,"-1",0
77,26,3,100,74,29,100,"-1",0
77,27,3,25,14,45,50,"1",-25
77,28,3,10,20,20,20,"1",-10
77,29,2,42,74,66,60,"1",-18
77,30,4,94,34,48,94,"-1",0
77,31,2,36,49,19,15,"-1",21
77,32,5,87,56,33,87,"-1",0
77,33,3,100,43,15,100,"-1",0
77,34,3,9,13,80,15,"1",-6
77,35,1,12,36,17,12,"1",0
77,36,2,85,85,26,26,"-1",59
77,37,4,90,41,30,90,"-1",0
77,38,2,90,80,71,90,"-1",0
77,39,4,100,40,43,100,"-1",0
77,40,3,14,31,21,12,"1",2
77,41,2,50,39,17,30,"-1",20
77,42,3,20,46,13,10,"-1",10
77,43,3,6,54,81,10,"1",-4
77,44,3,10,8,19,19,"1",-9
77,45,4,42,8,19,60,"-1",-18
77,46,5,100,55,45,100,"-1",0
77,47,5,100,70,20,100,"-1",0
77,48,3,100,13,18,100,"-1",0
77,49,4,26,23,11,23,"-1",3
77,50,3,0,19,38,0,"1",0
77,51,1,0,30,26,0,"1",0
78,1,5,60,59,26,60,"-1",0
78,2,5,25,50,20,15,"-1",10
78,3,4,0,20,29,0,"1",0
78,4,4,100,50,78,100,"-1",0
78,5,5,70,72,56,60,"-1",10
78,6,3,20,25,29,25,"1",-5
78,7,3,0,45,45,0,"1",0
78,8,5,100,62,75,62,"-1",38
78,9,4,0,35,29,15,"1",-15
78,10,5,100,90,56,100,"-1",0
78,11,5,70,72,31,31,"-1",39
78,12,3,50,50,78,50,"1",0
78,13,5,0,25,22,0,"1",0
78,14,3,10,15,41,15,"1",-5
78,15,2,20,40,60,50,"1",-30
78,16,2,0,50,26,15,"1",-15
78,17,2,50,60,43,43,"-1",7
78,18,2,20,25,82,50,"1",-30
78,19,1,0,32,21,0,"1",0
78,20,1,0,35,40,0,"1",0
78,21,2,30,35,35,35,"1",-5
78,22,1,60,65,60,60,"0",0
78,23,2,30,35,71,71,"1",-41
78,24,3,10,10,14,10,"1",0
78,25,3,0,20,14,0,"1",0
78,26,3,60,30,29,30,"-1",30
78,27,1,0,25,45,5,"1",-5
78,28,3,50,50,20,20,"-1",30
78,29,2,70,60,66,66,"-1",4
78,30,2,0,12,48,0,"1",0
78,31,3,10,12,19,10,"1",0
78,32,5,0,20,33,0,"1",0
78,33,3,100,60,15,15,"-1",85
78,34,3,10,15,80,15,"1",-5
78,35,4,60,65,17,65,"-1",-5
78,36,2,5,20,26,15,"1",-10
78,37,3,50,50,30,30,"-1",20
78,38,1,100,100,71,71,"-1",29
78,39,1,0,15,43,0,"1",0
78,40,5,100,60,21,100,"-1",0
78,41,3,2,10,17,2,"1",0
78,42,3,12,25,13,12,"1",0
78,43,3,60,70,81,60,"1",0
78,44,3,0,35,19,0,"1",0
78,45,5,100,23,19,100,"-1",0
78,46,3,0,20,45,0,"1",0
78,47,3,0,10,20,0,"1",0
78,48,2,1,10,18,1,"1",0
78,49,3,0,22,11,0,"1",0
78,50,1,0,35,38,0,"1",0
78,51,3,0,20,26,0,"1",0
79,1,3,0,0,26,28,"1",-28
79,2,2,20,20,20,20,"0",0
79,3,4,0,25,29,0,"1",0
79,4,4,5,50,78,80,"1",-75
79,5,4,20,60,56,30,"1",-10
79,6,4,75,23,29,75,"-1",0
79,7,4,80,85,45,75,"-1",5
79,8,3,25,26,75,60,"1",-35
79,9,4,10,10,29,25,"1",-15
79,10,2,45,70,56,0,"1",45
79,11,4,4,10,31,35,"1",-31
79,12,2,0,89,78,35,"1",-35
79,13,5,5,3,22,15,"1",-10
79,14,2,25,25,41,45,"1",-20
79,15,2,80,75,60,75,"-1",5
79,16,2,15,20,26,25,"1",-10
79,17,2,85,65,43,48,"-1",37
79,18,2,4,5,82,75,"1",-71
79,19,1,35,23,21,22,"-1",13
79,20,1,0,28,40,25,"1",-25
79,21,2,85,55,35,45,"-1",40
79,22,1,50,50,60,65,"1",-15
79,23,1,60,60,71,75,"1",-15
79,24,3,33,33,14,15,"-1",18
79,25,3,0,35,14,0,"1",0
79,26,4,100,98,29,100,"-1",0
79,27,3,85,90,45,75,"-1",10
79,28,3,34,34,20,20,"-1",14
79,29,2,50,50,66,66,"1",-16
79,30,3,0,32,48,52,"1",-52
79,31,2,2,5,19,20,"1",-18
79,32,5,0,20,33,0,"1",0
79,33,3,0,0,15,0,"1",0
79,34,3,35,45,80,76,"1",-41
79,35,4,75,85,17,20,"-1",55
79,36,1,5,34,26,26,"1",-21
79,37,4,95,85,30,75,"-1",20
79,38,2,100,100,71,80,"-1",20
79,39,3,64,58,43,45,"-1",19
79,40,3,0,65,21,0,"1",0
79,41,3,99,25,17,75,"-1",24
79,42,3,90,75,13,76,"-1",14
79,43,3,4,5,81,90,"1",-86
79,44,3,35,35,19,35,"-1",0
79,45,4,75,65,19,35,"-1",40
79,46,4,100,50,45,100,"-1",0
79,47,5,10,4,20,30,"1",-20
79,48,2,10,25,18,20,"1",-10
79,49,5,66,65,11,25,"-1",41
79,50,5,15,25,38,15,"1",0
79,51,2,2,45,26,28,"1",-26
80,1,2,50,45,26,44,"-1",6
80,2,4,50,50,20,50,"-1",0
80,3,3,0,50,29,0,"1",0
80,4,2,99,95,78,99,"-1",0
80,5,4,99,95,56,95,"-1",4
80,6,3,40,30,29,45,"-1",-5
80,7,3,50,65,45,50,"-1",0
80,8,4,5,5,75,50,"1",-45
80,9,4,0,10,29,0,"1",0
80,10,4,100,100,56,100,"-1",0
80,11,4,5,45,31,15,"1",-10
80,12,3,100,99,78,99,"-1",1
80,13,4,0,2,22,0,"1",0
80,14,1,50,20,41,40,"-1",10
80,15,1,65,30,60,70,"-1",-5
80,16,2,50,50,26,50,"-1",0
80,17,2,15,35,43,35,"1",-20
80,18,1,85,50,82,85,"-1",0
80,19,1,0,50,21,0,"1",0
80,20,1,2,2,40,2,"1",0
80,21,2,40,40,35,40,"-1",0
80,22,1,50,50,60,50,"1",0
80,23,2,100,95,71,100,"-1",0
80,24,3,30,50,14,25,"-1",5
80,25,3,80,50,14,20,"-1",60
80,26,4,100,100,29,100,"-1",0
80,27,3,15,80,45,20,"1",-5
80,28,3,30,40,20,20,"-1",10
80,29,1,99,99,66,95,"-1",4
80,30,3,15,30,48,15,"1",0
80,31,2,50,60,19,30,"-1",20
80,32,3,0,0,33,0,"1",0
80,33,3,75,5,15,50,"-1",25
80,34,2,15,15,80,15,"1",0
80,35,3,95,80,17,95,"-1",0
80,36,3,5,5,26,15,"1",-10
80,37,5,50,50,30,50,"-1",0
80,38,2,75,75,71,75,"-1",0
80,39,3,95,50,43,95,"-1",0
80,40,4,95,95,21,95,"-1",0
80,41,3,15,20,17,5,"1",10
80,42,3,100,100,13,13,"-1",87
80,43,4,20,20,81,50,"1",-30
80,44,3,5,20,19,20,"1",-15
80,45,3,90,50,19,50,"-1",40
80,46,3,0,50,45,0,"1",0
80,47,3,0,5,20,0,"1",0
80,48,3,0,1,18,1,"1",-1
80,49,3,0,2,11,0,"1",0
80,50,3,0,20,38,0,"1",0
80,51,3,0,10,26,0,"1",0
81,1,5,20,20,26,20,"1",0
81,2,5,20,20,20,20,"0",0
81,3,2,20,0,29,0,"1",20
81,4,3,99,99,78,99,"-1",0
81,5,5,99,80,56,99,"-1",0
81,6,4,10,10,29,10,"1",0
81,7,3,99,99,45,99,"-1",0
81,8,3,10,90,75,10,"1",0
81,9,2,0,5,29,0,"1",0
81,10,4,10,10,56,10,"1",0
81,11,4,10,10,31,20,"1",-10
81,12,3,99,20,78,99,"-1",0
81,13,5,10,0,22,0,"1",10
81,14,2,99,90,41,99,"-1",0
81,15,2,80,80,60,80,"-1",0
81,16,2,10,0,26,0,"1",10
81,17,1,50,50,43,50,"-1",0
81,18,1,10,10,82,10,"1",0
81,19,1,5,50,21,5,"1",0
81,20,1,0,10,40,0,"1",0
81,21,2,50,50,35,50,"-1",0
81,22,1,99,99,60,99,"-1",0
81,23,1,99,40,71,99,"-1",0
81,24,3,40,40,14,40,"-1",0
81,25,1,0,50,14,0,"1",0
81,26,5,99,99,29,99,"-1",0
81,27,2,0,5,45,5,"1",-5
81,28,3,10,10,20,10,"1",0
81,29,1,99,99,66,99,"-1",0
81,30,3,0,5,48,0,"1",0
81,31,1,99,80,19,0,"-1",99
81,32,4,90,20,33,90,"-1",0
81,33,5,100,50,15,100,"-1",0
81,34,3,0,0,80,0,"1",0
81,35,1,0,80,17,0,"1",0
81,36,2,10,10,26,10,"1",0
81,37,3,99,60,30,99,"-1",0
81,38,1,99,99,71,99,"-1",0
81,39,1,0,10,43,0,"1",0
81,40,5,99,50,21,99,"-1",0
81,41,5,99,80,17,99,"-1",0
81,42,3,99,60,13,99,"-1",0
81,43,1,0,10,81,0,"1",0
81,44,3,0,10,19,0,"1",0
81,45,3,0,5,19,0,"1",0
81,46,4,0,50,45,0,"1",0
81,47,4,99,40,20,99,"-1",0
81,48,1,0,10,18,0,"1",0
81,49,3,50,30,11,50,"-1",0
81,50,3,0,10,38,0,"1",0
81,51,3,0,10,26,0,"1",0
82,1,2,20,20,26,15,"1",5
82,2,4,30,40,20,20,"-1",10
82,3,4,40,5,29,5,"-1",35
82,4,2,80,75,78,80,"-1",0
82,5,2,95,85,56,95,"-1",0
82,6,4,5,10,29,5,"1",0
82,7,5,70,65,45,70,"-1",0
82,8,3,80,75,75,80,"-1",0
82,9,5,5,25,29,10,"1",-5
82,10,5,80,80,56,50,"-1",30
82,11,5,100,55,31,100,"-1",0
82,12,2,50,70,78,70,"1",-20
82,13,4,15,5,22,5,"1",10
82,14,2,65,65,41,40,"-1",25
82,15,1,25,40,60,35,"1",-10
82,16,1,30,30,26,30,"-1",0
82,17,2,65,85,43,40,"-1",25
82,18,1,10,15,82,50,"1",-40
82,19,2,10,20,21,10,"1",0
82,20,1,1,5,40,1,"1",0
82,21,1,12,12,35,30,"1",-18
82,22,1,80,75,60,70,"-1",10
82,23,2,90,88,71,80,"-1",10
82,24,3,50,40,14,10,"-1",40
82,25,4,100,80,14,100,"-1",0
82,26,5,100,90,29,100,"-1",0
82,27,3,2,3,45,20,"1",-18
82,28,3,50,45,20,20,"-1",30
82,29,1,90,90,66,80,"-1",10
82,30,4,20,30,48,40,"1",-20
82,31,4,75,65,19,15,"-1",60
82,32,5,1,4,33,1,"1",0
82,33,3,10,25,15,10,"1",0
82,34,3,1,2,80,2,"1",-1
82,35,2,4,10,17,1,"1",3
82,36,3,10,60,26,10,"1",0
82,37,4,78,78,30,70,"-1",8
82,38,2,90,90,71,70,"-1",20
82,39,3,85,65,43,75,"-1",10
82,40,4,45,75,21,15,"-1",30
82,41,3,10,40,17,20,"1",-10
82,42,3,50,60,13,20,"-1",30
82,43,3,70,75,81,85,"1",-15
82,44,3,10,10,19,10,"1",0
82,45,4,75,75,19,15,"-1",60
82,46,4,75,90,45,40,"-1",35
82,47,4,70,40,20,70,"-1",0
82,48,2,20,35,18,15,"-1",5
82,49,4,20,55,11,10,"-1",10
82,50,2,1,5,38,1,"1",0
82,51,3,50,50,26,25,"-1",25
83,1,4,1,12,26,2,"1",-1
83,2,5,5,15,20,7,"1",-2
83,3,4,25,5,29,5,"1",20
83,4,5,100,75,78,100,"-1",0
83,5,2,35,55,56,35,"1",0
83,6,4,10,25,29,10,"1",0
83,7,4,80,45,45,80,"-1",0
83,8,3,75,95,75,60,"0",15
83,9,4,9,45,29,5,"1",4
83,10,4,85,75,56,80,"-1",5
83,11,5,15,30,31,15,"1",0
83,12,2,5,30,78,15,"1",-10
83,13,5,35,20,22,15,"-1",20
83,14,1,15,35,41,18,"1",-3
83,15,1,10,30,60,35,"1",-25
83,16,1,20,5,26,6,"1",14
83,17,2,15,65,43,5,"1",10
83,18,1,60,65,82,70,"1",-10
83,19,1,0,15,21,0,"1",0
83,20,2,30,40,40,30,"1",0
83,21,5,75,70,35,55,"-1",20
83,22,2,10,70,60,5,"1",5
83,23,1,60,65,71,65,"1",-5
83,24,3,5,20,14,3,"1",2
83,25,3,40,35,14,20,"-1",20
83,26,3,85,65,29,80,"-1",5
83,27,1,65,85,45,30,"-1",35
83,28,3,45,75,20,35,"-1",10
83,29,2,25,55,66,40,"1",-15
83,30,2,5,25,48,6,"1",-1
83,31,1,85,60,19,75,"-1",10
83,32,5,60,40,33,70,"-1",-10
83,33,4,95,85,15,20,"-1",75
83,34,2,5,30,80,20,"1",-15
83,35,1,2,20,17,1,"1",1
83,36,2,35,45,26,20,"-1",15
83,37,4,80,65,30,60,"-1",20
83,38,2,10,25,71,30,"1",-20
83,39,2,35,55,43,30,"1",5
83,40,4,100,65,21,100,"-1",0
83,41,1,1,45,17,1,"1",0
83,42,3,35,20,13,30,"-1",5
83,43,4,70,60,81,75,"1",-5
83,44,3,5,25,19,5,"1",0
83,45,4,40,45,19,45,"-1",-5
83,46,4,2,32,45,2,"1",0
83,47,2,15,55,20,2,"1",13
83,48,2,10,30,18,5,"1",5
83,49,3,2,25,11,1,"1",1
83,50,3,2,32,38,2,"1",0
83,51,2,45,65,26,10,"-1",35
84,1,2,50,30,26,30,"-1",20
84,2,5,5,5,20,5,"1",0
84,3,3,1,1,29,1,"1",0
84,4,4,99,90,78,99,"-1",0
84,5,5,70,70,56,60,"-1",10
84,6,4,30,20,29,30,"-1",0
84,7,4,20,20,45,20,"1",0
84,8,4,70,70,75,75,"1",-5
84,9,4,90,50,29,90,"-1",0
84,10,5,90,70,56,90,"-1",0
84,11,4,10,20,31,10,"1",0
84,12,3,90,90,78,90,"-1",0
84,13,4,0,15,22,0,"1",0
84,14,2,50,40,41,50,"-1",0
84,15,2,90,50,60,90,"-1",0
84,16,2,70,30,26,60,"-1",10
84,17,2,50,50,43,40,"-1",10
84,18,1,50,50,82,50,"1",0
84,19,2,90,50,21,80,"-1",10
84,20,1,5,5,40,5,"1",0
84,21,3,70,50,35,70,"-1",0
84,22,2,90,90,60,90,"-1",0
84,23,2,90,90,71,90,"-1",0
84,24,3,10,10,14,14,"1",-4
84,25,4,80,60,14,80,"-1",0
84,26,4,90,60,29,90,"-1",0
84,27,2,40,20,45,60,"1",-20
84,28,3,10,10,20,20,"1",-10
84,29,1,90,80,66,75,"-1",15
84,30,3,20,10,48,40,"1",-20
84,31,2,20,50,19,20,"-1",0
84,32,4,1,50,33,1,"1",0
84,33,3,90,50,15,90,"-1",0
84,34,2,20,20,80,40,"1",-20
84,35,1,1,10,17,1,"1",0
84,36,4,90,90,26,50,"-1",40
84,37,4,20,20,30,30,"1",-10
84,38,3,99,90,71,99,"-1",0
84,39,3,0,50,43,0,"1",0
84,40,4,1,5,21,2,"1",-1
84,41,3,50,50,17,30,"-1",20
84,42,3,60,15,13,20,"-1",40
84,43,4,50,50,81,50,"1",0
84,44,3,10,10,19,19,"1",-9
84,45,5,10,20,19,15,"1",-5
84,46,4,10,10,45,20,"1",-10
84,47,2,0,10,20,1,"1",-1
84,48,2,5,10,18,10,"1",-5
84,49,4,1,20,11,1,"1",0
84,50,3,5,5,38,5,"1",0
84,51,3,50,50,26,26,"-1",24
85,1,5,30,20,26,30,"-1",0
85,2,5,20,50,20,30,"0",-10
85,3,2,50,10,29,10,"-1",40
85,4,3,70,10,78,90,"1",-20
85,5,5,30,60,56,40,"1",-10
85,6,4,30,40,29,30,"-1",0
85,7,5,95,30,45,95,"-1",0
85,8,5,100,60,75,100,"-1",0
85,9,4,20,30,29,20,"1",0
85,10,5,20,50,56,30,"1",-10
85,11,5,50,30,31,50,"-1",0
85,12,2,40,60,78,60,"1",-20
85,13,4,30,10,22,5,"-1",25
85,14,1,20,30,41,20,"1",0
85,15,1,60,40,60,60,"0",0
85,16,2,10,10,26,10,"1",0
85,17,1,20,30,43,20,"1",0
85,18,2,60,40,82,60,"1",0
85,19,1,70,30,21,60,"-1",10
85,20,3,60,60,40,50,"-1",10
85,21,1,80,80,35,70,"-1",10
85,22,1,50,60,60,40,"1",10
85,23,2,70,85,71,70,"1",0
85,24,3,20,20,14,14,"-1",6
85,25,3,30,50,14,20,"-1",10
85,26,4,80,80,29,80,"-1",0
85,27,3,25,30,45,30,"1",-5
85,28,3,70,70,20,40,"-1",30
85,29,3,60,60,66,60,"1",0
85,30,4,20,30,48,30,"1",-10
85,31,2,20,40,19,20,"-1",0
85,32,3,100,60,33,100,"-1",0
85,33,3,20,15,15,20,"-1",0
85,34,2,20,40,80,20,"1",0
85,35,2,20,70,17,10,"-1",10
85,36,2,60,60,26,40,"-1",20
85,37,4,70,80,30,20,"-1",50
85,38,2,90,90,71,80,"-1",10
85,39,1,0,60,43,0,"1",0
85,40,4,20,30,21,20,"1",0
85,41,4,50,80,17,40,"-1",10
85,42,3,80,80,13,20,"-1",60
85,43,5,60,20,81,80,"1",-20
85,44,3,20,30,19,19,"-1",1
85,45,4,30,60,19,20,"-1",10
85,46,4,80,70,45,80,"-1",0
85,47,4,50,40,20,30,"-1",20
85,48,3,20,30,18,20,"-1",0
85,49,3,5,30,11,4,"1",1
85,50,3,10,50,38,15,"1",-5
85,51,1,0,5,26,0,"1",0
86,1,5,99,70,26,99,"-1",0
86,2,5,50,49,20,30,"-1",20
86,3,3,40,0,29,0,"-1",40
86,4,1,0,90,78,0,"1",0
86,5,5,50,50,56,50,"1",0
86,6,5,50,12,29,50,"-1",0
86,7,3,0,30,45,0,"1",0
86,8,3,0,0,75,0,"1",0
86,9,2,0,12,29,0,"1",0
86,10,3,0,30,56,0,"1",0
86,11,5,20,50,31,20,"1",0
86,12,3,100,71,78,100,"-1",0
86,13,3,30,0,22,0,"-1",30
86,14,1,0,30,41,0,"1",0
86,15,1,0,15,60,0,"1",0
86,16,1,5,0,26,0,"1",5
86,17,2,0,40,43,0,"1",0
86,18,1,50,90,82,82,"1",-32
86,19,2,0,20,21,0,"1",0
86,20,1,0,0,40,0,"1",0
86,21,2,0,30,35,0,"1",0
86,22,1,70,70,60,60,"-1",10
86,23,3,0,20,71,0,"1",0
86,24,3,0,30,14,0,"1",0
86,25,1,20,60,14,14,"-1",6
86,26,5,100,48,29,100,"-1",0
86,27,3,0,5,45,0,"1",0
86,28,3,50,50,20,20,"-1",30
86,29,3,99,99,66,99,"-1",0
86,30,2,100,50,48,100,"-1",0
86,31,1,99,50,19,0,"-1",99
86,32,5,100,100,33,100,"-1",0
86,33,3,99,20,15,99,"-1",0
86,34,3,0,70,80,0,"1",0
86,35,3,50,50,17,50,"-1",0
86,36,2,0,50,26,0,"1",0
86,37,5,70,70,30,30,"-1",40
86,38,1,99,90,71,60,"-1",39
86,39,1,0,20,43,0,"1",0
86,40,5,100,100,21,100,"-1",0
86,41,2,99,15,17,99,"-1",0
86,42,3,0,12,13,0,"1",0
86,43,1,0,12,81,0,"1",0
86,44,3,0,12,19,0,"1",0
86,45,3,0,60,19,0,"1",0
86,46,3,99,50,45,99,"-1",0
86,47,3,99,67,20,99,"-1",0
86,48,2,0,20,18,0,"1",0
86,49,1,0,5,11,0,"1",0
86,50,5,0,65,38,0,"1",0
86,51,3,0,70,26,0,"1",0
87,1,5,45,12,26,60,"-1",-15
87,2,5,0,5,20,24,"1",-24
87,3,5,34,25,29,25,"-1",9
87,4,4,100,84,78,100,"-1",0
87,5,5,30,23,56,55,"1",-25
87,6,5,14,22,29,17,"1",-3
87,7,4,0,50,45,0,"1",0
87,8,4,100,80,75,100,"-1",0
87,9,4,100,23,29,85,"-1",15
87,10,5,10,75,56,5,"1",5
87,11,5,23,15,31,25,"1",-2
87,12,3,100,100,78,100,"-1",0
87,13,5,20,15,22,15,"1",5
87,14,1,35,42,41,35,"1",0
87,15,3,60,35,60,60,"0",0
87,16,2,34,0,26,0,"-1",34
87,17,1,60,60,43,45,"-1",15
87,18,1,100,38,82,100,"-1",0
87,19,2,15,60,21,10,"1",5
87,20,2,0,18,40,0,"1",0
87,21,3,70,65,35,40,"-1",30
87,22,1,80,90,60,65,"-1",15
87,23,2,85,85,71,70,"-1",15
87,24,3,6,6,14,14,"1",-8
87,25,4,62,28,14,52,"-1",10
87,26,3,100,87,29,100,"-1",0
87,27,2,22,22,45,31,"1",-9
87,28,3,21,21,20,20,"-1",1
87,29,1,99,78,66,99,"-1",0
87,30,5,100,35,48,100,"-1",0
87,31,4,70,35,19,45,"-1",25
87,32,5,100,15,33,100,"-1",0
87,33,3,100,45,15,100,"-1",0
87,34,3,100,55,80,100,"-1",0
87,35,1,0,12,17,0,"1",0
87,36,2,80,67,26,75,"-1",5
87,37,4,65,65,30,30,"-1",35
87,38,3,86,86,71,71,"-1",15
87,39,3,67,33,43,67,"-1",0
87,40,4,0,14,21,0,"1",0
87,41,2,0,45,17,15,"1",-15
87,42,5,100,100,13,100,"-1",0
87,43,5,0,10,81,45,"1",-45
87,44,3,10,10,19,19,"1",-9
87,45,3,10,14,19,10,"1",0
87,46,4,0,55,45,0,"1",0
87,47,4,100,40,20,100,"-1",0
87,48,4,40,24,18,30,"-1",10
87,49,5,0,10,11,0,"1",0
87,50,5,40,18,38,40,"-1",0
87,51,3,10,23,26,10,"1",0
88,1,2,50,60,26,30,"-1",20
88,2,5,40,20,20,35,"-1",5
88,3,4,35,30,29,30,"-1",5
88,4,4,100,100,78,100,"-1",0
88,5,4,100,70,56,95,"-1",5
88,6,4,30,45,29,30,"-1",0
88,7,3,30,45,45,40,"1",-10
88,8,3,20,55,75,25,"1",-5
88,9,5,55,70,29,40,"-1",15
88,10,4,40,45,56,50,"1",-10
88,11,4,40,35,31,30,"-1",10
88,12,3,100,100,78,100,"-1",0
88,13,4,25,5,22,15,"-1",10
88,14,2,50,45,41,45,"-1",5
88,15,1,30,37,60,30,"1",0
88,16,2,3,5,26,13,"1",-10
88,17,2,65,75,43,50,"-1",15
88,18,2,65,60,82,70,"1",-5
88,19,2,10,35,21,20,"1",-10
88,20,2,25,15,40,25,"1",0
88,21,2,55,45,35,40,"-1",15
88,22,1,60,40,60,60,"0",0
88,23,2,50,65,71,65,"1",-15
88,24,3,5,5,14,10,"1",-5
88,25,4,80,75,14,80,"-1",0
88,26,3,80,78,29,80,"-1",0
88,27,3,45,40,45,45,"0",0
88,28,3,22,22,20,20,"-1",2
88,29,2,15,30,66,25,"1",-10
88,30,3,35,30,48,50,"1",-15
88,31,2,35,40,19,25,"-1",10
88,32,4,40,45,33,35,"-1",5
88,33,3,20,55,15,22,"-1",-2
88,34,3,65,55,80,70,"1",-5
88,35,3,44,60,17,25,"-1",19
88,36,2,50,70,26,45,"-1",5
88,37,4,100,90,30,70,"-1",30
88,38,2,100,90,71,80,"-1",20
88,39,3,25,33,43,38,"1",-13
88,40,5,100,66,21,100,"-1",0
88,41,3,40,70,17,25,"-1",15
88,42,3,60,70,13,50,"-1",10
88,43,3,40,60,81,70,"1",-30
88,44,3,20,15,19,20,"-1",0
88,45,3,40,55,19,25,"-1",15
88,46,2,10,55,45,10,"1",0
88,47,1,0,5,20,0,"1",0
88,48,3,50,25,18,25,"-1",25
88,49,4,0,75,11,0,"1",0
88,50,3,15,25,38,28,"1",-13
88,51,3,15,70,26,20,"1",-5
89,1,2,30,30,26,30,"-1",0
89,2,5,20,20,20,20,"0",0
89,3,4,14,0,29,10,"1",4
89,4,5,100,100,78,100,"-1",0
89,5,5,30,30,56,30,"1",0
89,6,4,30,30,29,29,"-1",1
89,7,5,99,53,45,99,"-1",0
89,8,3,60,60,75,60,"1",0
89,9,4,75,38,29,60,"-1",15
89,10,4,45,45,56,45,"1",0
89,11,4,10,13,31,20,"1",-10
89,12,3,85,85,78,78,"-1",7
89,13,5,10,0,22,10,"1",0
89,14,2,100,100,41,100,"-1",0
89,15,2,40,40,60,40,"1",0
89,16,2,10,10,26,10,"1",0
89,17,1,10,20,43,10,"1",0
89,18,1,60,60,82,70,"1",-10
89,19,1,0,34,21,0,"1",0
89,20,1,0,35,40,0,"1",0
89,21,3,90,90,35,90,"-1",0
89,22,1,80,80,60,70,"-1",10
89,23,2,90,90,71,90,"-1",0
89,24,3,30,30,14,14,"-1",16
89,25,4,20,20,14,14,"-1",6
89,26,3,100,90,29,90,"-1",10
89,27,2,25,45,45,25,"1",0
89,28,3,30,30,20,20,"-1",10
89,29,2,60,60,66,66,"1",-6
89,30,4,10,10,48,10,"1",0
89,31,2,15,15,19,15,"1",0
89,32,5,100,28,33,100,"-1",0
89,33,3,45,45,15,35,"-1",10
89,34,2,80,80,80,80,"0",0
89,35,2,10,10,17,10,"1",0
89,36,2,60,60,26,26,"-1",34
89,37,4,35,35,30,30,"-1",5
89,38,3,85,85,71,85,"-1",0
89,39,3,70,60,43,60,"-1",10
89,40,4,20,20,21,20,"1",0
89,41,2,0,20,17,0,"1",0
89,42,3,10,40,13,10,"1",0
89,43,4,20,20,81,40,"1",-20
89,44,3,0,23,19,0,"1",0
89,45,4,15,13,19,19,"1",-4
89,46,5,100,80,45,100,"-1",0
89,47,4,25,25,20,19,"-1",6
89,48,2,25,30,18,25,"-1",0
89,49,4,25,25,11,10,"-1",15
89,50,4,60,60,38,60,"-1",0
89,51,3,0,45,26,0,"1",0
90,1,2,10,15,26,10,"1",0
90,2,5,35,20,20,25,"-1",10
90,3,4,55,10,29,10,"-1",45
90,4,4,75,25,78,75,"1",0
90,5,4,75,60,56,80,"-1",-5
90,6,4,20,55,29,10,"1",10
90,7,4,90,80,45,90,"-1",0
90,8,4,60,85,75,70,"1",-10
90,9,4,70,40,29,70,"-1",0
90,10,4,80,90,56,75,"-1",5
90,11,4,40,55,31,30,"-1",10
90,12,3,95,80,78,85,"-1",10
90,13,5,15,30,22,25,"1",-10
90,14,2,60,65,41,40,"-1",20
90,15,1,25,30,60,30,"1",-5
90,16,2,40,10,26,10,"-1",30
90,17,2,30,85,43,40,"1",-10
90,18,2,20,50,82,20,"1",0
90,19,2,30,70,21,25,"-1",5
90,20,2,75,55,40,70,"-1",5
90,21,2,30,50,35,25,"1",5
90,22,1,40,75,60,40,"1",0
90,23,2,30,70,71,35,"1",-5
90,24,3,20,20,14,15,"-1",5
90,25,4,30,40,14,25,"-1",5
90,26,3,95,95,29,95,"-1",0
90,27,2,60,55,45,60,"-1",0
90,28,3,65,75,20,40,"-1",25
90,29,3,20,45,66,30,"1",-10
90,30,4,10,40,48,15,"1",-5
90,31,4,10,70,19,10,"1",0
90,32,4,10,20,33,10,"1",0
90,33,3,50,20,15,35,"-1",15
90,34,3,75,75,80,75,"1",0
90,35,1,40,60,17,25,"-1",15
90,36,2,5,20,26,5,"1",0
90,37,5,95,60,30,95,"-1",0
90,38,3,100,90,71,95,"-1",5
90,39,3,65,55,43,60,"-1",5
90,40,4,25,35,21,25,"-1",0
90,41,2,30,80,17,30,"-1",0
90,42,3,55,85,13,40,"-1",15
90,43,3,5,15,81,10,"1",-5
90,44,3,40,30,19,10,"-1",30
90,45,4,15,40,19,10,"1",5
90,46,5,30,30,45,35,"1",-5
90,47,5,1,20,20,5,"1",-4
90,48,4,75,60,18,60,"-1",15
90,49,5,15,25,11,15,"-1",0
90,50,5,10,20,38,15,"1",-5
90,51,3,30,40,26,30,"-1",0
91,1,5,10,10,26,10,"1",0
91,2,5,0,90,20,10,"1",-10
91,3,3,25,0,29,0,"1",25
91,4,3,50,50,78,78,"1",-28
91,5,5,30,30,56,40,"1",-10
91,6,4,40,40,29,29,"-1",11
91,7,4,0,50,45,10,"1",-10
91,8,4,50,75,75,50,"1",0
91,9,3,5,5,29,5,"1",0
91,10,3,60,60,56,56,"-1",4
91,11,3,30,40,31,30,"1",0
91,12,3,1,10,78,5,"1",-4
91,13,4,5,0,22,0,"1",5
91,14,2,10,10,41,20,"1",-10
91,15,3,30,20,60,40,"1",-10
91,16,2,4,0,26,1,"1",3
91,17,2,5,30,43,5,"1",0
91,18,2,60,50,82,70,"1",-10
91,19,1,0,20,21,0,"1",0
91,20,2,0,5,40,0,"1",0
91,21,3,60,60,35,40,"-1",20
91,22,1,30,45,60,35,"1",-5
91,23,1,50,80,71,71,"1",-21
91,24,3,30,30,14,14,"-1",16
91,25,3,10,25,14,5,"1",5
91,26,3,20,75,29,15,"1",5
91,27,1,0,70,45,0,"1",0
91,28,3,5,5,20,20,"1",-15
91,29,2,10,50,66,10,"1",0
91,30,4,100,40,48,100,"-1",0
91,31,2,100,75,19,10,"-1",90
91,32,3,80,50,33,80,"-1",0
91,33,5,100,50,15,100,"-1",0
91,34,3,50,50,80,60,"1",-10
91,35,3,50,50,17,40,"-1",10
91,36,2,0,60,26,0,"1",0
91,37,4,75,75,30,70,"-1",5
91,38,3,100,100,71,100,"-1",0
91,39,1,0,70,43,0,"1",0
91,40,3,0,50,21,0,"1",0
91,41,3,2,75,17,2,"1",0
91,42,2,1,50,13,1,"1",0
91,43,3,50,30,81,50,"1",0
91,44,3,10,40,19,19,"1",-9
91,45,5,0,5,19,0,"1",0
91,46,3,0,40,45,0,"1",0
91,47,3,0,10,20,0,"1",0
91,48,1,0,5,18,0,"1",0
91,49,3,0,5,11,0,"1",0
91,50,2,0,5,38,0,"1",0
91,51,2,0,50,26,0,"1",0
92,1,5,10,5,26,26,"1",-16
92,2,5,10,20,20,10,"1",0
92,3,4,50,40,29,29,"-1",21
92,4,4,80,80,78,80,"-1",0
92,5,5,90,70,56,100,"-1",-10
92,6,3,30,35,29,30,"-1",0
92,7,4,10,50,45,15,"1",-5
92,8,4,90,80,75,90,"-1",0
92,9,5,60,50,29,50,"-1",10
92,10,4,50,30,56,60,"1",-10
92,11,5,60,30,31,61,"-1",-1
92,12,3,0,60,78,0,"1",0
92,13,4,20,10,22,15,"1",5
92,14,1,50,40,41,50,"-1",0
92,15,2,40,30,60,40,"1",0
92,16,3,20,40,26,30,"1",-10
92,17,1,30,30,43,35,"1",-5
92,18,1,60,50,82,80,"1",-20
92,19,1,5,20,21,5,"1",0
92,20,1,0,50,40,0,"1",0
92,21,2,80,80,35,60,"-1",20
92,22,1,80,80,60,60,"-1",20
92,23,2,60,70,71,60,"1",0
92,24,3,2,2,14,14,"1",-12
92,25,5,80,50,14,80,"-1",0
92,26,3,100,80,29,100,"-1",0
92,27,2,50,40,45,45,"-1",5
92,28,3,50,50,20,20,"-1",30
92,29,3,90,90,66,66,"-1",24
92,30,4,5,40,48,10,"1",-5
92,31,2,90,50,19,80,"-1",10
92,32,5,0,20,33,0,"1",0
92,33,3,15,50,15,5,"0",10
92,34,3,35,25,80,80,"1",-45
92,35,1,0,10,17,0,"1",0
92,36,3,90,90,26,26,"-1",64
92,37,4,90,90,30,50,"-1",40
92,38,2,90,90,71,71,"-1",19
92,39,3,2,30,43,2,"1",0
92,40,5,50,20,21,40,"-1",10
92,41,2,100,30,17,100,"-1",0
92,42,3,100,70,13,100,"-1",0
92,43,4,80,75,81,80,"1",0
92,44,3,1,5,19,3,"1",-2
92,45,5,95,80,19,80,"-1",15
92,46,5,90,70,45,90,"-1",0
92,47,3,25,25,20,20,"-1",5
92,48,4,75,75,18,50,"-1",25
92,49,3,5,20,11,8,"1",-3
92,50,4,90,60,38,80,"-1",10
92,51,2,15,20,26,15,"1",0
93,1,2,1,1,26,26,"1",-25
93,2,5,0,13,20,0,"1",0
93,3,1,0,40,29,0,"1",0
93,4,3,100,70,78,100,"-1",0
93,5,5,12,26,56,20,"1",-8
93,6,2,20,20,29,29,"1",-9
93,7,5,0,14,45,0,"1",0
93,8,3,100,43,75,100,"-1",0
93,9,4,0,15,29,0,"1",0
93,10,4,50,60,56,50,"1",0
93,11,4,0,15,31,0,"1",0
93,12,2,100,70,78,100,"-1",0
93,13,2,0,11,22,0,"1",0
93,14,2,11,12,41,11,"1",0
93,15,2,30,30,60,60,"1",-30
93,16,2,0,23,26,0,"1",0
93,17,2,0,11,43,0,"1",0
93,18,2,20,20,82,50,"1",-30
93,19,2,100,40,21,100,"-1",0
93,20,2,100,50,40,100,"-1",0
93,21,3,20,20,35,20,"1",0
93,22,2,80,80,60,80,"-1",0
93,23,2,34,34,71,71,"1",-37
93,24,3,11,11,14,14,"1",-3
93,25,4,100,60,14,100,"-1",0
93,26,3,100,80,29,100,"-1",0
93,27,3,30,30,45,30,"1",0
93,28,3,50,50,20,20,"-1",30
93,29,4,75,75,66,75,"-1",0
93,30,3,100,23,48,100,"-1",0
93,31,2,70,70,19,70,"-1",0
93,32,5,0,13,33,0,"1",0
93,33,2,0,40,15,0,"1",0
93,34,3,0,30,80,0,"1",0
93,35,1,0,30,17,0,"1",0
93,36,2,14,14,26,26,"1",-12
93,37,3,50,50,30,50,"-1",0
93,38,3,0,14,71,0,"1",0
93,39,3,0,11,43,0,"1",0
93,40,4,70,70,21,70,"-1",0
93,41,3,100,40,17,100,"-1",0
93,42,3,100,30,13,100,"-1",0
93,43,4,0,40,81,0,"1",0
93,44,3,10,10,19,19,"1",-9
93,45,5,100,30,19,100,"-1",0
93,46,5,0,30,45,0,"1",0
93,47,4,100,50,20,100,"-1",0
93,48,3,100,30,18,100,"-1",0
93,49,5,100,13,11,100,"-1",0
93,50,2,0,39,38,0,"1",0
93,51,3,50,50,26,26,"-1",24
94,1,4,0,30,26,0,"1",0
94,2,5,20,30,20,20,"0",0
94,3,3,24,0,29,0,"1",24
94,4,4,100,80,78,100,"-1",0
94,5,5,0,15,56,10,"1",-10
94,6,4,20,40,29,30,"1",-10
94,7,3,0,30,45,0,"1",0
94,8,3,50,80,75,75,"1",-25
94,9,3,10,25,29,10,"1",0
94,10,3,10,35,56,10,"1",0
94,11,4,10,20,31,20,"1",-10
94,12,3,100,80,78,100,"-1",0
94,13,3,10,0,22,0,"1",10
94,14,2,30,40,41,30,"1",0
94,15,2,50,50,60,50,"1",0
94,16,3,25,10,26,10,"1",15
94,17,1,50,60,43,50,"-1",0
94,18,2,50,70,82,60,"1",-10
94,19,1,0,15,21,0,"1",0
94,20,2,60,35,40,60,"-1",0
94,21,2,50,45,35,40,"-1",10
94,22,2,50,80,60,50,"1",0
94,23,2,25,75,71,25,"1",0
94,24,3,10,10,14,10,"1",0
94,25,5,100,40,14,100,"-1",0
94,26,4,100,70,29,100,"-1",0
94,27,2,20,30,45,20,"1",0
94,28,3,20,20,20,20,"0",0
94,29,2,80,85,66,80,"-1",0
94,30,5,100,20,48,100,"-1",0
94,31,2,100,45,19,100,"-1",0
94,32,5,100,25,33,100,"-1",0
94,33,3,50,40,15,40,"-1",10
94,34,3,20,30,80,20,"1",0
94,35,1,0,40,17,0,"1",0
94,36,2,10,30,26,10,"1",0
94,37,4,60,60,30,50,"-1",10
94,38,2,10,76,71,20,"1",-10
94,39,2,10,33,43,10,"1",0
94,40,4,90,60,21,90,"-1",0
94,41,3,0,35,17,0,"1",0
94,42,3,50,60,13,50,"-1",0
94,43,3,0,25,81,0,"1",0
94,44,3,20,20,19,20,"-1",0
94,45,3,5,15,19,10,"1",-5
94,46,5,100,60,45,100,"-1",0
94,47,4,100,50,20,100,"-1",0
94,48,3,20,40,18,10,"-1",10
94,49,3,0,10,11,1,"1",-1
94,50,3,50,60,38,50,"-1",0
94,51,2,20,50,26,10,"1",10
95,1,5,10,10,26,10,"1",0
95,2,5,30,40,20,30,"-1",0
95,3,3,0,50,29,0,"1",0
95,4,3,100,60,78,70,"-1",30
95,5,5,100,40,56,40,"-1",60
95,6,5,0,35,29,0,"1",0
95,7,5,50,45,45,50,"-1",0
95,8,2,0,25,75,0,"1",0
95,9,4,0,30,29,0,"1",0
95,10,4,10,60,56,10,"1",0
95,11,4,0,20,31,0,"1",0
95,12,3,100,80,78,80,"-1",20
95,13,4,0,30,22,0,"1",0
95,14,1,10,18,41,10,"1",0
95,15,1,30,30,60,30,"1",0
95,16,1,30,30,26,30,"-1",0
95,17,2,0,40,43,0,"1",0
95,18,1,100,50,82,100,"-1",0
95,19,1,0,40,21,0,"1",0
95,20,2,70,35,40,50,"-1",20
95,21,2,50,50,35,50,"-1",0
95,22,1,80,60,60,80,"-1",0
95,23,1,60,60,71,60,"1",0
95,24,3,20,20,14,20,"-1",0
95,25,4,50,30,14,30,"-1",20
95,26,3,100,70,29,100,"-1",0
95,27,2,0,20,45,20,"1",-20
95,28,3,20,20,20,20,"0",0
95,29,1,30,30,66,30,"1",0
95,30,4,30,20,48,20,"1",10
95,31,2,100,70,19,0,"-1",100
95,32,5,100,40,33,100,"-1",0
95,33,3,100,20,15,20,"-1",80
95,34,2,0,40,80,0,"1",0
95,35,3,50,50,17,20,"-1",30
95,36,2,20,20,26,20,"1",0
95,37,5,50,30,30,50,"-1",0
95,38,1,0,70,71,0,"1",0
95,39,3,30,30,43,30,"1",0
95,40,3,30,30,21,30,"-1",0
95,41,1,0,10,17,0,"1",0
95,42,3,0,40,13,0,"1",0
95,43,3,20,30,81,70,"1",-50
95,44,3,20,20,19,20,"-1",0
95,45,3,50,50,19,10,"-1",40
95,46,5,100,70,45,100,"-1",0
95,47,4,10,30,20,10,"1",0
95,48,3,0,15,18,10,"1",-10
95,49,1,0,25,11,0,"1",0
95,50,1,0,35,38,0,"1",0
95,51,3,0,50,26,0,"1",0
96,1,1,20,20,26,26,"1",-6
96,2,5,25,25,20,20,"-1",5
96,3,4,1,43,29,1,"1",0
96,4,4,100,70,78,100,"-1",0
96,5,5,90,50,56,80,"-1",10
96,6,5,90,90,29,90,"-1",0
96,7,5,50,25,45,50,"-1",0
96,8,3,85,85,75,75,"-1",10
96,9,3,1,13,29,1,"1",0
96,10,5,85,85,56,75,"-1",10
96,11,5,50,50,31,50,"-1",0
96,12,2,100,100,78,100,"-1",0
96,13,5,0,5,22,1,"1",-1
96,14,1,20,20,41,41,"1",-21
96,15,2,10,10,60,10,"1",0
96,16,2,5,20,26,5,"1",0
96,17,1,10,50,43,10,"1",0
96,18,2,99,99,82,82,"-1",17
96,19,1,1,15,21,1,"1",0
96,20,1,5,15,40,5,"1",0
96,21,1,20,20,35,20,"1",0
96,22,2,85,85,60,60,"-1",25
96,23,2,99,95,71,95,"-1",4
96,24,3,15,15,14,14,"-1",1
96,25,4,5,25,14,5,"1",0
96,26,3,99,99,29,99,"-1",0
96,27,1,5,33,45,5,"1",0
96,28,3,17,17,20,20,"1",-3
96,29,2,60,60,66,66,"1",-6
96,30,3,30,10,48,48,"1",-18
96,31,5,100,50,19,95,"-1",5
96,32,5,100,50,33,100,"-1",0
96,33,3,100,90,15,90,"-1",10
96,34,3,90,90,80,80,"-1",10
96,35,2,10,10,17,17,"1",-7
96,36,2,80,80,26,26,"-1",54
96,37,5,95,75,30,30,"-1",65
96,38,2,99,99,71,71,"-1",28
96,39,4,99,60,43,99,"-1",0
96,40,5,100,90,21,100,"-1",0
96,41,3,90,60,17,40,"-1",50
96,42,3,20,20,13,13,"-1",7
96,43,3,0,30,81,1,"1",-1
96,44,3,10,10,19,19,"1",-9
96,45,3,5,5,19,19,"1",-14
96,46,5,100,70,45,100,"-1",0
96,47,4,100,20,20,100,"-1",0
96,48,2,30,25,18,18,"-1",12
96,49,4,15,15,11,11,"-1",4
96,50,1,0,45,38,0,"1",0
96,51,5,100,50,26,100,"-1",0
97,1,5,70,70,26,26,"-1",44
97,2,5,20,20,20,20,"0",0
97,3,5,80,80,29,80,"-1",0
97,4,2,100,100,78,100,"-1",0
97,5,5,100,40,56,100,"-1",0
97,6,3,5,5,29,5,"1",0
97,7,5,90,90,45,90,"-1",0
97,8,5,100,97,75,100,"-1",0
97,9,5,20,20,29,20,"1",0
97,10,5,5,100,56,5,"1",0
97,11,5,50,50,31,31,"-1",19
97,12,3,100,100,78,78,"-1",22
97,13,5,7,1,22,5,"1",2
97,14,1,3,3,41,3,"1",0
97,15,3,90,90,60,90,"-1",0
97,16,1,5,5,26,26,"1",-21
97,17,1,60,60,43,60,"-1",0
97,18,3,80,80,82,82,"1",-2
97,19,1,5,30,21,5,"1",0
97,20,1,0,2,40,0,"1",0
97,21,1,100,100,35,100,"-1",0
97,22,1,100,100,60,60,"-1",40
97,23,1,15,80,71,15,"1",0
97,24,3,33,33,14,14,"-1",19
97,25,3,0,5,14,0,"1",0
97,26,3,100,100,29,100,"-1",0
97,27,3,100,100,45,100,"-1",0
97,28,3,20,20,20,20,"0",0
97,29,3,90,90,66,66,"-1",24
97,30,3,0,5,48,0,"1",0
97,31,5,100,89,19,100,"-1",0
97,32,5,0,5,33,0,"1",0
97,33,3,40,50,15,50,"-1",-10
97,34,3,5,70,80,5,"1",0
97,35,3,99,50,17,99,"-1",0
97,36,1,80,80,26,80,"-1",0
97,37,5,70,70,30,30,"-1",40
97,38,1,100,100,71,100,"-1",0
97,39,5,20,20,43,50,"1",-30
97,40,5,100,90,21,100,"-1",0
97,41,3,80,80,17,80,"-1",0
97,42,3,90,90,13,90,"-1",0
97,43,5,20,20,81,20,"1",0
97,44,3,20,20,19,19,"-1",1
97,45,5,20,2,19,20,"-1",0
97,46,5,70,70,45,70,"-1",0
97,47,3,0,20,20,0,"1",0
97,48,3,0,20,18,5,"1",-5
97,49,5,100,60,11,100,"-1",0
97,50,5,0,20,38,0,"1",0
97,51,3,80,50,26,80,"-1",0
98,1,1,10,14,26,30,"1",-20
98,2,5,5,3,20,10,"1",-5
98,3,2,20,5,29,15,"1",5
98,4,5,100,60,78,100,"-1",0
98,5,2,32,44,56,52,"1",-20
98,6,4,30,32,29,30,"-1",0
98,7,5,90,70,45,80,"-1",10
98,8,1,50,30,75,60,"1",-10
98,9,4,35,47,29,36,"-1",-1
98,10,5,100,100,56,70,"-1",30
98,11,1,12,33,31,15,"1",-3
98,12,5,99,98,78,80,"-1",19
98,13,2,19,12,22,20,"1",-1
98,14,5,70,60,41,50,"-1",20
98,15,5,100,90,60,99,"-1",1
98,16,4,5,10,26,20,"1",-15
98,17,1,4,10,43,20,"1",-16
98,18,5,95,90,82,90,"-1",5
98,19,5,100,70,21,60,"-1",40
98,20,1,1,20,40,2,"1",-1
98,21,5,68,64,35,49,"-1",19
98,22,5,90,79,60,90,"-1",0
98,23,5,30,80,71,60,"1",-30
98,24,4,40,36,14,16,"-1",24
98,25,1,1,10,14,1,"1",0
98,26,5,100,88,29,70,"-1",30
98,27,4,70,90,45,50,"-1",20
98,28,2,12,15,20,34,"1",-22
98,29,5,98,89,66,70,"-1",28
98,30,1,1,12,48,19,"1",-18
98,31,5,40,50,19,25,"-1",15
98,32,3,34,30,33,33,"-1",1
98,33,1,15,10,15,15,"0",0
98,34,4,4,60,80,40,"1",-36
98,35,4,29,22,17,29,"-1",0
98,36,3,30,45,26,20,"-1",10
98,37,2,46,49,30,29,"-1",17
98,38,5,67,92,71,70,"1",-3
98,39,1,1,45,43,1,"1",0
98,40,4,79,60,21,50,"-1",29
98,41,5,80,80,17,20,"-1",60
98,42,2,10,12,13,12,"1",-2
98,43,2,57,37,81,89,"1",-32
98,44,3,2,5,19,10,"1",-8
98,45,2,2,10,19,3,"1",-1
98,46,5,100,70,45,90,"-1",10
98,47,1,1,2,20,17,"1",-16
98,48,2,1,5,18,10,"1",-9
98,49,2,1,2,11,4,"1",-3
98,50,1,1,4,38,13,"1",-12
98,51,1,1,6,26,1,"1",0
99,1,3,20,12,26,20,"1",0
99,2,5,10,15,20,10,"1",0
99,3,4,40,20,29,20,"-1",20
99,4,5,90,78,78,90,"-1",0
99,5,5,60,65,56,60,"-1",0
99,6,3,60,60,29,50,"-1",10
99,7,3,100,78,45,100,"-1",0
99,8,2,60,78,75,60,"1",0
99,9,4,20,30,29,20,"1",0
99,10,4,40,75,56,40,"1",0
99,11,4,30,45,31,30,"1",0
99,12,3,89,89,78,89,"-1",0
99,13,4,20,10,22,10,"1",10
99,14,3,80,75,41,70,"-1",10
99,15,3,60,76,60,60,"0",0
99,16,3,25,23,26,23,"1",2
99,17,2,45,61,43,40,"-1",5
99,18,1,20,45,82,40,"1",-20
99,19,2,70,61,21,70,"-1",0
99,20,3,65,65,40,65,"-1",0
99,21,2,72,72,35,40,"-1",32
99,22,2,95,88,60,88,"-1",7
99,23,3,95,95,71,95,"-1",0
99,24,3,18,18,14,16,"-1",2
99,25,5,85,79,14,85,"-1",0
99,26,3,100,91,29,100,"-1",0
99,27,2,5,17,45,20,"1",-15
99,28,3,12,12,20,20,"1",-8
99,29,3,80,75,66,80,"-1",0
99,30,5,95,31,48,90,"-1",5
99,31,2,89,60,19,89,"-1",0
99,32,5,100,30,33,100,"-1",0
99,33,4,100,80,15,100,"-1",0
99,34,2,60,45,80,70,"1",-10
99,35,5,70,40,17,30,"-1",40
99,36,3,93,93,26,50,"-1",43
99,37,4,75,80,30,60,"-1",15
99,38,2,78,78,71,78,"-1",0
99,39,3,100,58,43,100,"-1",0
99,40,5,2,11,21,2,"1",0
99,41,3,70,68,17,40,"-1",30
99,42,3,50,70,13,50,"-1",0
99,43,5,70,21,81,81,"1",-11
99,44,3,11,11,19,19,"1",-8
99,45,4,71,71,19,71,"-1",0
99,46,4,90,80,45,90,"-1",0
99,47,5,50,38,20,50,"-1",0
99,48,3,60,60,18,40,"-1",20
99,49,3,10,40,11,10,"1",0
99,50,3,0,55,38,0,"1",0
99,51,3,12,36,26,12,"1",0
100,1,4,60,25,26,60,"-1",0
100,2,5,50,50,20,50,"-1",0
100,3,4,35,0,29,0,"-1",35
100,4,5,100,90,78,100,"-1",0
100,5,5,0,75,56,0,"1",0
100,6,4,25,5,29,25,"1",0
100,7,4,80,45,45,80,"-1",0
100,8,2,10,85,75,10,"1",0
100,9,4,10,10,29,10,"1",0
100,10,4,100,25,56,100,"-1",0
100,11,4,1,10,31,1,"1",0
100,12,2,100,75,78,100,"-1",0
100,13,5,15,0,22,0,"1",15
100,14,2,60,60,41,41,"-1",19
100,15,2,80,50,60,80,"-1",0
100,16,2,10,10,26,10,"1",0
100,17,1,45,20,43,45,"-1",0
100,18,1,55,45,82,55,"1",0
100,19,2,50,35,21,50,"-1",0
100,20,2,0,5,40,0,"1",0
100,21,2,75,65,35,70,"-1",5
100,22,1,100,100,60,100,"-1",0
100,23,1,100,99,71,100,"-1",0
100,24,3,15,15,14,15,"-1",0
100,25,2,0,5,14,0,"1",0
100,26,2,0,70,29,0,"1",0
100,27,2,15,25,45,15,"1",0
100,28,3,60,60,20,20,"-1",40
100,29,2,90,80,66,90,"-1",0
100,30,2,1,5,48,1,"1",0
100,31,1,100,65,19,0,"-1",100
100,32,4,5,30,33,5,"1",0
100,33,2,25,80,15,25,"-1",0
100,34,3,2,5,80,2,"1",0
100,35,1,5,5,17,5,"1",0
100,36,2,80,80,26,26,"-1",54
100,37,4,85,65,30,85,"-1",0
100,38,2,100,100,71,100,"-1",0
100,39,2,0,70,43,0,"1",0
100,40,4,3,10,21,3,"1",0
100,41,2,25,50,17,50,"-1",-25
100,42,3,90,80,13,90,"-1",0
100,43,4,20,20,81,20,"1",0
100,44,3,10,15,19,15,"1",-5
100,45,3,10,20,19,10,"1",0
100,46,4,100,75,45,100,"-1",0
100,47,4,5,25,20,5,"1",0
100,48,2,30,30,18,18,"-1",12
100,49,3,2,5,11,2,"1",0
100,50,3,0,10,38,0,"1",0
100,51,2,10,40,26,10,"1",0
