"Participant","Event","E1","eBR","BR","Valence","E2","trialtype","signed_EE","abs_EE","direction","update"
1,1,77,65,56,3,77,"neutral",21,21,-1,0
1,2,33,50,29,3,3,"neutral",4,4,-1,30
1,3,50,40,20,3,40,"neutral",30,30,-1,10
1,4,10,40,17,3,70,"neutral",-7,7,1,60
1,5,50,35,38,3,50,"neutral",12,12,-1,0
1,6,3,30,26,3,3,"neutral",-23,23,1,0
1,7,65,50,62,3,65,"neutral",3,3,-1,0
1,8,20,40,59,3,30,"neutral",-39,39,1,10
1,9,65,35,65,3,45,"neutral",0,0,0,0
1,10,60,70,55,2,70,"negative",5,5,-1,-10
1,11,40,60,52,2,65,"negative",-12,12,1,25
1,12,75,70,48,3,75,"neutral",27,27,-1,0
1,13,10,17,30,3,40,"neutral",-20,20,1,30
1,14,40,60,55,4,60,"positive",-15,15,1,20
1,15,20,55,42,3,20,"neutral",-22,22,1,0
1,16,75,60,32,3,65,"neutral",43,43,-1,10
1,17,75,65,41,3,50,"neutral",34,34,-1,25
1,18,70,70,48,1,60,"negative",22,22,-1,10
1,19,50,40,49,3,50,"neutral",1,1,-1,0
1,20,20,20,44,3,35,"neutral",-24,24,1,15
1,21,40,35,33,2,30,"negative",7,7,-1,10
1,22,45,65,51,3,50,"neutral",-6,6,1,5
1,23,65,65,37,3,50,"neutral",28,28,-1,15
1,24,70,75,43,3,35,"neutral",27,27,-1,35
1,25,35,40,39,4,45,"positive",-4,4,1,10
1,26,70,75,35,3,65,"neutral",35,35,-1,5
1,27,60,55,30,2,40,"negative",30,30,-1,20
1,28,65,30,70,3,35,"neutral",-5,5,1,-30
1,29,70,75,10,3,70,"neutral",60,60,-1,0
1,30,33,33,23,2,20,"negative",10,10,-1,13
1,31,70,50,23,2,65,"negative",47,47,-1,5
1,32,35,45,36,2,40,"negative",-1,1,1,5
1,33,70,75,33,3,30,"neutral",37,37,-1,40
1,34,25,55,36,3,35,"neutral",-11,11,1,10
1,35,15,35,45,4,20,"positive",-30,30,1,5
1,36,65,60,43,3,60,"neutral",22,22,-1,5
1,37,77,60,38,3,65,"neutral",39,39,-1,12
1,38,70,70,33,3,40,"neutral",37,37,-1,30
1,39,5,20,47,2,30,"negative",-42,42,1,25
2,1,60,75,56,5,56,"positive",4,4,-1,4
2,2,65,45,29,4,33,"positive",36,36,-1,32
2,3,55,66,20,4,14,"positive",35,35,-1,41
2,4,77,10,17,1,56,"negative",60,60,-1,21
2,5,10,25,38,2,32,"negative",-28,28,1,22
2,6,70,56,26,2,42,"negative",44,44,-1,28
2,7,20,30,62,2,45,"negative",-42,42,1,25
2,8,35,25,59,2,56,"negative",-24,24,1,21
2,9,50,70,65,3,65,"neutral",-15,15,1,15
2,10,40,56,55,2,35,"negative",-15,15,1,-5
2,11,20,32,52,2,25,"negative",-32,32,1,5
2,12,30,20,48,3,45,"neutral",-18,18,1,15
2,13,10,35,30,2,23,"negative",-20,20,1,13
2,14,25,45,55,4,45,"positive",-30,30,1,20
2,15,70,56,42,4,69,"positive",28,28,-1,1
2,16,56,60,32,3,23,"neutral",24,24,-1,33
2,17,70,56,41,5,35,"positive",29,29,-1,35
2,18,30,25,48,5,46,"positive",-18,18,1,16
2,19,25,30,49,4,55,"positive",-24,24,1,30
2,20,25,40,44,3,32,"neutral",-19,19,1,7
2,21,60,45,33,5,15,"positive",27,27,-1,45
2,22,20,35,51,1,57,"negative",-31,31,1,37
2,23,3,3,37,3,45,"neutral",-34,34,1,42
2,24,35,45,43,5,70,"positive",-8,8,1,35
2,25,20,15,39,1,40,"negative",-19,19,1,20
2,26,60,70,35,2,59,"negative",25,25,-1,1
2,27,35,55,30,4,30,"positive",5,5,-1,5
2,28,70,55,70,4,75,"positive",0,0,0,0
2,29,30,25,10,3,35,"neutral",20,20,-1,-5
2,30,77,60,23,1,15,"negative",54,54,-1,62
2,31,56,65,23,4,15,"positive",33,33,-1,41
2,32,30,40,36,2,40,"negative",-6,6,1,10
2,33,70,56,33,4,37,"positive",37,37,-1,33
2,34,20,15,36,4,30,"positive",-16,16,1,10
2,35,65,55,45,4,65,"positive",20,20,-1,0
2,36,56,45,43,2,65,"negative",13,13,-1,-9
2,37,60,70,38,2,35,"negative",22,22,-1,25
2,38,20,33,33,3,20,"neutral",-13,13,1,0
2,39,10,30,47,1,20,"negative",-37,37,1,10
3,1,75,50,56,3,60,"neutral",19,19,-1,15
3,2,3,50,29,2,5,"negative",-26,26,1,2
3,3,24,27,20,3,20,"neutral",4,4,-1,4
3,4,75,75,17,4,30,"positive",58,58,-1,45
3,5,5,77,38,2,5,"negative",-33,33,1,0
3,6,5,10,26,4,10,"positive",-21,21,1,5
3,7,5,5,62,3,40,"neutral",-57,57,1,35
3,8,30,40,59,3,40,"neutral",-29,29,1,10
3,9,60,50,65,3,40,"neutral",-5,5,1,-20
3,10,66,50,55,1,60,"negative",11,11,-1,6
3,11,10,30,52,2,40,"negative",-42,42,1,30
3,12,75,58,48,3,45,"neutral",27,27,-1,30
3,13,3,15,30,3,30,"neutral",-27,27,1,27
3,14,20,30,55,4,40,"positive",-35,35,1,20
3,15,3,26,42,3,10,"neutral",-39,39,1,7
3,16,75,59,32,3,70,"neutral",43,43,-1,5
3,17,5,5,41,3,50,"neutral",-36,36,1,45
3,18,20,30,48,4,59,"positive",-28,28,1,39
3,19,50,55,49,3,50,"neutral",1,1,-1,0
3,20,10,30,44,3,40,"neutral",-34,34,1,30
3,21,37,40,33,2,20,"negative",4,4,-1,17
3,22,46,56,51,3,50,"neutral",-5,5,1,4
3,23,50,60,37,2,30,"negative",13,13,-1,20
3,24,60,60,43,3,50,"neutral",17,17,-1,10
3,25,56,60,39,3,30,"neutral",17,17,-1,26
3,26,58,60,35,3,30,"neutral",23,23,-1,28
3,27,50,77,30,3,44,"neutral",20,20,-1,6
3,28,6,17,70,3,30,"neutral",-64,64,1,24
3,29,15,30,10,3,30,"neutral",5,5,-1,-15
3,30,12,13,23,3,30,"neutral",-11,11,1,18
3,31,20,24,23,3,40,"neutral",-3,3,1,20
3,32,10,20,36,2,30,"negative",-26,26,1,20
3,33,20,40,33,3,30,"neutral",-13,13,1,10
3,34,55,46,36,3,44,"neutral",19,19,-1,11
3,35,60,40,45,4,60,"positive",15,15,-1,0
3,36,44,30,43,4,40,"positive",1,1,-1,4
3,37,50,50,38,3,20,"neutral",12,12,-1,30
3,38,19,35,33,3,40,"neutral",-14,14,1,21
3,39,66,56,47,2,40,"negative",19,19,-1,26
4,1,20,65,56,2,56,"negative",-36,36,1,36
4,2,30,70,29,2,20,"negative",1,1,-1,10
4,3,60,50,20,3,23,"neutral",40,40,-1,37
4,4,70,60,17,4,30,"positive",53,53,-1,40
4,5,60,60,38,2,40,"negative",22,22,-1,20
4,6,50,40,26,3,23,"neutral",24,24,-1,27
4,7,30,40,62,5,57,"positive",-32,32,1,27
4,8,9,15,59,2,51,"negative",-50,50,1,42
4,9,32,32,65,2,46,"negative",-33,33,1,14
4,10,50,70,55,2,60,"negative",-5,5,1,10
4,11,3,10,52,4,60,"positive",-49,49,1,57
4,12,60,60,48,4,35,"positive",12,12,-1,25
4,13,10,11,30,1,17,"negative",-20,20,1,7
4,14,70,50,55,4,65,"positive",15,15,-1,5
4,15,3,67,42,4,3,"positive",-39,39,1,0
4,16,65,71,32,2,46,"negative",33,33,-1,19
4,17,30,50,41,3,20,"neutral",-11,11,1,-10
4,18,20,40,48,4,50,"positive",-28,28,1,30
4,19,20,30,49,3,48,"neutral",-29,29,1,28
4,20,17,30,44,3,34,"neutral",-27,27,1,17
4,21,70,65,33,3,25,"neutral",37,37,-1,45
4,22,3,3,51,3,33,"neutral",-48,48,1,30
4,23,30,50,37,2,33,"negative",-7,7,1,3
4,24,70,50,43,2,47,"negative",27,27,-1,23
4,25,26,40,39,3,45,"neutral",-13,13,1,19
4,26,75,70,35,4,40,"positive",40,40,-1,35
4,27,20,43,30,3,37,"neutral",-10,10,1,17
4,28,55,70,70,4,55,"positive",-15,15,1,0
4,29,45,29,10,4,21,"positive",35,35,-1,24
4,30,29,45,23,3,22,"neutral",6,6,-1,7
4,31,50,41,23,3,25,"neutral",27,27,-1,25
4,32,10,25,36,3,23,"neutral",-26,26,1,13
4,33,50,46,33,3,40,"neutral",17,17,-1,10
4,34,15,20,36,3,40,"neutral",-21,21,1,25
4,35,55,60,45,4,11,"positive",10,10,-1,44
4,36,3,60,43,2,3,"negative",-40,40,1,0
4,37,48,67,38,4,32,"positive",10,10,-1,16
4,38,30,54,33,3,37,"neutral",-3,3,1,7
4,39,30,30,47,3,30,"neutral",-17,17,1,0
5,1,10,5,56,4,9,"positive",-46,46,1,-1
5,2,5,5,29,3,4,"neutral",-24,24,1,-1
5,3,10,8,20,5,8,"positive",-10,10,1,-2
5,4,10,10,17,3,10,"neutral",-7,7,1,0
5,5,3,3,38,2,3,"negative",-35,35,1,0
5,6,3,5,26,3,3,"neutral",-23,23,1,0
5,7,10,4,62,5,4,"positive",-52,52,1,-6
5,8,3,3,59,4,10,"positive",-56,56,1,7
5,9,3,3,65,3,4,"neutral",-62,62,1,1
5,10,10,10,55,1,3,"negative",-45,45,1,-7
5,11,8,6,52,1,6,"negative",-44,44,1,-2
5,12,6,10,48,3,8,"neutral",-42,42,1,2
5,13,3,3,30,2,3,"negative",-27,27,1,0
5,14,5,5,55,3,4,"neutral",-50,50,1,-1
5,15,8,5,42,4,8,"positive",-34,34,1,0
5,16,3,3,32,4,8,"positive",-29,29,1,5
5,17,4,7,41,3,9,"neutral",-37,37,1,5
5,18,5,3,48,3,5,"neutral",-43,43,1,0
5,19,5,3,49,3,4,"neutral",-44,44,1,-1
5,20,3,4,44,3,4,"neutral",-41,41,1,1
5,21,5,4,33,3,10,"neutral",-28,28,1,5
5,22,3,3,51,3,4,"neutral",-48,48,1,1
5,23,6,8,37,2,8,"negative",-31,31,1,2
5,24,3,3,43,3,3,"neutral",-40,40,1,0
5,25,4,3,39,3,10,"neutral",-35,35,1,6
5,26,6,5,35,2,4,"negative",-29,29,1,-2
5,27,5,5,30,3,4,"neutral",-25,25,1,-1
5,28,7,8,70,3,7,"neutral",-63,63,1,0
5,29,10,10,10,3,9,"neutral",0,0,0,0
5,30,3,3,23,3,3,"neutral",-20,20,1,0
5,31,3,3,23,3,3,"neutral",-20,20,1,0
5,32,6,3,36,2,6,"negative",-30,30,1,0
5,33,5,3,33,4,9,"positive",-28,28,1,4
5,34,8,4,36,3,8,"neutral",-28,28,1,0
5,35,3,3,45,4,5,"positive",-42,42,1,2
5,36,3,3,43,1,3,"negative",-40,40,1,0
5,37,4,3,38,2,7,"negative",-34,34,1,3
5,38,5,5,33,3,6,"neutral",-28,28,1,1
5,39,5,5,47,3,5,"neutral",-42,42,1,0
6,1,5,3,56,4,30,"positive",-51,51,1,25
6,2,5,5,29,4,4,"positive",-24,24,1,-1
6,3,5,5,20,5,4,"positive",-15,15,1,-1
6,4,5,5,17,4,60,"positive",-12,12,1,55
6,5,3,5,38,3,4,"neutral",-35,35,1,1
6,6,3,4,26,3,3,"neutral",-23,23,1,0
6,7,3,4,62,4,6,"positive",-59,59,1,3
6,8,5,3,59,3,4,"neutral",-54,54,1,-1
6,9,5,3,65,4,3,"positive",-60,60,1,-2
6,10,3,5,55,5,4,"positive",-52,52,1,1
6,11,3,3,52,4,4,"positive",-49,49,1,1
6,12,3,3,48,2,3,"negative",-45,45,1,0
6,13,5,5,30,4,3,"positive",-25,25,1,-2
6,14,3,4,55,4,20,"positive",-52,52,1,17
6,15,4,5,42,5,5,"positive",-38,38,1,1
6,16,5,5,32,5,5,"positive",-27,27,1,0
6,17,3,3,41,3,3,"neutral",-38,38,1,0
6,18,3,4,48,3,3,"neutral",-45,45,1,0
6,19,3,4,49,4,4,"positive",-46,46,1,1
6,20,4,3,44,3,4,"neutral",-40,40,1,0
6,21,3,3,33,2,3,"negative",-30,30,1,0
6,22,3,3,51,4,3,"positive",-48,48,1,0
6,23,4,3,37,3,3,"neutral",-33,33,1,-1
6,24,3,3,43,3,30,"neutral",-40,40,1,27
6,25,3,4,39,1,3,"negative",-36,36,1,0
6,26,5,4,35,4,4,"positive",-30,30,1,-1
6,27,5,3,30,3,4,"neutral",-25,25,1,-1
6,28,3,4,70,5,5,"positive",-67,67,1,2
6,29,5,4,10,3,29,"neutral",-5,5,1,24
6,30,4,3,23,5,5,"positive",-19,19,1,1
6,31,4,4,23,5,3,"positive",-19,19,1,-1
6,32,3,4,36,4,40,"positive",-33,33,1,37
6,33,4,3,33,4,50,"positive",-29,29,1,46
6,34,5,5,36,4,4,"positive",-31,31,1,-1
6,35,5,5,45,5,50,"positive",-40,40,1,45
6,36,5,5,43,5,3,"positive",-38,38,1,-2
6,37,4,4,38,3,10,"neutral",-34,34,1,6
6,38,5,4,33,2,50,"negative",-28,28,1,45
6,39,4,4,47,4,4,"positive",-43,43,1,0
7,1,30,22,56,3,55,"neutral",-26,26,1,25
7,2,3,65,29,3,77,"neutral",-26,26,1,74
7,3,66,33,20,3,77,"neutral",46,46,-1,-11
7,4,77,55,17,1,27,"negative",60,60,-1,50
7,5,3,43,38,3,21,"neutral",-35,35,1,18
7,6,40,50,26,3,32,"neutral",14,14,-1,8
7,7,3,19,62,2,55,"negative",-59,59,1,52
7,8,55,77,59,3,55,"neutral",-4,4,1,0
7,9,21,34,65,3,33,"neutral",-44,44,1,12
7,10,50,50,55,1,45,"negative",-5,5,1,-5
7,11,22,35,52,3,61,"neutral",-30,30,1,39
7,12,3,15,48,3,45,"neutral",-45,45,1,42
7,13,32,21,30,3,33,"neutral",2,2,-1,-1
7,14,3,77,55,3,44,"neutral",-52,52,1,41
7,15,77,77,42,3,33,"neutral",35,35,-1,44
7,16,50,20,32,2,18,"negative",18,18,-1,32
7,17,32,49,41,3,33,"neutral",-9,9,1,1
7,18,50,69,48,3,33,"neutral",2,2,-1,17
7,19,13,33,49,3,43,"neutral",-36,36,1,30
7,20,12,19,44,3,44,"neutral",-32,32,1,32
7,21,3,67,33,3,33,"neutral",-30,30,1,30
7,22,69,35,51,3,32,"neutral",18,18,-1,37
7,23,36,45,37,2,76,"negative",-1,1,1,40
7,24,45,44,43,3,43,"neutral",2,2,-1,2
7,25,44,43,39,3,43,"neutral",5,5,-1,1
7,26,31,20,35,3,44,"neutral",-4,4,1,13
7,27,33,44,30,2,22,"negative",3,3,-1,11
7,28,60,33,70,3,22,"neutral",-10,10,1,-38
7,29,55,44,10,3,38,"neutral",45,45,-1,17
7,30,48,66,23,2,26,"negative",25,25,-1,22
7,31,50,44,23,3,66,"neutral",27,27,-1,-16
7,32,55,56,36,3,55,"neutral",19,19,-1,0
7,33,77,77,33,3,50,"neutral",44,44,-1,27
7,34,66,63,36,3,45,"neutral",30,30,-1,21
7,35,55,55,45,4,28,"positive",10,10,-1,27
7,36,32,23,43,3,44,"neutral",-11,11,1,12
7,37,22,44,38,3,77,"neutral",-16,16,1,55
7,38,40,76,33,3,44,"neutral",7,7,-1,-4
7,39,70,75,47,3,33,"neutral",23,23,-1,37
8,1,3,40,56,5,3,"positive",-53,53,1,0
8,2,3,33,29,4,3,"positive",-26,26,1,0
8,3,5,30,20,4,4,"positive",-15,15,1,-1
8,4,7,70,17,3,7,"neutral",-10,10,1,0
8,5,3,30,38,2,3,"negative",-35,35,1,0
8,6,6,50,26,3,3,"neutral",-20,20,1,-3
8,7,4,50,62,3,3,"neutral",-58,58,1,-1
8,8,4,30,59,4,4,"positive",-55,55,1,0
8,9,3,10,65,2,3,"negative",-62,62,1,0
8,10,3,60,55,1,5,"negative",-52,52,1,2
8,11,7,30,52,1,5,"negative",-45,45,1,-2
8,12,3,30,48,4,4,"positive",-45,45,1,1
8,13,5,40,30,3,3,"neutral",-25,25,1,-2
8,14,4,50,55,1,5,"negative",-51,51,1,1
8,15,5,60,42,4,7,"positive",-37,37,1,2
8,16,7,60,32,4,5,"positive",-25,25,1,-2
8,17,4,25,41,3,3,"neutral",-37,37,1,-1
8,18,4,40,48,4,5,"positive",-44,44,1,1
8,19,5,60,49,4,7,"positive",-44,44,1,2
8,20,5,55,44,3,4,"neutral",-39,39,1,-1
8,21,4,20,33,4,3,"positive",-29,29,1,-1
8,22,5,50,51,3,5,"neutral",-46,46,1,0
8,23,4,40,37,2,4,"negative",-33,33,1,0
8,24,4,60,43,3,4,"neutral",-39,39,1,0
8,25,7,65,39,3,5,"neutral",-32,32,1,-2
8,26,6,50,35,3,5,"neutral",-29,29,1,-1
8,27,5,35,30,3,4,"neutral",-25,25,1,-1
8,28,7,50,70,4,4,"positive",-63,63,1,-3
8,29,4,30,10,4,4,"positive",-6,6,1,0
8,30,3,40,23,3,3,"neutral",-20,20,1,0
8,31,5,60,23,3,4,"neutral",-18,18,1,-1
8,32,4,40,36,3,4,"neutral",-32,32,1,0
8,33,7,60,33,4,5,"positive",-26,26,1,-2
8,34,5,10,36,3,4,"neutral",-31,31,1,-1
8,35,3,50,45,1,3,"negative",-42,42,1,0
8,36,3,20,43,2,3,"negative",-40,40,1,0
8,37,3,40,38,3,5,"neutral",-35,35,1,2
8,38,3,30,33,3,3,"neutral",-30,30,1,0
8,39,5,60,47,4,5,"positive",-42,42,1,0
9,1,77,60,56,3,70,"neutral",21,21,-1,7
9,2,70,55,29,5,70,"positive",41,41,-1,0
9,3,25,28,20,3,36,"neutral",5,5,-1,-11
9,4,77,50,17,4,58,"positive",60,60,-1,19
9,5,15,12,38,3,15,"neutral",-23,23,1,0
9,6,45,20,26,3,15,"neutral",19,19,-1,30
9,7,55,55,62,3,58,"neutral",-7,7,1,3
9,8,50,58,59,4,50,"positive",-9,9,1,0
9,9,25,28,65,2,45,"negative",-40,40,1,20
9,10,38,38,55,1,58,"negative",-17,17,1,20
9,11,50,40,52,2,58,"negative",-2,2,1,8
9,12,50,50,48,3,38,"neutral",2,2,-1,12
9,13,15,15,30,2,20,"negative",-15,15,1,5
9,14,58,50,55,4,48,"positive",3,3,-1,10
9,15,77,77,42,5,40,"positive",35,35,-1,37
9,16,15,38,32,3,28,"neutral",-17,17,1,13
9,17,50,60,41,4,65,"positive",9,9,-1,-15
9,18,77,77,48,3,60,"neutral",29,29,-1,17
9,19,77,77,49,4,70,"positive",28,28,-1,7
9,20,60,58,44,3,60,"neutral",16,16,-1,0
9,21,50,35,33,4,38,"positive",17,17,-1,12
9,22,50,50,51,2,30,"negative",-1,1,1,-20
9,23,38,32,37,3,32,"neutral",1,1,-1,6
9,24,40,45,43,4,58,"positive",-3,3,1,18
9,25,25,18,39,2,25,"negative",-14,14,1,0
9,26,58,55,35,3,25,"neutral",23,23,-1,33
9,27,58,55,30,3,32,"neutral",28,28,-1,26
9,28,40,32,70,4,65,"positive",-30,30,1,25
9,29,25,18,10,4,40,"positive",15,15,-1,-15
9,30,3,28,23,3,3,"neutral",-20,20,1,0
9,31,58,58,23,4,60,"positive",35,35,-1,-2
9,32,35,30,36,3,58,"neutral",-1,1,1,23
9,33,58,55,33,4,65,"positive",25,25,-1,-7
9,34,38,30,36,3,35,"neutral",2,2,-1,3
9,35,3,50,45,1,3,"negative",-42,42,1,0
9,36,77,70,43,4,70,"positive",34,34,-1,7
9,37,18,20,38,3,50,"neutral",-20,20,1,32
9,38,20,20,33,2,38,"negative",-13,13,1,18
9,39,38,38,47,3,35,"neutral",-9,9,1,-3
10,1,3,28,56,4,22,"positive",-53,53,1,19
10,2,3,48,29,4,22,"positive",-26,26,1,19
10,3,32,23,20,3,52,"neutral",12,12,-1,-20
10,4,76,68,17,2,65,"negative",59,59,-1,11
10,5,77,54,38,4,77,"positive",39,39,-1,0
10,6,38,40,26,2,11,"negative",12,12,-1,27
10,7,44,51,62,4,65,"positive",-18,18,1,21
10,8,12,35,59,4,36,"positive",-47,47,1,24
10,9,34,38,65,2,43,"negative",-31,31,1,9
10,10,67,32,55,2,43,"negative",12,12,-1,24
10,11,70,61,52,3,67,"neutral",18,18,-1,3
10,12,60,55,48,4,33,"positive",12,12,-1,27
10,13,3,23,30,4,11,"positive",-27,27,1,8
10,14,56,55,55,4,56,"positive",1,1,-1,0
10,15,70,68,42,3,68,"neutral",28,28,-1,2
10,16,70,64,32,3,34,"neutral",38,38,-1,36
10,17,13,21,41,3,34,"neutral",-28,28,1,21
10,18,40,75,48,4,66,"positive",-8,8,1,26
10,19,76,35,49,4,67,"positive",27,27,-1,9
10,20,56,35,44,3,43,"neutral",12,12,-1,13
10,21,65,60,33,5,56,"positive",32,32,-1,9
10,22,14,16,51,4,59,"positive",-37,37,1,45
10,23,24,37,37,3,32,"neutral",-13,13,1,8
10,24,11,25,43,3,34,"neutral",-32,32,1,23
10,25,23,54,39,2,32,"negative",-16,16,1,9
10,26,43,57,35,4,47,"positive",8,8,-1,-4
10,27,54,51,30,2,56,"negative",24,24,-1,-2
10,28,53,43,70,4,65,"positive",-17,17,1,12
10,29,33,38,10,4,24,"positive",23,23,-1,9
10,30,70,65,23,3,38,"neutral",47,47,-1,32
10,31,49,58,23,3,23,"neutral",26,26,-1,26
10,32,3,10,36,2,21,"negative",-33,33,1,18
10,33,23,45,33,3,47,"neutral",-10,10,1,24
10,34,4,3,36,4,28,"positive",-32,32,1,24
10,35,43,67,45,3,3,"neutral",-2,2,1,-40
10,36,3,25,43,2,3,"negative",-40,40,1,0
10,37,44,32,38,3,65,"neutral",6,6,-1,-21
10,38,57,60,33,3,32,"neutral",24,24,-1,25
10,39,10,45,47,3,44,"neutral",-37,37,1,34
11,1,24,21,56,3,3,"neutral",-32,32,1,-21
11,2,3,20,29,4,10,"positive",-26,26,1,7
11,3,60,54,20,3,59,"neutral",40,40,-1,1
11,4,60,70,17,2,70,"negative",43,43,-1,-10
11,5,60,50,38,5,17,"positive",22,22,-1,43
11,6,67,48,26,3,65,"neutral",41,41,-1,2
11,7,21,28,62,3,21,"neutral",-41,41,1,0
11,8,36,35,59,3,50,"neutral",-23,23,1,14
11,9,20,28,65,3,57,"neutral",-45,45,1,37
11,10,60,54,55,2,65,"negative",5,5,-1,-5
11,11,30,31,52,1,50,"negative",-22,22,1,20
11,12,40,40,48,3,43,"neutral",-8,8,1,3
11,13,25,11,30,3,10,"neutral",-5,5,1,-15
11,14,77,77,55,3,35,"neutral",22,22,-1,42
11,15,77,58,42,5,70,"positive",35,35,-1,7
11,16,69,59,32,3,34,"neutral",37,37,-1,35
11,17,18,20,41,3,30,"neutral",-23,23,1,12
11,18,70,70,48,3,60,"neutral",22,22,-1,10
11,19,40,49,49,3,39,"neutral",-9,9,1,-1
11,20,30,20,44,3,32,"neutral",-14,14,1,2
11,21,35,40,33,4,28,"positive",2,2,-1,7
11,22,30,40,51,2,60,"negative",-21,21,1,30
11,23,39,29,37,3,58,"neutral",2,2,-1,-19
11,24,10,40,43,5,59,"positive",-33,33,1,49
11,25,50,50,39,3,39,"neutral",11,11,-1,11
11,26,68,56,35,3,49,"neutral",33,33,-1,19
11,27,20,31,30,3,38,"neutral",-10,10,1,18
11,28,40,30,70,3,28,"neutral",-30,30,1,-12
11,29,40,50,10,3,34,"neutral",30,30,-1,6
11,30,10,10,23,3,28,"neutral",-13,13,1,18
11,31,47,50,23,3,42,"neutral",24,24,-1,5
11,32,54,46,36,3,54,"neutral",18,18,-1,0
11,33,20,26,33,3,49,"neutral",-13,13,1,29
11,34,59,59,36,3,26,"neutral",23,23,-1,33
11,35,58,53,45,5,68,"positive",13,13,-1,-10
11,36,60,61,43,2,69,"negative",17,17,-1,-9
11,37,60,63,38,3,68,"neutral",22,22,-1,-8
11,38,30,28,33,3,43,"neutral",-3,3,1,13
11,39,48,38,47,2,49,"negative",1,1,-1,-1
12,1,77,40,56,3,65,"neutral",21,21,-1,12
12,2,20,55,29,4,35,"positive",-9,9,1,15
12,3,60,50,20,3,50,"neutral",40,40,-1,10
12,4,77,77,17,3,70,"neutral",60,60,-1,7
12,5,30,50,38,4,35,"positive",-8,8,1,5
12,6,50,60,26,2,20,"negative",24,24,-1,30
12,7,55,55,62,3,50,"neutral",-7,7,1,-5
12,8,60,50,59,4,40,"positive",1,1,-1,20
12,9,50,50,65,2,36,"negative",-15,15,1,-14
12,10,65,65,55,2,60,"negative",10,10,-1,5
12,11,20,60,52,2,50,"negative",-32,32,1,30
12,12,10,33,48,3,40,"neutral",-38,38,1,30
12,13,3,20,30,2,3,"negative",-27,27,1,0
12,14,3,40,55,3,50,"neutral",-52,52,1,47
12,15,77,77,42,4,70,"positive",35,35,-1,7
12,16,77,77,32,4,77,"positive",45,45,-1,0
12,17,30,30,41,3,40,"neutral",-11,11,1,10
12,18,60,60,48,3,20,"neutral",12,12,-1,40
12,19,60,40,49,4,77,"positive",11,11,-1,-17
12,20,40,40,44,3,56,"neutral",-4,4,1,16
12,21,30,60,33,4,35,"positive",-3,3,1,5
12,22,60,65,51,3,70,"neutral",9,9,-1,-10
12,23,40,45,37,3,40,"neutral",3,3,-1,0
12,24,35,35,43,4,45,"positive",-8,8,1,10
12,25,50,50,39,3,40,"neutral",11,11,-1,10
12,26,77,65,35,3,30,"neutral",42,42,-1,47
12,27,65,65,30,3,45,"neutral",35,35,-1,20
12,28,40,50,70,4,55,"positive",-30,30,1,15
12,29,55,50,10,3,40,"neutral",45,45,-1,15
12,30,50,20,23,4,40,"positive",27,27,-1,10
12,31,70,30,23,3,40,"neutral",47,47,-1,30
12,32,5,3,36,2,10,"negative",-31,31,1,5
12,33,77,77,33,4,38,"positive",44,44,-1,39
12,34,77,77,36,3,40,"neutral",41,41,-1,37
12,35,65,60,45,4,65,"positive",20,20,-1,0
12,36,77,77,43,4,70,"positive",34,34,-1,7
12,37,69,70,38,4,40,"positive",31,31,-1,29
12,38,20,10,33,4,25,"positive",-13,13,1,5
12,39,40,50,47,3,50,"neutral",-7,7,1,10
13,1,30,45,56,5,35,"positive",-26,26,1,5
13,2,30,36,29,4,31,"positive",1,1,-1,-1
13,3,70,3,20,4,45,"positive",50,50,-1,25
13,4,77,50,17,3,50,"neutral",60,60,-1,27
13,5,62,50,38,5,36,"positive",24,24,-1,26
13,6,40,35,26,2,31,"negative",14,14,-1,9
13,7,30,35,62,3,45,"neutral",-32,32,1,15
13,8,50,55,59,5,50,"positive",-9,9,1,0
13,9,40,60,65,3,45,"neutral",-25,25,1,5
13,10,35,40,55,2,35,"negative",-20,20,1,0
13,11,50,45,52,5,45,"positive",-2,2,1,-5
13,12,30,35,48,4,35,"positive",-18,18,1,5
13,13,32,35,30,3,30,"neutral",2,2,-1,2
13,14,60,60,55,5,65,"positive",5,5,-1,-5
13,15,60,60,42,4,40,"positive",18,18,-1,20
13,16,35,40,32,3,30,"neutral",3,3,-1,5
13,17,40,42,41,4,45,"positive",-1,1,1,5
13,18,50,60,48,3,35,"neutral",2,2,-1,15
13,19,32,30,49,3,30,"neutral",-17,17,1,-2
13,20,50,50,44,3,45,"neutral",6,6,-1,5
13,21,40,46,33,5,35,"positive",7,7,-1,5
13,22,30,32,51,4,40,"positive",-21,21,1,10
13,23,30,30,37,3,30,"neutral",-7,7,1,0
13,24,50,55,43,4,40,"positive",7,7,-1,10
13,25,35,40,39,3,60,"neutral",-4,4,1,25
13,26,60,60,35,3,35,"neutral",25,25,-1,25
13,27,40,40,30,3,40,"neutral",10,10,-1,0
13,28,60,60,70,4,50,"positive",-10,10,1,-10
13,29,40,40,10,5,30,"positive",30,30,-1,10
13,30,30,50,23,3,35,"neutral",7,7,-1,-5
13,31,40,45,23,3,30,"neutral",17,17,-1,10
13,32,30,30,36,3,32,"neutral",-6,6,1,2
13,33,60,42,33,5,50,"positive",27,27,-1,10
13,34,30,40,36,4,30,"positive",-6,6,1,0
13,35,30,42,45,5,30,"positive",-15,15,1,0
13,36,30,31,43,1,30,"negative",-13,13,1,0
13,37,60,50,38,3,40,"neutral",22,22,-1,20
13,38,50,50,33,3,50,"neutral",17,17,-1,0
13,39,40,40,47,2,35,"negative",-7,7,1,-5
14,1,3,35,56,3,3,"neutral",-53,53,1,0
14,2,3,45,29,3,3,"neutral",-26,26,1,0
14,3,18,18,20,5,20,"positive",-2,2,1,2
14,4,70,55,17,3,77,"neutral",53,53,-1,-7
14,5,10,20,38,3,3,"neutral",-28,28,1,-7
14,6,15,30,26,3,10,"neutral",-11,11,1,-5
14,7,45,45,62,5,60,"positive",-17,17,1,15
14,8,35,38,59,3,15,"neutral",-24,24,1,-20
14,9,18,15,65,3,30,"neutral",-47,47,1,12
14,10,25,30,55,3,15,"neutral",-30,30,1,-10
14,11,60,45,52,3,77,"neutral",8,8,-1,-17
14,12,36,36,48,3,45,"neutral",-12,12,1,9
14,13,25,30,30,3,30,"neutral",-5,5,1,5
14,14,50,50,55,5,35,"positive",-5,5,1,-15
14,15,28,40,42,3,28,"neutral",-14,14,1,0
14,16,20,35,32,3,45,"neutral",-12,12,1,25
14,17,70,65,41,3,60,"neutral",29,29,-1,10
14,18,77,77,48,5,70,"positive",29,29,-1,7
14,19,40,40,49,3,60,"neutral",-9,9,1,20
14,20,54,40,44,3,50,"neutral",10,10,-1,4
14,21,20,15,33,4,50,"positive",-13,13,1,30
14,22,30,30,51,3,15,"neutral",-21,21,1,-15
14,23,20,28,37,3,15,"neutral",-17,17,1,-5
14,24,60,60,43,3,60,"neutral",17,17,-1,0
14,25,20,20,39,3,30,"neutral",-19,19,1,10
14,26,55,55,35,3,40,"neutral",20,20,-1,15
14,27,20,18,30,4,55,"positive",-10,10,1,35
14,28,20,60,70,3,70,"neutral",-50,50,1,50
14,29,10,14,10,4,25,"positive",0,0,0,0
14,30,3,10,23,3,3,"neutral",-20,20,1,0
14,31,30,55,23,3,35,"neutral",7,7,-1,-5
14,32,15,35,36,3,50,"neutral",-21,21,1,35
14,33,77,55,33,4,77,"positive",44,44,-1,0
14,34,25,20,36,3,30,"neutral",-11,11,1,5
14,35,60,50,45,3,74,"neutral",15,15,-1,-14
14,36,3,40,43,1,3,"negative",-40,40,1,0
14,37,20,40,38,3,10,"neutral",-18,18,1,-10
14,38,60,60,33,3,45,"neutral",27,27,-1,15
14,39,60,55,47,3,70,"neutral",13,13,-1,-10
15,1,75,70,56,4,70,"positive",19,19,-1,5
15,2,60,55,29,4,55,"positive",31,31,-1,5
15,3,50,50,20,3,55,"neutral",30,30,-1,-5
15,4,30,40,17,2,38,"negative",13,13,-1,-8
15,5,40,50,38,4,45,"positive",2,2,-1,-5
15,6,25,30,26,2,25,"negative",-1,1,1,0
15,7,60,50,62,4,60,"positive",-2,2,1,0
15,8,35,40,59,3,50,"neutral",-24,24,1,15
15,9,45,50,65,2,60,"negative",-20,20,1,15
15,10,70,60,55,2,55,"negative",15,15,-1,15
15,11,75,55,52,4,75,"positive",23,23,-1,0
15,12,75,75,48,3,60,"neutral",27,27,-1,15
15,13,25,30,30,4,25,"positive",-5,5,1,0
15,14,35,35,55,3,38,"neutral",-20,20,1,3
15,15,77,50,42,4,77,"positive",35,35,-1,0
15,16,70,75,32,4,60,"positive",38,38,-1,10
15,17,38,35,41,3,38,"neutral",-3,3,1,0
15,18,65,55,48,3,45,"neutral",17,17,-1,20
15,19,55,50,49,3,35,"neutral",6,6,-1,20
15,20,40,35,44,3,45,"neutral",-4,4,1,5
15,21,50,45,33,3,55,"neutral",17,17,-1,-5
15,22,20,25,51,3,60,"neutral",-31,31,1,40
15,23,30,25,37,2,38,"negative",-7,7,1,8
15,24,55,45,43,3,60,"neutral",12,12,-1,-5
15,25,50,55,39,3,50,"neutral",11,11,-1,0
15,26,68,70,35,3,30,"neutral",33,33,-1,38
15,27,50,45,30,3,50,"neutral",20,20,-1,0
15,28,58,55,70,4,65,"positive",-12,12,1,7
15,29,50,55,10,3,40,"neutral",40,40,-1,10
15,30,40,40,23,3,45,"neutral",17,17,-1,-5
15,31,55,50,23,3,30,"neutral",32,32,-1,25
15,32,40,43,36,3,30,"neutral",4,4,-1,10
15,33,35,32,33,4,40,"positive",2,2,-1,-5
15,34,35,40,36,3,40,"neutral",-1,1,1,5
15,35,60,45,45,4,65,"positive",15,15,-1,-5
15,36,60,60,43,2,35,"negative",17,17,-1,25
15,37,35,30,38,4,50,"positive",-3,3,1,15
15,38,50,50,33,3,35,"neutral",17,17,-1,15
15,39,50,65,47,2,38,"negative",3,3,-1,12
16,1,3,30,56,3,3,"neutral",-53,53,1,0
16,2,10,20,29,4,20,"positive",-19,19,1,10
16,3,50,50,20,3,50,"neutral",30,30,-1,0
16,4,70,50,17,3,60,"neutral",53,53,-1,10
16,5,30,30,38,4,20,"positive",-8,8,1,-10
16,6,10,40,26,2,10,"negative",-16,16,1,0
16,7,10,20,62,3,40,"neutral",-52,52,1,30
16,8,40,50,59,3,30,"neutral",-19,19,1,-10
16,9,20,10,65,3,30,"neutral",-45,45,1,10
16,10,40,40,55,2,60,"negative",-15,15,1,20
16,11,10,30,52,2,70,"negative",-42,42,1,60
16,12,70,50,48,3,50,"neutral",22,22,-1,20
16,13,20,20,30,3,20,"neutral",-10,10,1,0
16,14,40,40,55,3,50,"neutral",-15,15,1,10
16,15,3,70,42,3,3,"neutral",-39,39,1,0
16,16,30,40,32,3,20,"neutral",-2,2,1,-10
16,17,70,70,41,3,40,"neutral",29,29,-1,30
16,18,60,60,48,3,50,"neutral",12,12,-1,10
16,19,60,40,49,2,40,"negative",11,11,-1,20
16,20,20,30,44,3,60,"neutral",-24,24,1,40
16,21,30,50,33,3,50,"neutral",-3,3,1,20
16,22,30,40,51,2,50,"negative",-21,21,1,20
16,23,50,40,37,3,50,"neutral",13,13,-1,0
16,24,70,50,43,3,70,"neutral",27,27,-1,0
16,25,30,30,39,3,60,"neutral",-9,9,1,30
16,26,60,40,35,3,60,"neutral",25,25,-1,0
16,27,50,50,30,3,50,"neutral",20,20,-1,0
16,28,60,60,70,3,50,"neutral",-10,10,1,-10
16,29,40,40,10,3,50,"neutral",30,30,-1,-10
16,30,3,20,23,3,3,"neutral",-20,20,1,0
16,31,60,30,23,3,60,"neutral",37,37,-1,0
16,32,70,40,36,3,60,"neutral",34,34,-1,10
16,33,70,70,33,3,60,"neutral",37,37,-1,10
16,34,60,50,36,3,30,"neutral",24,24,-1,30
16,35,40,50,45,4,30,"positive",-5,5,1,-10
16,36,20,40,43,2,3,"negative",-23,23,1,-17
16,37,50,40,38,3,50,"neutral",12,12,-1,0
16,38,40,40,33,3,30,"neutral",7,7,-1,10
16,39,40,40,47,3,30,"neutral",-7,7,1,-10
17,1,10,50,56,5,15,"positive",-46,46,1,5
17,2,10,15,29,3,30,"neutral",-19,19,1,20
17,3,3,3,20,4,20,"positive",-17,17,1,17
17,4,30,45,17,2,17,"negative",13,13,-1,13
17,5,10,48,38,3,10,"neutral",-28,28,1,0
17,6,5,30,26,4,35,"positive",-21,21,1,30
17,7,48,40,62,3,40,"neutral",-14,14,1,-8
17,8,18,60,59,4,20,"positive",-41,41,1,2
17,9,10,25,65,2,56,"negative",-55,55,1,46
17,10,48,70,55,2,57,"negative",-7,7,1,9
17,11,15,20,52,4,40,"positive",-37,37,1,25
17,12,10,40,48,5,50,"positive",-38,38,1,40
17,13,14,9,30,3,47,"neutral",-16,16,1,33
17,14,60,68,55,4,38,"positive",5,5,-1,22
17,15,60,66,42,4,18,"positive",18,18,-1,42
17,16,30,58,32,4,24,"positive",-2,2,1,-6
17,17,35,52,41,4,48,"positive",-6,6,1,13
17,18,60,55,48,3,47,"neutral",12,12,-1,13
17,19,50,50,49,4,50,"positive",1,1,-1,0
17,20,28,38,44,4,30,"positive",-16,16,1,2
17,21,30,50,33,3,40,"neutral",-3,3,1,10
17,22,20,20,51,2,56,"negative",-31,31,1,36
17,23,45,50,37,3,40,"neutral",8,8,-1,5
17,24,25,49,43,4,45,"positive",-18,18,1,20
17,25,10,20,39,2,47,"negative",-29,29,1,37
17,26,25,30,35,4,14,"positive",-10,10,1,-11
17,27,45,40,30,3,17,"neutral",15,15,-1,28
17,28,5,21,70,4,40,"positive",-65,65,1,35
17,29,25,60,10,2,20,"negative",15,15,-1,5
17,30,4,3,23,2,21,"negative",-19,19,1,17
17,31,70,70,23,3,20,"neutral",47,47,-1,50
17,32,15,12,36,4,30,"positive",-21,21,1,15
17,33,60,60,33,4,66,"positive",27,27,-1,-6
17,34,66,52,36,4,20,"positive",30,30,-1,46
17,35,55,45,45,4,60,"positive",10,10,-1,-5
17,36,4,4,43,4,30,"positive",-39,39,1,26
17,37,3,4,38,4,40,"positive",-35,35,1,37
17,38,36,44,33,4,50,"positive",3,3,-1,-14
17,39,45,60,47,4,40,"positive",-2,2,1,-5
18,1,20,30,56,4,30,"positive",-36,36,1,10
18,2,77,40,29,5,77,"positive",48,48,-1,0
18,3,30,30,20,4,30,"positive",10,10,-1,0
18,4,60,40,17,3,55,"neutral",43,43,-1,5
18,5,10,30,38,2,10,"negative",-28,28,1,0
18,6,20,30,26,2,15,"negative",-6,6,1,-5
18,7,40,40,62,4,50,"positive",-22,22,1,10
18,8,50,55,59,4,50,"positive",-9,9,1,0
18,9,20,20,65,2,40,"negative",-45,45,1,20
18,10,50,30,55,2,50,"negative",-5,5,1,0
18,11,70,50,52,4,50,"positive",18,18,-1,20
18,12,45,40,48,4,45,"positive",-3,3,1,0
18,13,10,15,30,2,10,"negative",-20,20,1,0
18,14,50,40,55,5,60,"positive",-5,5,1,10
18,15,10,30,42,3,10,"neutral",-32,32,1,0
18,16,70,60,32,4,60,"positive",38,38,-1,10
18,17,40,50,41,3,30,"neutral",-1,1,1,-10
18,18,35,40,48,3,35,"neutral",-13,13,1,0
18,19,10,15,49,3,30,"neutral",-39,39,1,20
18,20,40,30,44,3,45,"neutral",-4,4,1,5
18,21,40,35,33,4,35,"positive",7,7,-1,5
18,22,40,50,51,1,45,"negative",-11,11,1,5
18,23,30,30,37,2,30,"negative",-7,7,1,0
18,24,50,40,43,3,55,"neutral",7,7,-1,-5
18,25,10,15,39,3,20,"neutral",-29,29,1,10
18,26,60,50,35,4,35,"positive",25,25,-1,25
18,27,40,35,30,4,35,"positive",10,10,-1,5
18,28,30,20,70,3,35,"neutral",-40,40,1,5
18,29,40,40,10,4,30,"positive",30,30,-1,10
18,30,20,20,23,4,15,"positive",-3,3,1,-5
18,31,60,60,23,3,40,"neutral",37,37,-1,20
18,32,20,15,36,3,30,"neutral",-16,16,1,10
18,33,40,35,33,3,40,"neutral",7,7,-1,0
18,34,20,20,36,4,50,"positive",-16,16,1,30
18,35,60,40,45,4,70,"positive",15,15,-1,-10
18,36,40,30,43,4,35,"positive",-3,3,1,-5
18,37,50,40,38,2,30,"negative",12,12,-1,20
18,38,60,65,33,3,40,"neutral",27,27,-1,20
18,39,30,20,47,2,40,"negative",-17,17,1,10
19,1,77,70,56,3,50,"neutral",21,21,-1,27
19,2,3,25,29,3,3,"neutral",-26,26,1,0
19,3,30,35,20,3,20,"neutral",10,10,-1,10
19,4,77,77,17,4,30,"positive",60,60,-1,47
19,5,3,50,38,3,35,"neutral",-35,35,1,32
19,6,3,20,26,2,25,"negative",-23,23,1,22
19,7,5,30,62,3,65,"neutral",-57,57,1,60
19,8,3,10,59,3,65,"neutral",-56,56,1,62
19,9,3,20,65,3,60,"neutral",-62,62,1,57
19,10,3,65,55,1,10,"negative",-52,52,1,7
19,11,10,45,52,3,10,"neutral",-42,42,1,0
19,12,3,30,48,3,45,"neutral",-45,45,1,42
19,13,9,20,30,4,35,"positive",-21,21,1,26
19,14,3,5,55,3,45,"neutral",-52,52,1,42
19,15,30,55,42,3,35,"neutral",-12,12,1,5
19,16,50,60,32,3,20,"neutral",18,18,-1,30
19,17,20,35,41,3,10,"neutral",-21,21,1,-10
19,18,77,77,48,3,35,"neutral",29,29,-1,42
19,19,77,45,49,3,30,"neutral",28,28,-1,47
19,20,3,60,44,3,10,"neutral",-41,41,1,7
19,21,10,25,33,3,35,"neutral",-23,23,1,25
19,22,60,55,51,3,20,"neutral",9,9,-1,40
19,23,5,10,37,3,30,"neutral",-32,32,1,25
19,24,10,25,43,3,30,"neutral",-33,33,1,20
19,25,50,30,39,3,35,"neutral",11,11,-1,15
19,26,40,55,35,3,35,"neutral",5,5,-1,5
19,27,60,65,30,3,20,"neutral",30,30,-1,40
19,28,30,45,70,3,25,"neutral",-40,40,1,-5
19,29,60,65,10,3,25,"neutral",50,50,-1,35
19,30,40,45,23,3,10,"neutral",17,17,-1,30
19,31,20,45,23,3,30,"neutral",-3,3,1,10
19,32,3,10,36,2,25,"negative",-33,33,1,22
19,33,20,35,33,3,30,"neutral",-13,13,1,10
19,34,3,40,36,3,30,"neutral",-33,33,1,27
19,35,3,70,45,3,25,"neutral",-42,42,1,22
19,36,3,65,43,2,3,"negative",-40,40,1,0
19,37,10,15,38,3,25,"neutral",-28,28,1,15
19,38,25,45,33,3,20,"neutral",-8,8,1,-5
19,39,3,10,47,3,35,"neutral",-44,44,1,32
20,1,6,5,56,4,5,"positive",-50,50,1,-1
20,2,6,6,29,4,6,"positive",-23,23,1,0
20,3,4,5,20,3,4,"neutral",-16,16,1,0
20,4,6,7,17,4,7,"positive",-11,11,1,1
20,5,3,3,38,2,3,"negative",-35,35,1,0
20,6,3,4,26,2,3,"negative",-23,23,1,0
20,7,3,3,62,2,4,"negative",-59,59,1,1
20,8,3,5,59,3,4,"neutral",-56,56,1,1
20,9,4,5,65,3,4,"neutral",-61,61,1,0
20,10,6,4,55,4,5,"positive",-49,49,1,-1
20,11,3,3,52,2,3,"negative",-49,49,1,0
20,12,5,5,48,3,4,"neutral",-43,43,1,-1
20,13,3,4,30,3,4,"neutral",-27,27,1,1
20,14,3,3,55,2,3,"negative",-52,52,1,0
20,15,6,5,42,4,6,"positive",-36,36,1,0
20,16,6,6,32,4,5,"positive",-26,26,1,-1
20,17,3,4,41,2,4,"negative",-38,38,1,1
20,18,5,5,48,3,5,"neutral",-43,43,1,0
20,19,3,3,49,2,3,"negative",-46,46,1,0
20,20,4,3,44,3,4,"neutral",-40,40,1,0
20,21,6,5,33,2,3,"negative",-27,27,1,-3
20,22,6,6,51,5,6,"positive",-45,45,1,0
20,23,3,4,37,2,5,"negative",-34,34,1,2
20,24,5,4,43,3,5,"neutral",-38,38,1,0
20,25,6,3,39,4,6,"positive",-33,33,1,0
20,26,5,5,35,3,5,"neutral",-30,30,1,0
20,27,4,4,30,3,5,"neutral",-26,26,1,1
20,28,6,5,70,4,3,"positive",-64,64,1,-3
20,29,6,5,10,4,4,"positive",-4,4,1,-2
20,30,5,5,23,3,4,"neutral",-18,18,1,-1
20,31,6,6,23,4,6,"positive",-17,17,1,0
20,32,3,3,36,1,6,"negative",-33,33,1,3
20,33,3,4,33,3,3,"neutral",-30,30,1,0
20,34,5,4,36,3,4,"neutral",-31,31,1,-1
20,35,6,6,45,4,5,"positive",-39,39,1,-1
20,36,3,3,43,2,3,"negative",-40,40,1,0
20,37,3,4,38,2,6,"negative",-35,35,1,3
20,38,5,4,33,5,4,"positive",-28,28,1,-1
20,39,4,4,47,3,5,"neutral",-43,43,1,1
21,1,4,76,56,3,3,"neutral",-52,52,1,-1
21,2,50,40,29,4,65,"positive",21,21,-1,-15
21,3,65,60,20,4,47,"positive",45,45,-1,18
21,4,68,60,17,3,60,"neutral",51,51,-1,8
21,5,10,8,38,4,8,"positive",-28,28,1,-2
21,6,33,45,26,3,25,"neutral",7,7,-1,8
21,7,40,50,62,3,50,"neutral",-22,22,1,10
21,8,40,40,59,3,50,"neutral",-19,19,1,10
21,9,30,30,65,3,38,"neutral",-35,35,1,8
21,10,56,52,55,2,55,"negative",1,1,-1,1
21,11,5,9,52,2,30,"negative",-47,47,1,25
21,12,48,50,48,3,40,"neutral",0,0,0,0
21,13,14,20,30,2,4,"negative",-16,16,1,-10
21,14,30,30,55,4,45,"positive",-25,25,1,15
21,15,3,30,42,3,3,"neutral",-39,39,1,0
21,16,67,45,32,4,68,"positive",35,35,-1,-1
21,17,23,26,41,4,47,"positive",-18,18,1,24
21,18,60,60,48,3,45,"neutral",12,12,-1,15
21,19,60,40,49,3,30,"neutral",11,11,-1,30
21,20,45,45,44,3,20,"neutral",1,1,-1,25
21,21,39,30,33,3,48,"neutral",6,6,-1,-9
21,22,34,34,51,2,35,"negative",-17,17,1,1
21,23,69,69,37,3,38,"neutral",32,32,-1,31
21,24,70,70,43,3,25,"neutral",27,27,-1,45
21,25,46,46,39,3,45,"neutral",7,7,-1,1
21,26,55,55,35,4,39,"positive",20,20,-1,16
21,27,50,50,30,3,20,"neutral",20,20,-1,30
21,28,20,45,70,3,67,"neutral",-50,50,1,47
21,29,33,33,10,3,22,"neutral",23,23,-1,11
21,30,4,4,23,3,33,"neutral",-19,19,1,29
21,31,20,24,23,3,36,"neutral",-3,3,1,16
21,32,77,50,36,3,77,"neutral",41,41,-1,0
21,33,30,29,33,4,33,"positive",-3,3,1,3
21,34,32,19,36,3,36,"neutral",-4,4,1,4
21,35,68,60,45,4,67,"positive",23,23,-1,1
21,36,3,20,43,2,3,"negative",-40,40,1,0
21,37,65,70,38,3,20,"neutral",27,27,-1,45
21,38,40,40,33,3,34,"neutral",7,7,-1,6
21,39,40,40,47,2,49,"negative",-7,7,1,9
22,1,5,6,56,3,4,"neutral",-51,51,1,-1
22,2,3,4,29,3,4,"neutral",-26,26,1,1
22,3,5,6,20,2,4,"negative",-15,15,1,-1
22,4,3,4,17,3,4,"neutral",-14,14,1,1
22,5,5,6,38,4,6,"positive",-33,33,1,1
22,6,3,6,26,2,4,"negative",-23,23,1,1
22,7,6,8,62,4,6,"positive",-56,56,1,0
22,8,4,5,59,3,5,"neutral",-55,55,1,1
22,9,4,5,65,3,4,"neutral",-61,61,1,0
22,10,3,4,55,2,3,"negative",-52,52,1,0
22,11,3,4,52,2,3,"negative",-49,49,1,0
22,12,4,5,48,3,3,"neutral",-44,44,1,-1
22,13,4,5,30,3,4,"neutral",-26,26,1,0
22,14,4,8,55,2,6,"negative",-51,51,1,2
22,15,4,5,42,2,4,"negative",-38,38,1,0
22,16,4,6,32,4,5,"positive",-28,28,1,1
22,17,3,4,41,3,5,"neutral",-38,38,1,2
22,18,3,4,48,3,4,"neutral",-45,45,1,1
22,19,3,4,49,3,4,"neutral",-46,46,1,1
22,20,4,5,44,3,3,"neutral",-40,40,1,-1
22,21,3,4,33,4,3,"positive",-30,30,1,0
22,22,3,5,51,2,4,"negative",-48,48,1,1
22,23,3,4,37,4,4,"positive",-34,34,1,1
22,24,6,8,43,3,5,"neutral",-37,37,1,-1
22,25,5,6,39,1,5,"negative",-34,34,1,0
22,26,4,5,35,3,5,"neutral",-31,31,1,1
22,27,4,6,30,2,4,"negative",-26,26,1,0
22,28,3,4,70,3,3,"neutral",-67,67,1,0
22,29,5,7,10,4,3,"positive",-5,5,1,-2
22,30,5,6,23,3,5,"neutral",-18,18,1,0
22,31,4,6,23,3,5,"neutral",-19,19,1,1
22,32,4,5,36,1,5,"negative",-32,32,1,1
22,33,3,4,33,2,4,"negative",-30,30,1,1
22,34,3,4,36,3,4,"neutral",-33,33,1,1
22,35,5,6,45,3,4,"neutral",-40,40,1,-1
22,36,4,6,43,2,4,"negative",-39,39,1,0
22,37,6,7,38,3,4,"neutral",-32,32,1,-2
22,38,4,6,33,3,5,"neutral",-29,29,1,1
22,39,6,7,47,3,3,"neutral",-41,41,1,-3
23,1,3,50,56,4,48,"positive",-53,53,1,45
23,2,6,26,29,3,3,"neutral",-23,23,1,-3
23,3,60,75,20,3,41,"neutral",40,40,-1,19
23,4,77,70,17,1,77,"negative",60,60,-1,0
23,5,36,40,38,4,69,"positive",-2,2,1,33
23,6,10,30,26,2,20,"negative",-16,16,1,10
23,7,5,10,62,3,45,"neutral",-57,57,1,40
23,8,38,40,59,3,36,"neutral",-21,21,1,-2
23,9,60,65,65,2,45,"negative",-5,5,1,-15
23,10,65,65,55,2,58,"negative",10,10,-1,7
23,11,3,10,52,4,39,"positive",-49,49,1,36
23,12,50,50,48,3,41,"neutral",2,2,-1,9
23,13,50,50,30,3,38,"neutral",20,20,-1,12
23,14,30,40,55,4,52,"positive",-25,25,1,22
23,15,3,59,42,3,3,"neutral",-39,39,1,0
23,16,3,70,32,3,38,"neutral",-29,29,1,35
23,17,3,3,41,2,49,"negative",-38,38,1,46
23,18,10,25,48,4,38,"positive",-38,38,1,28
23,19,50,45,49,4,60,"positive",1,1,-1,-10
23,20,30,55,44,3,35,"neutral",-14,14,1,5
23,21,50,50,33,4,63,"positive",17,17,-1,-13
23,22,3,6,51,4,28,"positive",-48,48,1,25
23,23,40,48,37,3,50,"neutral",3,3,-1,-10
23,24,6,35,43,3,52,"neutral",-37,37,1,46
23,25,50,45,39,2,52,"negative",11,11,-1,-2
23,26,60,60,35,3,35,"neutral",25,25,-1,25
23,27,50,39,30,3,41,"neutral",20,20,-1,9
23,28,63,65,70,4,45,"positive",-7,7,1,-18
23,29,60,50,10,4,65,"positive",50,50,-1,-5
23,30,50,50,23,3,23,"neutral",27,27,-1,27
23,31,50,45,23,3,46,"neutral",27,27,-1,4
23,32,20,35,36,2,42,"negative",-16,16,1,22
23,33,50,70,33,2,39,"negative",17,17,-1,11
23,34,60,45,36,3,47,"neutral",24,24,-1,13
23,35,77,68,45,3,71,"neutral",32,32,-1,6
23,36,15,48,43,4,38,"positive",-28,28,1,23
23,37,20,42,38,3,49,"neutral",-18,18,1,29
23,38,40,30,33,2,43,"negative",7,7,-1,-3
23,39,71,69,47,2,52,"negative",24,24,-1,19
24,1,42,70,56,3,42,"neutral",-14,14,1,0
24,2,15,26,29,3,21,"neutral",-14,14,1,6
24,3,38,52,20,4,20,"positive",18,18,-1,18
24,4,77,71,17,4,17,"positive",60,60,-1,60
24,5,35,26,38,5,25,"positive",-3,3,1,-10
24,6,23,17,26,3,27,"neutral",-3,3,1,4
24,7,16,25,62,3,61,"neutral",-46,46,1,45
24,8,48,42,59,5,38,"positive",-11,11,1,-10
24,9,12,18,65,3,59,"neutral",-53,53,1,47
24,10,56,65,55,1,57,"negative",1,1,-1,-1
24,11,12,9,52,1,52,"negative",-40,40,1,40
24,12,23,39,48,3,25,"neutral",-25,25,1,2
24,13,3,20,30,3,32,"neutral",-27,27,1,29
24,14,77,70,55,5,20,"positive",22,22,-1,57
24,15,42,61,42,3,42,"neutral",0,0,0,0
24,16,62,55,32,3,17,"neutral",30,30,-1,45
24,17,55,57,41,3,51,"neutral",14,14,-1,4
24,18,25,42,48,3,58,"neutral",-23,23,1,33
24,19,77,65,49,2,21,"negative",28,28,-1,56
24,20,25,35,44,5,48,"positive",-19,19,1,23
24,21,18,20,33,5,52,"positive",-15,15,1,34
24,22,50,59,51,3,47,"neutral",-1,1,1,-3
24,23,25,37,37,2,26,"negative",-12,12,1,1
24,24,39,60,43,4,41,"positive",-4,4,1,2
24,25,38,42,39,3,35,"neutral",-1,1,1,-3
24,26,36,12,35,4,35,"positive",1,1,-1,1
24,27,34,36,30,3,27,"neutral",4,4,-1,7
24,28,25,36,70,4,45,"positive",-45,45,1,20
24,29,42,61,10,3,10,"neutral",32,32,-1,32
24,30,38,35,23,3,23,"neutral",15,15,-1,15
24,31,21,35,23,3,25,"neutral",-2,2,1,4
24,32,9,30,36,1,29,"negative",-27,27,1,20
24,33,47,49,33,3,21,"neutral",14,14,-1,26
24,34,42,35,36,3,32,"neutral",6,6,-1,10
24,35,50,65,45,4,39,"positive",5,5,-1,11
24,36,3,56,43,2,17,"negative",-40,40,1,14
24,37,56,40,38,1,37,"negative",18,18,-1,19
24,38,5,12,33,2,48,"negative",-28,28,1,43
24,39,9,35,47,1,42,"negative",-38,38,1,33
25,1,3,17,56,3,3,"neutral",-53,53,1,0
25,2,3,34,29,3,3,"neutral",-26,26,1,0
25,3,40,40,20,3,35,"neutral",20,20,-1,5
25,4,77,45,17,3,77,"neutral",60,60,-1,0
25,5,3,30,38,4,30,"positive",-35,35,1,27
25,6,12,12,26,2,12,"negative",-14,14,1,0
25,7,56,47,62,4,67,"positive",-6,6,1,11
25,8,30,45,59,3,67,"neutral",-29,29,1,37
25,9,34,45,65,3,49,"neutral",-31,31,1,15
25,10,50,56,55,1,57,"negative",-5,5,1,7
25,11,77,68,52,2,77,"negative",25,25,-1,0
25,12,58,67,48,3,56,"neutral",10,10,-1,2
25,13,3,12,30,3,3,"neutral",-27,27,1,0
25,14,77,59,55,3,45,"neutral",22,22,-1,32
25,15,77,58,42,3,56,"neutral",35,35,-1,21
25,16,50,56,32,3,77,"neutral",18,18,-1,-27
25,17,3,25,41,3,43,"neutral",-38,38,1,40
25,18,12,12,48,3,40,"neutral",-36,36,1,28
25,19,3,45,49,2,30,"negative",-46,46,1,27
25,20,30,30,44,3,45,"neutral",-14,14,1,15
25,21,77,67,33,4,77,"positive",44,44,-1,0
25,22,10,55,51,1,20,"negative",-41,41,1,10
25,23,5,33,37,3,45,"neutral",-32,32,1,40
25,24,77,77,43,3,67,"neutral",34,34,-1,10
25,25,5,20,39,3,30,"neutral",-34,34,1,25
25,26,66,66,35,3,39,"neutral",31,31,-1,27
25,27,77,33,30,5,40,"positive",47,47,-1,37
25,28,67,67,70,3,68,"neutral",-3,3,1,1
25,29,20,34,10,4,23,"positive",10,10,-1,-3
25,30,3,40,23,3,3,"neutral",-20,20,1,0
25,31,77,56,23,3,30,"neutral",54,54,-1,47
25,32,20,34,36,2,35,"negative",-16,16,1,15
25,33,67,56,33,3,56,"neutral",34,34,-1,11
25,34,34,37,36,2,43,"negative",-2,2,1,9
25,35,20,67,45,3,40,"neutral",-25,25,1,20
25,36,77,70,43,2,77,"negative",34,34,-1,0
25,37,55,3,38,3,59,"neutral",17,17,-1,-4
25,38,30,58,33,3,50,"neutral",-3,3,1,20
25,39,67,77,47,2,76,"negative",20,20,-1,-9
26,1,50,50,56,3,50,"neutral",-6,6,1,0
26,2,10,50,29,2,10,"negative",-19,19,1,0
26,3,40,35,20,3,35,"neutral",20,20,-1,5
26,4,60,60,17,3,70,"neutral",43,43,-1,-10
26,5,15,35,38,4,15,"positive",-23,23,1,0
26,6,35,25,26,3,30,"neutral",9,9,-1,5
26,7,60,60,62,4,60,"positive",-2,2,1,0
26,8,65,45,59,4,60,"positive",6,6,-1,5
26,9,30,30,65,4,25,"positive",-35,35,1,-5
26,10,15,35,55,2,20,"negative",-40,40,1,5
26,11,70,50,52,3,60,"neutral",18,18,-1,10
26,12,50,40,48,3,40,"neutral",2,2,-1,10
26,13,30,15,30,3,30,"neutral",0,0,0,0
26,14,60,60,55,4,50,"positive",5,5,-1,10
26,15,40,45,42,3,40,"neutral",-2,2,1,0
26,16,60,70,32,4,60,"positive",28,28,-1,0
26,17,30,20,41,3,30,"neutral",-11,11,1,0
26,18,50,50,48,3,50,"neutral",2,2,-1,0
26,19,20,20,49,4,30,"positive",-29,29,1,10
26,20,50,50,44,3,45,"neutral",6,6,-1,5
26,21,40,45,33,3,50,"neutral",7,7,-1,-10
26,22,56,60,51,4,50,"positive",5,5,-1,6
26,23,50,40,37,3,30,"neutral",13,13,-1,20
26,24,50,50,43,3,50,"neutral",7,7,-1,0
26,25,65,65,39,3,60,"neutral",26,26,-1,5
26,26,65,60,35,3,50,"neutral",30,30,-1,15
26,27,50,40,30,4,30,"positive",20,20,-1,20
26,28,60,60,70,4,50,"positive",-10,10,1,-10
26,29,60,55,10,3,60,"neutral",50,50,-1,0
26,30,40,20,23,4,30,"positive",17,17,-1,10
26,31,70,60,23,3,40,"neutral",47,47,-1,30
26,32,30,30,36,3,30,"neutral",-6,6,1,0
26,33,65,60,33,4,60,"positive",32,32,-1,5
26,34,40,40,36,3,40,"neutral",4,4,-1,0
26,35,60,50,45,4,50,"positive",15,15,-1,10
26,36,10,40,43,3,10,"neutral",-33,33,1,0
26,37,60,50,38,3,50,"neutral",22,22,-1,10
26,38,50,45,33,3,45,"neutral",17,17,-1,5
26,39,50,40,47,3,50,"neutral",3,3,-1,0
27,1,77,45,56,5,77,"positive",21,21,-1,0
27,2,33,77,29,3,25,"neutral",4,4,-1,8
27,3,77,40,20,3,60,"neutral",57,57,-1,17
27,4,77,60,17,1,77,"negative",60,60,-1,0
27,5,3,60,38,2,3,"negative",-35,35,1,0
27,6,77,48,26,2,60,"negative",51,51,-1,17
27,7,50,60,62,5,60,"positive",-12,12,1,10
27,8,60,35,59,3,60,"neutral",1,1,-1,0
27,9,30,50,65,2,30,"negative",-35,35,1,0
27,10,60,77,55,1,60,"negative",5,5,-1,0
27,11,60,60,52,1,77,"negative",8,8,-1,-17
27,12,20,65,48,3,40,"neutral",-28,28,1,20
27,13,3,45,30,4,3,"positive",-27,27,1,0
27,14,60,30,55,4,48,"positive",5,5,-1,12
27,15,48,30,42,2,40,"negative",6,6,-1,8
27,16,40,60,32,3,65,"neutral",8,8,-1,-25
27,17,40,35,41,2,60,"negative",-1,1,1,20
27,18,40,30,48,2,45,"negative",-8,8,1,5
27,19,60,40,49,4,60,"positive",11,11,-1,0
27,20,30,35,44,4,45,"positive",-14,14,1,15
27,21,48,35,33,1,50,"negative",15,15,-1,-2
27,22,50,58,51,1,60,"negative",-1,1,1,10
27,23,40,30,37,2,30,"negative",3,3,-1,10
27,24,45,60,43,1,60,"negative",2,2,-1,-15
27,25,58,58,39,3,40,"neutral",19,19,-1,18
27,26,55,65,35,2,55,"negative",20,20,-1,0
27,27,30,60,30,4,30,"positive",0,0,0,0
27,28,50,40,70,4,60,"positive",-20,20,1,10
27,29,65,65,10,5,50,"positive",55,55,-1,15
27,30,3,5,23,3,3,"neutral",-20,20,1,0
27,31,40,60,23,3,20,"neutral",17,17,-1,20
27,32,3,70,36,1,45,"negative",-33,33,1,42
27,33,60,55,33,3,55,"neutral",27,27,-1,5
27,34,15,47,36,4,38,"positive",-21,21,1,23
27,35,3,60,45,2,3,"negative",-42,42,1,0
27,36,20,20,43,1,3,"negative",-23,23,1,-17
27,37,77,77,38,2,65,"negative",39,39,-1,12
27,38,35,20,33,3,50,"neutral",2,2,-1,-15
27,39,20,20,47,2,30,"negative",-27,27,1,10
28,1,50,60,56,4,44,"positive",-6,6,1,-6
28,2,60,60,29,4,60,"positive",31,31,-1,0
28,3,70,70,20,5,29,"positive",50,50,-1,41
28,4,20,30,17,5,29,"positive",3,3,-1,-9
28,5,55,60,38,2,50,"negative",17,17,-1,5
28,6,55,55,26,4,59,"positive",29,29,-1,-4
28,7,30,30,62,4,55,"positive",-32,32,1,25
28,8,30,20,59,2,44,"negative",-29,29,1,14
28,9,33,32,65,2,55,"negative",-32,32,1,22
28,10,30,50,55,4,43,"positive",-25,25,1,13
28,11,20,60,52,3,33,"neutral",-32,32,1,13
28,12,50,60,48,4,56,"positive",2,2,-1,-6
28,13,50,40,30,3,55,"neutral",20,20,-1,-5
28,14,30,30,55,4,33,"positive",-25,25,1,3
28,15,20,20,42,3,30,"neutral",-22,22,1,10
28,16,60,60,32,5,30,"positive",28,28,-1,30
28,17,4,75,41,4,30,"positive",-37,37,1,26
28,18,40,40,48,4,30,"positive",-8,8,1,-10
28,19,40,50,49,2,55,"negative",-9,9,1,15
28,20,20,70,44,4,50,"positive",-24,24,1,30
28,21,36,40,33,3,38,"neutral",3,3,-1,-2
28,22,10,60,51,4,40,"positive",-41,41,1,30
28,23,50,50,37,4,29,"positive",13,13,-1,21
28,24,45,45,43,4,60,"positive",2,2,-1,-15
28,25,35,40,39,4,40,"positive",-4,4,1,5
28,26,50,50,35,2,29,"negative",15,15,-1,21
28,27,50,5,30,2,44,"negative",20,20,-1,6
28,28,30,35,70,3,33,"neutral",-40,40,1,3
28,29,45,40,10,2,59,"negative",35,35,-1,-14
28,30,40,40,23,3,29,"neutral",17,17,-1,11
28,31,35,40,23,3,60,"neutral",12,12,-1,-25
28,32,69,69,36,3,30,"neutral",33,33,-1,39
28,33,64,65,33,4,20,"positive",31,31,-1,44
28,34,60,60,36,3,30,"neutral",24,24,-1,30
28,35,10,77,45,3,39,"neutral",-35,35,1,29
28,36,35,30,43,4,55,"positive",-8,8,1,20
28,37,45,60,38,4,39,"positive",7,7,-1,6
28,38,20,50,33,4,22,"positive",-13,13,1,2
28,39,13,13,47,5,45,"positive",-34,34,1,32
29,1,55,35,56,3,55,"neutral",-1,1,1,0
29,2,55,55,29,2,55,"negative",26,26,-1,0
29,3,50,70,20,2,70,"negative",30,30,-1,-20
29,4,50,33,17,3,20,"neutral",33,33,-1,30
29,5,5,20,38,2,10,"negative",-33,33,1,5
29,6,50,55,26,4,30,"positive",24,24,-1,20
29,7,40,48,62,4,33,"positive",-22,22,1,-7
29,8,33,33,59,2,48,"negative",-26,26,1,15
29,9,33,30,65,3,48,"neutral",-32,32,1,15
29,10,30,20,55,4,20,"positive",-25,25,1,-10
29,11,3,5,52,3,60,"neutral",-49,49,1,57
29,12,30,35,48,2,33,"negative",-18,18,1,3
29,13,33,33,30,3,10,"neutral",3,3,-1,23
29,14,52,48,55,2,20,"negative",-3,3,1,-32
29,15,5,48,42,3,60,"neutral",-37,37,1,55
29,16,30,33,32,4,70,"positive",-2,2,1,40
29,17,5,20,41,3,50,"neutral",-36,36,1,45
29,18,55,74,48,3,35,"neutral",7,7,-1,20
29,19,50,48,49,3,36,"neutral",1,1,-1,14
29,20,5,55,44,2,55,"negative",-39,39,1,50
29,21,3,5,33,3,48,"neutral",-30,30,1,45
29,22,20,30,51,3,35,"neutral",-31,31,1,15
29,23,50,33,37,3,55,"neutral",13,13,-1,-5
29,24,52,52,43,4,59,"positive",9,9,-1,-7
29,25,5,48,39,3,35,"neutral",-34,34,1,30
29,26,48,33,35,4,70,"positive",13,13,-1,-22
29,27,30,55,30,3,33,"neutral",0,0,0,0
29,28,30,55,70,4,60,"positive",-40,40,1,30
29,29,55,55,10,1,33,"negative",45,45,-1,22
29,30,50,55,23,2,55,"negative",27,27,-1,-5
29,31,30,55,23,4,55,"positive",7,7,-1,-25
29,32,10,33,36,1,20,"negative",-26,26,1,10
29,33,35,52,33,2,20,"negative",2,2,-1,15
29,34,33,30,36,3,55,"neutral",-3,3,1,22
29,35,55,55,45,4,70,"positive",10,10,-1,-15
29,36,10,30,43,1,33,"negative",-33,33,1,23
29,37,48,36,38,3,20,"neutral",10,10,-1,28
29,38,30,48,33,3,33,"neutral",-3,3,1,3
29,39,15,33,47,3,33,"neutral",-32,32,1,18
30,1,70,65,56,5,67,"positive",14,14,-1,3
30,2,40,59,29,4,50,"positive",11,11,-1,-10
30,3,60,50,20,4,60,"positive",40,40,-1,0
30,4,77,77,17,5,77,"positive",60,60,-1,0
30,5,5,7,38,1,4,"negative",-33,33,1,-1
30,6,67,50,26,3,65,"neutral",41,41,-1,2
30,7,50,45,62,3,45,"neutral",-12,12,1,-5
30,8,65,50,59,3,50,"neutral",6,6,-1,15
30,9,54,45,65,4,50,"positive",-11,11,1,-4
30,10,77,70,55,5,70,"positive",22,22,-1,7
30,11,30,20,52,3,35,"neutral",-22,22,1,5
30,12,35,45,48,3,40,"neutral",-13,13,1,5
30,13,3,3,30,3,3,"neutral",-27,27,1,0
30,14,30,30,55,2,35,"negative",-25,25,1,5
30,15,65,60,42,5,70,"positive",23,23,-1,-5
30,16,65,62,32,4,70,"positive",33,33,-1,-5
30,17,50,45,41,3,40,"neutral",9,9,-1,10
30,18,60,56,48,3,40,"neutral",12,12,-1,20
30,19,50,45,49,4,45,"positive",1,1,-1,5
30,20,30,34,44,3,50,"neutral",-14,14,1,20
30,21,40,35,33,4,40,"positive",7,7,-1,0
30,22,70,66,51,4,65,"positive",19,19,-1,5
30,23,50,45,37,3,45,"neutral",13,13,-1,5
30,24,68,58,43,4,48,"positive",25,25,-1,20
30,25,70,56,39,4,45,"positive",31,31,-1,25
30,26,67,50,35,3,60,"neutral",32,32,-1,7
30,27,50,45,30,3,50,"neutral",20,20,-1,0
30,28,50,45,70,4,45,"positive",-20,20,1,-5
30,29,50,50,10,3,30,"neutral",40,40,-1,20
30,30,60,50,23,4,60,"positive",37,37,-1,0
30,31,45,40,23,3,45,"neutral",22,22,-1,0
30,32,45,50,36,4,65,"positive",9,9,-1,-20
30,33,50,46,33,3,45,"neutral",17,17,-1,5
30,34,30,25,36,3,45,"neutral",-6,6,1,15
30,35,3,10,45,1,3,"negative",-42,42,1,0
30,36,67,67,43,5,56,"positive",24,24,-1,11
30,37,40,37,38,4,50,"positive",2,2,-1,-10
30,38,40,30,33,2,35,"negative",7,7,-1,5
30,39,70,67,47,3,47,"neutral",23,23,-1,23
31,1,10,30,56,3,10,"neutral",-46,46,1,0
31,2,30,45,29,5,60,"positive",1,1,-1,-30
31,3,50,55,20,3,55,"neutral",30,30,-1,-5
31,4,10,32,17,5,20,"positive",-7,7,1,10
31,5,10,30,38,2,20,"negative",-28,28,1,10
31,6,40,50,26,3,40,"neutral",14,14,-1,0
31,7,50,60,62,4,60,"positive",-12,12,1,10
31,8,70,65,59,4,65,"positive",11,11,-1,5
31,9,20,30,65,2,30,"negative",-45,45,1,10
31,10,60,50,55,2,60,"negative",5,5,-1,0
31,11,70,60,52,4,70,"positive",18,18,-1,0
31,12,65,50,48,4,65,"positive",17,17,-1,0
31,13,10,15,30,3,10,"neutral",-20,20,1,0
31,14,50,45,55,4,55,"positive",-5,5,1,5
31,15,5,30,42,3,10,"neutral",-37,37,1,5
31,16,10,30,32,3,20,"neutral",-22,22,1,10
31,17,50,40,41,3,45,"neutral",9,9,-1,5
31,18,70,55,48,4,65,"positive",22,22,-1,5
31,19,10,20,49,1,10,"negative",-39,39,1,0
31,20,50,38,44,3,55,"neutral",6,6,-1,-5
31,21,30,45,33,5,40,"positive",-3,3,1,10
31,22,5,30,51,2,45,"negative",-46,46,1,40
31,23,30,25,37,3,20,"neutral",-7,7,1,-10
31,24,50,60,43,3,50,"neutral",7,7,-1,0
31,25,20,30,39,3,30,"neutral",-19,19,1,10
31,26,40,40,35,4,60,"positive",5,5,-1,-20
31,27,10,50,30,5,50,"positive",-20,20,1,40
31,28,65,45,70,3,60,"neutral",-5,5,1,-5
31,29,68,40,10,4,60,"positive",58,58,-1,8
31,30,10,40,23,3,3,"neutral",-13,13,1,-7
31,31,65,65,23,3,50,"neutral",42,42,-1,15
31,32,20,70,36,3,50,"neutral",-16,16,1,30
31,33,70,65,33,3,65,"neutral",37,37,-1,5
31,34,20,30,36,3,60,"neutral",-16,16,1,40
31,35,70,60,45,4,70,"positive",25,25,-1,0
31,36,3,50,43,3,3,"neutral",-40,40,1,0
31,37,65,58,38,3,65,"neutral",27,27,-1,0
31,38,60,50,33,3,55,"neutral",27,27,-1,5
31,39,20,40,47,2,10,"negative",-27,27,1,-10
32,1,45,44,56,3,45,"neutral",-11,11,1,0
32,2,60,70,29,4,35,"positive",31,31,-1,25
32,3,67,50,20,3,45,"neutral",47,47,-1,22
32,4,70,65,17,3,45,"neutral",53,53,-1,25
32,5,56,45,38,4,65,"positive",18,18,-1,-9
32,6,15,19,26,2,10,"negative",-11,11,1,-5
32,7,19,30,62,3,34,"neutral",-43,43,1,15
32,8,55,45,59,3,45,"neutral",-4,4,1,-10
32,9,70,65,65,3,56,"neutral",5,5,-1,14
32,10,77,71,55,3,65,"neutral",22,22,-1,12
32,11,44,34,52,3,50,"neutral",-8,8,1,6
32,12,34,42,48,3,48,"neutral",-14,14,1,14
32,13,19,27,30,2,23,"negative",-11,11,1,4
32,14,67,56,55,4,65,"positive",12,12,-1,2
32,15,50,55,42,3,55,"neutral",8,8,-1,-5
32,16,70,65,32,3,70,"neutral",38,38,-1,0
32,17,60,27,41,3,48,"neutral",19,19,-1,12
32,18,32,35,48,3,38,"neutral",-16,16,1,6
32,19,60,70,49,2,56,"negative",11,11,-1,4
32,20,37,56,44,3,45,"neutral",-7,7,1,8
32,21,44,48,33,2,38,"negative",11,11,-1,6
32,22,65,60,51,3,32,"neutral",14,14,-1,33
32,23,30,23,37,2,45,"negative",-7,7,1,15
32,24,30,25,43,3,45,"neutral",-13,13,1,15
32,25,55,55,39,3,45,"neutral",16,16,-1,10
32,26,48,55,35,3,45,"neutral",13,13,-1,3
32,27,25,22,30,4,35,"positive",-5,5,1,10
32,28,34,38,70,3,65,"neutral",-36,36,1,31
32,29,30,35,10,3,10,"neutral",20,20,-1,20
32,30,45,56,23,3,34,"neutral",22,22,-1,11
32,31,40,29,23,3,35,"neutral",17,17,-1,5
32,32,43,44,36,2,35,"negative",7,7,-1,8
32,33,65,56,33,3,38,"neutral",32,32,-1,27
32,34,34,45,36,3,34,"neutral",-2,2,1,0
32,35,20,34,45,3,34,"neutral",-25,25,1,14
32,36,56,65,43,3,34,"neutral",13,13,-1,22
32,37,23,32,38,3,45,"neutral",-15,15,1,22
32,38,30,35,33,2,23,"negative",-3,3,1,-7
32,39,23,25,47,2,32,"negative",-24,24,1,9
33,1,3,3,56,3,3,"neutral",-53,53,1,0
33,2,3,3,29,4,3,"positive",-26,26,1,0
33,3,77,44,20,5,40,"positive",57,57,-1,37
33,4,77,77,17,2,77,"negative",60,60,-1,0
33,5,77,50,38,5,77,"positive",39,39,-1,0
33,6,3,3,26,2,3,"negative",-23,23,1,0
33,7,77,50,62,4,77,"positive",15,15,-1,0
33,8,3,58,59,4,3,"positive",-56,56,1,0
33,9,3,3,65,3,3,"neutral",-62,62,1,0
33,10,60,40,55,3,50,"neutral",5,5,-1,10
33,11,3,3,52,2,3,"negative",-49,49,1,0
33,12,3,3,48,3,3,"neutral",-45,45,1,0
33,13,3,3,30,3,3,"neutral",-27,27,1,0
33,14,3,3,55,2,3,"negative",-52,52,1,0
33,15,77,60,42,4,77,"positive",35,35,-1,0
33,16,60,77,32,3,50,"neutral",28,28,-1,10
33,17,50,40,41,3,50,"neutral",9,9,-1,0
33,18,3,3,48,3,3,"neutral",-45,45,1,0
33,19,60,60,49,3,60,"neutral",11,11,-1,0
33,20,30,20,44,3,40,"neutral",-14,14,1,10
33,21,6,7,33,3,3,"neutral",-27,27,1,-3
33,22,3,3,51,3,3,"neutral",-48,48,1,0
33,23,3,4,37,3,3,"neutral",-34,34,1,0
33,24,3,3,43,4,3,"positive",-40,40,1,0
33,25,3,5,39,3,65,"neutral",-36,36,1,62
33,26,66,5,35,3,77,"neutral",31,31,-1,-11
33,27,40,50,30,3,40,"neutral",10,10,-1,0
33,28,50,60,70,3,50,"neutral",-20,20,1,0
33,29,35,4,10,3,55,"neutral",25,25,-1,-20
33,30,4,4,23,3,55,"neutral",-19,19,1,51
33,31,77,77,23,3,30,"neutral",54,54,-1,47
33,32,50,20,36,4,66,"positive",14,14,-1,-16
33,33,77,77,33,4,60,"positive",44,44,-1,17
33,34,33,55,36,3,5,"neutral",-3,3,1,-28
33,35,69,10,45,5,77,"positive",24,24,-1,-8
33,36,3,3,43,2,3,"negative",-40,40,1,0
33,37,40,50,38,3,3,"neutral",2,2,-1,37
33,38,4,5,33,3,3,"neutral",-29,29,1,-1
33,39,77,50,47,2,77,"negative",30,30,-1,0
34,1,55,45,56,4,50,"positive",-1,1,1,-5
34,2,3,29,29,4,5,"positive",-26,26,1,2
34,3,38,52,20,3,25,"neutral",18,18,-1,13
34,4,77,77,17,3,60,"neutral",60,60,-1,17
34,5,5,25,38,4,16,"positive",-33,33,1,11
34,6,37,42,26,3,29,"neutral",11,11,-1,8
34,7,38,52,62,4,38,"positive",-24,24,1,0
34,8,20,18,59,3,38,"neutral",-39,39,1,18
34,9,20,25,65,3,18,"neutral",-45,45,1,-2
34,10,35,39,55,2,28,"negative",-20,20,1,-7
34,11,45,50,52,2,30,"negative",-7,7,1,-15
34,12,32,28,48,3,35,"neutral",-16,16,1,3
34,13,6,18,30,3,18,"neutral",-24,24,1,12
34,14,65,68,55,4,62,"positive",10,10,-1,3
34,15,77,70,42,4,58,"positive",35,35,-1,19
34,16,55,45,32,4,42,"positive",23,23,-1,13
34,17,30,35,41,3,38,"neutral",-11,11,1,8
34,18,60,52,48,4,55,"positive",12,12,-1,5
34,19,5,15,49,3,32,"neutral",-44,44,1,27
34,20,30,42,44,3,30,"neutral",-14,14,1,0
34,21,40,45,33,4,35,"positive",7,7,-1,5
34,22,58,62,51,3,42,"neutral",7,7,-1,16
34,23,25,28,37,3,28,"neutral",-12,12,1,3
34,24,20,36,43,3,29,"neutral",-23,23,1,9
34,25,10,18,39,4,43,"positive",-29,29,1,33
34,26,52,48,35,3,48,"neutral",17,17,-1,4
34,27,50,60,30,3,36,"neutral",20,20,-1,14
34,28,30,47,70,3,56,"neutral",-40,40,1,26
34,29,15,30,10,3,52,"neutral",5,5,-1,-37
34,30,30,25,23,3,38,"neutral",7,7,-1,-8
34,31,20,30,23,3,42,"neutral",-3,3,1,22
34,32,30,45,36,3,26,"neutral",-6,6,1,-4
34,33,40,60,33,4,36,"positive",7,7,-1,4
34,34,35,28,36,4,28,"positive",-1,1,1,-7
34,35,68,38,45,4,77,"positive",23,23,-1,-9
34,36,3,15,43,3,20,"neutral",-40,40,1,17
34,37,70,77,38,4,42,"positive",32,32,-1,28
34,38,45,50,33,3,15,"neutral",12,12,-1,30
34,39,20,39,47,2,38,"negative",-27,27,1,18
35,1,20,3,56,3,20,"neutral",-36,36,1,0
35,2,20,4,29,4,20,"positive",-9,9,1,0
35,3,35,3,20,3,20,"neutral",15,15,-1,15
35,4,77,5,17,5,70,"positive",60,60,-1,7
35,5,20,3,38,4,20,"positive",-18,18,1,0
35,6,20,3,26,2,70,"negative",-6,6,1,50
35,7,75,5,62,5,60,"positive",13,13,-1,15
35,8,55,4,59,4,55,"positive",-4,4,1,0
35,9,55,3,65,4,35,"positive",-10,10,1,-20
35,10,20,3,55,1,50,"negative",-35,35,1,30
35,11,35,30,52,3,60,"neutral",-17,17,1,25
35,12,20,3,48,3,35,"neutral",-28,28,1,15
35,13,20,3,30,3,35,"neutral",-10,10,1,15
35,14,70,4,55,4,60,"positive",15,15,-1,10
35,15,60,3,42,3,66,"neutral",18,18,-1,-6
35,16,70,3,32,3,60,"neutral",38,38,-1,10
35,17,70,5,41,4,26,"positive",29,29,-1,44
35,18,55,4,48,4,55,"positive",7,7,-1,0
35,19,60,4,49,3,35,"neutral",11,11,-1,25
35,20,40,3,44,3,50,"neutral",-4,4,1,10
35,21,75,5,33,5,60,"positive",42,42,-1,15
35,22,35,3,51,3,30,"neutral",-16,16,1,-5
35,23,70,4,37,3,65,"neutral",33,33,-1,5
35,24,20,3,43,2,60,"negative",-23,23,1,40
35,25,76,5,39,5,20,"positive",37,37,-1,56
35,26,66,4,35,3,60,"neutral",31,31,-1,6
35,27,65,4,30,3,35,"neutral",35,35,-1,30
35,28,40,3,70,2,45,"negative",-30,30,1,5
35,29,55,4,10,4,70,"positive",45,45,-1,-15
35,30,50,3,23,3,30,"neutral",27,27,-1,20
35,31,75,5,23,5,45,"positive",52,52,-1,30
35,32,20,3,36,2,40,"negative",-16,16,1,20
35,33,60,5,33,5,70,"positive",27,27,-1,-10
35,34,60,4,36,4,35,"positive",24,24,-1,25
35,35,50,3,45,3,40,"neutral",5,5,-1,10
35,36,10,3,43,3,40,"neutral",-33,33,1,30
35,37,75,5,38,4,35,"positive",37,37,-1,40
35,38,75,4,33,3,20,"neutral",42,42,-1,55
35,39,40,3,47,3,55,"neutral",-7,7,1,15
36,1,29,29,56,2,56,"negative",-27,27,1,27
36,2,44,44,29,4,47,"positive",15,15,-1,-3
36,3,56,56,20,1,38,"negative",36,36,-1,18
36,4,40,9,17,2,52,"negative",23,23,-1,-12
36,5,36,36,38,4,38,"positive",-2,2,1,2
36,6,20,20,26,3,38,"neutral",-6,6,1,18
36,7,55,55,62,4,52,"positive",-7,7,1,-3
36,8,44,44,59,3,38,"neutral",-15,15,1,-6
36,9,46,46,65,2,23,"negative",-19,19,1,-23
36,10,33,33,55,4,52,"positive",-22,22,1,19
36,11,20,30,52,3,37,"neutral",-32,32,1,17
36,12,30,30,48,4,56,"positive",-18,18,1,26
36,13,45,45,30,3,44,"neutral",15,15,-1,1
36,14,3,3,55,3,29,"neutral",-52,52,1,26
36,15,41,41,42,4,39,"positive",-1,1,1,-2
36,16,77,77,32,3,39,"neutral",45,45,-1,38
36,17,73,70,41,3,46,"neutral",32,32,-1,27
36,18,46,74,48,2,46,"negative",-2,2,1,0
36,19,75,72,49,2,38,"negative",26,26,-1,37
36,20,33,33,44,4,38,"positive",-11,11,1,5
36,21,70,70,33,1,56,"negative",37,37,-1,14
36,22,33,33,51,3,33,"neutral",-18,18,1,0
36,23,48,48,37,3,37,"neutral",11,11,-1,11
36,24,47,47,43,4,39,"positive",4,4,-1,8
36,25,33,33,39,4,29,"positive",-6,6,1,-4
36,26,34,34,35,4,36,"positive",-1,1,1,2
36,27,28,29,30,4,29,"positive",-2,2,1,1
36,28,40,40,70,3,54,"neutral",-30,30,1,14
36,29,45,45,10,3,46,"neutral",35,35,-1,-1
36,30,8,8,23,3,38,"neutral",-15,15,1,30
36,31,38,38,23,3,58,"neutral",15,15,-1,-20
36,32,39,39,36,4,37,"positive",3,3,-1,2
36,33,38,38,33,3,44,"neutral",5,5,-1,-6
36,34,76,76,36,3,33,"neutral",40,40,-1,43
36,35,29,29,45,4,29,"positive",-16,16,1,0
36,36,48,28,43,3,28,"neutral",5,5,-1,20
36,37,50,50,38,4,22,"positive",12,12,-1,28
36,38,71,71,33,3,30,"neutral",38,38,-1,41
36,39,73,73,47,4,37,"positive",26,26,-1,36
37,1,4,70,56,3,5,"neutral",-52,52,1,1
37,2,7,60,29,4,7,"positive",-22,22,1,0
37,3,3,10,20,2,4,"negative",-17,17,1,1
37,4,3,33,17,2,7,"negative",-14,14,1,4
37,5,5,50,38,3,4,"neutral",-33,33,1,-1
37,6,5,45,26,3,5,"neutral",-21,21,1,0
37,7,7,77,62,3,7,"neutral",-55,55,1,0
37,8,6,60,59,4,6,"positive",-53,53,1,0
37,9,5,65,65,3,5,"neutral",-60,60,1,0
37,10,4,35,55,2,4,"negative",-51,51,1,0
37,11,4,50,52,1,3,"negative",-48,48,1,-1
37,12,7,65,48,4,7,"positive",-41,41,1,0
37,13,5,44,30,3,5,"neutral",-25,25,1,0
37,14,7,70,55,4,7,"positive",-48,48,1,0
37,15,7,77,42,4,7,"positive",-35,35,1,0
37,16,7,40,32,3,7,"neutral",-25,25,1,0
37,17,3,30,41,2,3,"negative",-38,38,1,0
37,18,5,50,48,3,5,"neutral",-43,43,1,0
37,19,5,58,49,3,5,"neutral",-44,44,1,0
37,20,6,65,44,3,5,"neutral",-38,38,1,-1
37,21,3,33,33,3,4,"neutral",-30,30,1,1
37,22,4,35,51,3,5,"neutral",-47,47,1,1
37,23,3,48,37,2,5,"negative",-34,34,1,2
37,24,7,70,43,3,6,"neutral",-36,36,1,-1
37,25,5,55,39,3,4,"neutral",-34,34,1,-1
37,26,7,70,35,4,7,"positive",-28,28,1,0
37,27,6,40,30,3,5,"neutral",-24,24,1,-1
37,28,7,68,70,3,7,"neutral",-63,63,1,0
37,29,4,50,10,3,4,"neutral",-6,6,1,0
37,30,3,60,23,3,3,"neutral",-20,20,1,0
37,31,7,77,23,4,6,"positive",-16,16,1,-1
37,32,5,60,36,2,5,"negative",-31,31,1,0
37,33,4,50,33,3,4,"neutral",-29,29,1,0
37,34,3,34,36,3,6,"neutral",-33,33,1,3
37,35,7,45,45,5,7,"positive",-38,38,1,0
37,36,3,65,43,2,3,"negative",-40,40,1,0
37,37,7,75,38,3,5,"neutral",-31,31,1,-2
37,38,3,45,33,3,5,"neutral",-30,30,1,2
37,39,4,38,47,2,4,"negative",-43,43,1,0
38,1,50,50,56,3,56,"neutral",-6,6,1,6
38,2,56,56,29,2,48,"negative",27,27,-1,8
38,3,70,77,20,4,77,"positive",50,50,-1,-7
38,4,77,77,17,3,77,"neutral",60,60,-1,0
38,5,40,40,38,3,40,"neutral",2,2,-1,0
38,6,68,68,26,3,60,"neutral",42,42,-1,8
38,7,60,60,62,5,20,"positive",-2,2,1,-40
38,8,20,20,59,3,30,"neutral",-39,39,1,10
38,9,50,70,65,2,38,"negative",-15,15,1,-12
38,10,30,40,55,1,20,"negative",-25,25,1,-10
38,11,77,77,52,1,60,"negative",25,25,-1,17
38,12,49,48,48,3,48,"neutral",1,1,-1,1
38,13,20,60,30,3,30,"neutral",-10,10,1,10
38,14,70,70,55,3,68,"neutral",15,15,-1,2
38,15,68,60,42,5,70,"positive",26,26,-1,-2
38,16,20,20,32,3,23,"neutral",-12,12,1,3
38,17,34,34,41,3,20,"neutral",-7,7,1,-14
38,18,70,50,48,3,40,"neutral",22,22,-1,30
38,19,44,44,49,3,49,"neutral",-5,5,1,5
38,20,50,50,44,3,48,"neutral",6,6,-1,2
38,21,43,40,33,3,50,"neutral",10,10,-1,-7
38,22,3,3,51,3,50,"neutral",-48,48,1,47
38,23,60,60,37,3,50,"neutral",23,23,-1,10
38,24,60,60,43,3,70,"neutral",17,17,-1,-10
38,25,35,30,39,3,49,"neutral",-4,4,1,14
38,26,40,50,35,2,68,"negative",5,5,-1,-28
38,27,50,50,30,3,34,"neutral",20,20,-1,16
38,28,60,60,70,3,45,"neutral",-10,10,1,-15
38,29,75,75,10,4,45,"positive",65,65,-1,30
38,30,50,50,23,3,45,"neutral",27,27,-1,5
38,31,40,40,23,3,32,"neutral",17,17,-1,8
38,32,20,38,36,2,30,"negative",-16,16,1,10
38,33,70,70,33,4,60,"positive",37,37,-1,10
38,34,77,60,36,3,56,"neutral",41,41,-1,21
38,35,40,20,45,1,24,"negative",-5,5,1,-16
38,36,20,60,43,2,67,"negative",-23,23,1,47
38,37,40,50,38,3,50,"neutral",2,2,-1,-10
38,38,40,38,33,2,35,"negative",7,7,-1,5
38,39,23,30,47,3,56,"neutral",-24,24,1,33
39,1,10,35,56,3,29,"neutral",-46,46,1,19
39,2,3,50,29,3,3,"neutral",-26,26,1,0
39,3,35,38,20,3,30,"neutral",15,15,-1,5
39,4,15,50,17,3,48,"neutral",-2,2,1,33
39,5,25,45,38,4,17,"positive",-13,13,1,-8
39,6,25,65,26,2,36,"negative",-1,1,1,11
39,7,6,10,62,3,67,"neutral",-56,56,1,61
39,8,50,45,59,3,56,"neutral",-9,9,1,6
39,9,24,25,65,3,12,"neutral",-41,41,1,-12
39,10,70,70,55,3,58,"neutral",15,15,-1,12
39,11,10,30,52,1,59,"negative",-42,42,1,49
39,12,8,12,48,3,48,"neutral",-40,40,1,40
39,13,25,36,30,3,67,"neutral",-5,5,1,42
39,14,25,25,55,3,70,"neutral",-30,30,1,45
39,15,60,70,42,3,38,"neutral",18,18,-1,22
39,16,10,10,32,3,77,"neutral",-22,22,1,67
39,17,15,26,41,3,56,"neutral",-26,26,1,41
39,18,77,77,48,4,48,"positive",29,29,-1,29
39,19,60,60,49,3,68,"neutral",11,11,-1,-8
39,20,60,65,44,3,25,"neutral",16,16,-1,35
39,21,25,25,33,3,45,"neutral",-8,8,1,20
39,22,60,77,51,3,60,"neutral",9,9,-1,0
39,23,20,25,37,3,28,"neutral",-17,17,1,8
39,24,8,10,43,3,50,"neutral",-35,35,1,42
39,25,35,35,39,3,36,"neutral",-4,4,1,1
39,26,60,60,35,3,70,"neutral",25,25,-1,-10
39,27,12,45,30,3,47,"neutral",-18,18,1,35
39,28,45,65,70,4,45,"positive",-25,25,1,0
39,29,56,56,10,3,46,"neutral",46,46,-1,10
39,30,8,8,23,3,23,"neutral",-15,15,1,15
39,31,60,65,23,3,38,"neutral",37,37,-1,22
39,32,10,15,36,2,25,"negative",-26,26,1,15
39,33,3,65,33,3,56,"neutral",-30,30,1,53
39,34,58,64,36,3,38,"neutral",22,22,-1,20
39,35,50,50,45,4,70,"positive",5,5,-1,-20
39,36,67,67,43,3,67,"neutral",24,24,-1,0
39,37,70,60,38,3,67,"neutral",32,32,-1,3
39,38,54,65,33,3,58,"neutral",21,21,-1,-4
39,39,56,56,47,3,15,"neutral",9,9,-1,41
40,1,77,77,56,1,77,"negative",21,21,-1,0
40,2,3,40,29,4,3,"positive",-26,26,1,0
40,3,30,30,20,3,20,"neutral",10,10,-1,10
40,4,77,77,17,3,77,"neutral",60,60,-1,0
40,5,30,50,38,3,40,"neutral",-8,8,1,10
40,6,70,70,26,3,50,"neutral",44,44,-1,20
40,7,20,25,62,3,20,"neutral",-42,42,1,0
40,8,20,30,59,3,30,"neutral",-39,39,1,10
40,9,25,35,65,3,30,"neutral",-40,40,1,5
40,10,40,40,55,3,10,"neutral",-15,15,1,-30
40,11,3,40,52,1,3,"negative",-49,49,1,0
40,12,10,10,48,3,30,"neutral",-38,38,1,20
40,13,40,40,30,3,10,"neutral",10,10,-1,30
40,14,77,77,55,4,77,"positive",22,22,-1,0
40,15,40,40,42,3,40,"neutral",-2,2,1,0
40,16,40,40,32,2,10,"negative",8,8,-1,30
40,17,70,70,41,3,40,"neutral",29,29,-1,30
40,18,77,77,48,5,40,"positive",29,29,-1,37
40,19,10,20,49,1,10,"negative",-39,39,1,0
40,20,35,30,44,3,45,"neutral",-9,9,1,10
40,21,77,50,33,3,50,"neutral",44,44,-1,27
40,22,50,55,51,3,50,"neutral",-1,1,1,0
40,23,40,40,37,3,25,"neutral",3,3,-1,15
40,24,50,40,43,4,40,"positive",7,7,-1,10
40,25,20,35,39,2,37,"negative",-19,19,1,17
40,26,77,60,35,3,60,"neutral",42,42,-1,17
40,27,40,45,30,3,40,"neutral",10,10,-1,0
40,28,60,40,70,3,40,"neutral",-10,10,1,-20
40,29,30,30,10,5,30,"positive",20,20,-1,0
40,30,45,45,23,5,25,"positive",22,22,-1,20
40,31,40,45,23,3,35,"neutral",17,17,-1,5
40,32,30,40,36,1,35,"negative",-6,6,1,5
40,33,50,40,33,3,40,"neutral",17,17,-1,10
40,34,40,40,36,3,26,"neutral",4,4,-1,14
40,35,10,60,45,3,3,"neutral",-35,35,1,-7
40,36,3,3,43,1,3,"negative",-40,40,1,0
40,37,5,15,38,2,10,"negative",-33,33,1,5
40,38,26,30,33,3,25,"neutral",-7,7,1,-1
40,39,40,40,47,3,30,"neutral",-7,7,1,-10
41,1,3,30,56,5,40,"positive",-53,53,1,37
41,2,70,55,29,4,60,"positive",41,41,-1,10
41,3,12,20,20,4,30,"positive",-8,8,1,18
41,4,77,70,17,5,60,"positive",60,60,-1,17
41,5,3,50,38,3,3,"neutral",-35,35,1,0
41,6,38,35,26,1,25,"negative",12,12,-1,13
41,7,50,40,62,4,60,"positive",-12,12,1,10
41,8,65,59,59,5,65,"positive",6,6,-1,0
41,9,20,25,65,3,50,"neutral",-45,45,1,30
41,10,20,30,55,1,50,"negative",-35,35,1,30
41,11,58,65,52,4,60,"positive",6,6,-1,-2
41,12,55,60,48,3,35,"neutral",7,7,-1,20
41,13,9,15,30,2,35,"negative",-21,21,1,26
41,14,77,65,55,4,65,"positive",22,22,-1,12
41,15,40,40,42,3,51,"neutral",-2,2,1,11
41,16,70,55,32,4,38,"positive",38,38,-1,32
41,17,30,31,41,3,50,"neutral",-11,11,1,20
41,18,77,50,48,5,55,"positive",29,29,-1,22
41,19,60,60,49,4,55,"positive",11,11,-1,5
41,20,65,70,44,4,48,"positive",21,21,-1,17
41,21,68,58,33,4,55,"positive",35,35,-1,13
41,22,20,30,51,3,55,"neutral",-31,31,1,35
41,23,10,20,37,2,30,"negative",-27,27,1,20
41,24,56,52,43,4,40,"positive",13,13,-1,16
41,25,60,56,39,2,38,"negative",21,21,-1,22
41,26,77,70,35,4,55,"positive",42,42,-1,22
41,27,30,40,30,4,55,"positive",0,0,0,0
41,28,45,40,70,4,55,"positive",-25,25,1,10
41,29,35,32,10,4,65,"positive",25,25,-1,-30
41,30,50,50,23,5,35,"positive",27,27,-1,15
41,31,68,70,23,2,60,"negative",45,45,-1,8
41,32,60,65,36,3,40,"neutral",24,24,-1,20
41,33,55,60,33,2,40,"negative",22,22,-1,15
41,34,70,65,36,2,53,"negative",34,34,-1,17
41,35,70,70,45,4,30,"positive",25,25,-1,40
41,36,10,30,43,1,38,"negative",-33,33,1,28
41,37,52,48,38,2,45,"negative",14,14,-1,7
41,38,38,30,33,3,55,"neutral",5,5,-1,-17
41,39,33,20,47,3,45,"neutral",-14,14,1,12
42,1,4,4,56,3,5,"neutral",-52,52,1,1
42,2,3,4,29,2,5,"negative",-26,26,1,2
42,3,3,5,20,3,5,"neutral",-17,17,1,2
42,4,76,76,17,5,4,"positive",59,59,-1,72
42,5,6,6,38,3,3,"neutral",-32,32,1,-3
42,6,6,7,26,2,4,"negative",-20,20,1,-2
42,7,5,5,62,4,4,"positive",-57,57,1,-1
42,8,6,5,59,3,4,"neutral",-53,53,1,-2
42,9,4,4,65,3,4,"neutral",-61,61,1,0
42,10,30,40,55,4,5,"positive",-25,25,1,-25
42,11,3,3,52,2,6,"negative",-49,49,1,3
42,12,3,3,48,3,5,"neutral",-45,45,1,2
42,13,6,8,30,3,5,"neutral",-24,24,1,-1
42,14,4,5,55,3,5,"neutral",-51,51,1,1
42,15,3,3,42,3,5,"neutral",-39,39,1,2
42,16,5,5,32,4,5,"positive",-27,27,1,0
42,17,10,25,41,3,4,"neutral",-31,31,1,-6
42,18,3,4,48,3,5,"neutral",-45,45,1,2
42,19,4,3,49,3,5,"neutral",-45,45,1,1
42,20,4,4,44,2,5,"negative",-40,40,1,1
42,21,5,6,33,3,6,"neutral",-28,28,1,1
42,22,3,3,51,2,4,"negative",-48,48,1,1
42,23,6,6,37,4,3,"positive",-31,31,1,-3
42,24,3,4,43,3,5,"neutral",-40,40,1,2
42,25,4,5,39,3,4,"neutral",-35,35,1,0
42,26,5,3,35,3,5,"neutral",-30,30,1,0
42,27,4,4,30,3,5,"neutral",-26,26,1,1
42,28,4,3,70,3,6,"neutral",-66,66,1,2
42,29,4,4,10,2,4,"negative",-6,6,1,0
42,30,7,3,23,4,6,"positive",-16,16,1,-1
42,31,3,3,23,3,3,"neutral",-20,20,1,0
42,32,4,3,36,3,4,"neutral",-32,32,1,0
42,33,5,5,33,4,5,"positive",-28,28,1,0
42,34,76,32,36,3,5,"neutral",40,40,-1,71
42,35,3,3,45,2,5,"negative",-42,42,1,2
42,36,3,3,43,3,6,"neutral",-40,40,1,3
42,37,4,4,38,3,4,"neutral",-34,34,1,0
42,38,3,3,33,3,4,"neutral",-30,30,1,1
42,39,4,6,47,3,4,"neutral",-43,43,1,0
43,1,3,35,56,3,56,"neutral",-53,53,1,53
43,2,15,56,29,4,17,"positive",-14,14,1,2
43,3,31,42,20,3,35,"neutral",11,11,-1,-4
43,4,77,67,17,3,25,"neutral",60,60,-1,52
43,5,3,37,38,2,3,"negative",-35,35,1,0
43,6,3,44,26,1,3,"negative",-23,23,1,0
43,7,53,57,62,3,34,"neutral",-9,9,1,-19
43,8,37,27,59,4,56,"positive",-22,22,1,19
43,9,34,42,65,3,65,"neutral",-31,31,1,31
43,10,52,54,55,2,43,"negative",-3,3,1,-9
43,11,77,36,52,5,58,"positive",25,25,-1,19
43,12,52,61,48,3,32,"neutral",4,4,-1,20
43,13,3,13,30,2,23,"negative",-27,27,1,20
43,14,34,46,55,3,46,"neutral",-21,21,1,12
43,15,3,45,42,3,35,"neutral",-39,39,1,32
43,16,15,27,32,2,3,"negative",-17,17,1,-12
43,17,48,38,41,3,43,"neutral",7,7,-1,5
43,18,45,55,48,3,54,"neutral",-3,3,1,9
43,19,42,53,49,1,56,"negative",-7,7,1,14
43,20,45,52,44,4,34,"positive",1,1,-1,11
43,21,56,35,33,5,35,"positive",23,23,-1,21
43,22,37,48,51,1,45,"negative",-14,14,1,8
43,23,36,45,37,3,46,"neutral",-1,1,1,10
43,24,32,50,43,3,26,"neutral",-11,11,1,-6
43,25,46,38,39,4,47,"positive",7,7,-1,-1
43,26,55,43,35,4,41,"positive",20,20,-1,14
43,27,46,52,30,4,42,"positive",16,16,-1,4
43,28,42,35,70,4,37,"positive",-28,28,1,-5
43,29,46,58,10,4,23,"positive",36,36,-1,23
43,30,24,36,23,3,23,"neutral",1,1,-1,1
43,31,55,61,23,3,45,"neutral",32,32,-1,10
43,32,24,45,36,3,43,"neutral",-12,12,1,19
43,33,55,55,33,4,37,"positive",22,22,-1,18
43,34,56,65,36,4,34,"positive",20,20,-1,22
43,35,3,54,45,4,13,"positive",-42,42,1,10
43,36,55,36,43,3,65,"neutral",12,12,-1,-10
43,37,23,34,38,4,21,"positive",-15,15,1,-2
43,38,38,46,33,4,38,"positive",5,5,-1,0
43,39,3,44,47,1,24,"negative",-44,44,1,21
44,1,77,48,56,1,77,"negative",21,21,-1,0
44,2,3,45,29,2,3,"negative",-26,26,1,0
44,3,62,34,20,3,23,"neutral",42,42,-1,39
44,4,77,65,17,3,77,"neutral",60,60,-1,0
44,5,3,30,38,4,17,"positive",-35,35,1,14
44,6,3,21,26,1,3,"negative",-23,23,1,0
44,7,3,20,62,3,10,"neutral",-59,59,1,7
44,8,3,40,59,3,5,"neutral",-56,56,1,2
44,9,33,25,65,2,32,"negative",-32,32,1,-1
44,10,3,37,55,3,3,"neutral",-52,52,1,0
44,11,34,45,52,2,56,"negative",-18,18,1,22
44,12,15,20,48,3,34,"neutral",-33,33,1,19
44,13,3,12,30,3,23,"neutral",-27,27,1,20
44,14,65,56,55,4,77,"positive",10,10,-1,-12
44,15,44,77,42,3,77,"neutral",2,2,-1,-33
44,16,77,72,32,5,77,"positive",45,45,-1,0
44,17,17,56,41,3,52,"neutral",-24,24,1,35
44,18,9,77,48,3,58,"neutral",-39,39,1,49
44,19,65,60,49,4,45,"positive",16,16,-1,20
44,20,5,77,44,3,45,"neutral",-39,39,1,40
44,21,7,67,33,4,32,"positive",-26,26,1,25
44,22,65,55,51,3,67,"neutral",14,14,-1,-2
44,23,3,27,37,3,23,"neutral",-34,34,1,20
44,24,23,17,43,2,12,"negative",-20,20,1,-11
44,25,20,25,39,3,65,"neutral",-19,19,1,45
44,26,65,50,35,3,77,"neutral",30,30,-1,-12
44,27,17,18,30,4,32,"positive",-13,13,1,15
44,28,7,36,70,3,45,"neutral",-63,63,1,38
44,29,17,23,10,3,36,"neutral",7,7,-1,-19
44,30,67,70,23,3,77,"neutral",44,44,-1,-10
44,31,77,56,23,3,67,"neutral",54,54,-1,10
44,32,65,41,36,2,65,"negative",29,29,-1,0
44,33,3,56,33,4,10,"positive",-30,30,1,7
44,34,10,15,36,3,3,"neutral",-26,26,1,-7
44,35,3,45,45,3,3,"neutral",-42,42,1,0
44,36,10,54,43,3,3,"neutral",-33,33,1,-7
44,37,60,65,38,3,56,"neutral",22,22,-1,4
44,38,56,56,33,3,34,"neutral",23,23,-1,22
44,39,9,67,47,3,23,"neutral",-38,38,1,14
45,1,3,20,56,3,3,"neutral",-53,53,1,0
45,2,3,20,29,2,3,"negative",-26,26,1,0
45,3,77,77,20,5,66,"positive",57,57,-1,11
45,4,60,60,17,2,60,"negative",43,43,-1,0
45,5,70,56,38,4,50,"positive",32,32,-1,20
45,6,60,55,26,3,55,"neutral",34,34,-1,5
45,7,10,30,62,3,23,"neutral",-52,52,1,13
45,8,10,31,59,4,26,"positive",-49,49,1,16
45,9,40,40,65,3,60,"neutral",-25,25,1,20
45,10,60,60,55,2,65,"negative",5,5,-1,-5
45,11,30,55,52,1,45,"negative",-22,22,1,15
45,12,20,42,48,3,33,"neutral",-28,28,1,13
45,13,4,16,30,3,5,"neutral",-26,26,1,1
45,14,68,56,55,4,50,"positive",13,13,-1,18
45,15,15,45,42,4,24,"positive",-27,27,1,9
45,16,50,43,32,4,30,"positive",18,18,-1,20
45,17,77,77,41,3,45,"neutral",36,36,-1,32
45,18,40,45,48,4,59,"positive",-8,8,1,19
45,19,45,43,49,4,55,"positive",-4,4,1,10
45,20,34,43,44,3,45,"neutral",-10,10,1,11
45,21,20,31,33,3,30,"neutral",-13,13,1,10
45,22,5,60,51,2,43,"negative",-46,46,1,38
45,23,5,10,37,5,60,"positive",-32,32,1,55
45,24,23,23,43,3,25,"neutral",-20,20,1,2
45,25,15,15,39,3,43,"neutral",-24,24,1,28
45,26,70,65,35,4,65,"positive",35,35,-1,5
45,27,60,43,30,3,33,"neutral",30,30,-1,27
45,28,50,49,70,4,50,"positive",-20,20,1,0
45,29,55,55,10,3,50,"neutral",45,45,-1,5
45,30,3,41,23,3,3,"neutral",-20,20,1,0
45,31,50,50,23,2,50,"negative",27,27,-1,0
45,32,70,40,36,3,45,"neutral",34,34,-1,25
45,33,60,60,33,3,60,"neutral",27,27,-1,0
45,34,77,50,36,4,30,"positive",41,41,-1,47
45,35,70,69,45,3,30,"neutral",25,25,-1,40
45,36,5,22,43,3,5,"neutral",-38,38,1,0
45,37,33,33,38,3,10,"neutral",-5,5,1,-23
45,38,10,33,33,3,36,"neutral",-23,23,1,26
45,39,77,50,47,4,60,"positive",30,30,-1,17
46,1,77,77,56,4,50,"positive",21,21,-1,27
46,2,10,30,29,4,30,"positive",-19,19,1,20
46,3,50,42,20,3,25,"neutral",30,30,-1,25
46,4,77,50,17,4,77,"positive",60,60,-1,0
46,5,10,25,38,4,32,"positive",-28,28,1,22
46,6,60,50,26,3,60,"neutral",34,34,-1,0
46,7,60,50,62,3,65,"neutral",-2,2,1,5
46,8,70,72,59,4,66,"positive",11,11,-1,4
46,9,25,12,65,3,42,"neutral",-40,40,1,17
46,10,66,68,55,2,45,"negative",11,11,-1,21
46,11,65,50,52,4,53,"positive",13,13,-1,12
46,12,42,40,48,3,30,"neutral",-6,6,1,-12
46,13,3,3,30,2,20,"negative",-27,27,1,17
46,14,50,52,55,4,52,"positive",-5,5,1,2
46,15,55,60,42,4,50,"positive",13,13,-1,5
46,16,77,60,32,4,77,"positive",45,45,-1,0
46,17,20,10,41,4,55,"positive",-21,21,1,35
46,18,50,42,48,4,77,"positive",2,2,-1,-27
46,19,20,30,49,3,45,"neutral",-29,29,1,25
46,20,15,40,44,3,25,"neutral",-29,29,1,10
46,21,56,30,33,4,60,"positive",23,23,-1,-4
46,22,50,50,51,3,56,"neutral",-1,1,1,6
46,23,58,50,37,3,20,"neutral",21,21,-1,38
46,24,40,40,43,3,50,"neutral",-3,3,1,10
46,25,3,10,39,3,18,"neutral",-36,36,1,15
46,26,77,77,35,3,56,"neutral",42,42,-1,21
46,27,77,77,30,3,25,"neutral",47,47,-1,52
46,28,33,36,70,4,60,"positive",-37,37,1,27
46,29,30,36,10,3,20,"neutral",20,20,-1,10
46,30,6,3,23,4,55,"positive",-17,17,1,49
46,31,77,77,23,4,20,"positive",54,54,-1,57
46,32,25,20,36,4,56,"positive",-11,11,1,31
46,33,30,40,33,4,55,"positive",-3,3,1,25
46,34,50,52,36,3,45,"neutral",14,14,-1,5
46,35,50,50,45,3,50,"neutral",5,5,-1,0
46,36,77,50,43,4,77,"positive",34,34,-1,0
46,37,50,40,38,3,15,"neutral",12,12,-1,35
46,38,50,55,33,3,65,"neutral",17,17,-1,-15
46,39,60,55,47,3,60,"neutral",13,13,-1,0
47,1,3,4,56,3,3,"neutral",-53,53,1,0
47,2,10,45,29,4,15,"positive",-19,19,1,5
47,3,54,64,20,4,50,"positive",34,34,-1,4
47,4,77,70,17,4,77,"positive",60,60,-1,0
47,5,50,45,38,3,60,"neutral",12,12,-1,-10
47,6,20,35,26,3,20,"neutral",-6,6,1,0
47,7,60,65,62,4,62,"positive",-2,2,1,2
47,8,4,5,59,4,55,"positive",-55,55,1,51
47,9,20,25,65,3,54,"neutral",-45,45,1,34
47,10,70,60,55,1,70,"negative",15,15,-1,0
47,11,3,3,52,1,77,"negative",-49,49,1,74
47,12,3,3,48,4,45,"positive",-45,45,1,42
47,13,20,15,30,3,30,"neutral",-10,10,1,10
47,14,70,65,55,4,70,"positive",15,15,-1,0
47,15,3,30,42,3,65,"neutral",-39,39,1,62
47,16,77,50,32,4,77,"positive",45,45,-1,0
47,17,40,20,41,4,70,"positive",-1,1,1,30
47,18,60,50,48,3,50,"neutral",12,12,-1,10
47,19,3,4,49,4,48,"positive",-46,46,1,45
47,20,6,6,44,3,30,"neutral",-38,38,1,24
47,21,4,5,33,4,40,"positive",-29,29,1,36
47,22,3,3,51,3,65,"neutral",-48,48,1,62
47,23,6,6,37,4,40,"positive",-31,31,1,34
47,24,70,60,43,3,60,"neutral",27,27,-1,10
47,25,40,38,39,3,30,"neutral",1,1,-1,10
47,26,65,60,35,4,45,"positive",30,30,-1,20
47,27,4,4,30,3,40,"neutral",-26,26,1,36
47,28,5,6,70,4,56,"positive",-65,65,1,51
47,29,3,3,10,5,51,"positive",-7,7,1,48
47,30,30,10,23,4,10,"positive",7,7,-1,20
47,31,30,25,23,3,20,"neutral",7,7,-1,10
47,32,70,50,36,2,60,"negative",34,34,-1,10
47,33,20,35,33,3,35,"neutral",-13,13,1,15
47,34,30,40,36,3,60,"neutral",-6,6,1,30
47,35,77,50,45,3,30,"neutral",32,32,-1,47
47,36,30,20,43,4,20,"positive",-13,13,1,-10
47,37,77,67,38,2,77,"negative",39,39,-1,0
47,38,6,6,33,5,20,"positive",-27,27,1,14
47,39,30,35,47,3,50,"neutral",-17,17,1,20
48,1,4,5,56,2,40,"negative",-52,52,1,36
48,2,3,5,29,3,33,"neutral",-26,26,1,30
48,3,40,5,20,2,40,"negative",20,20,-1,0
48,4,50,50,17,4,50,"positive",33,33,-1,0
48,5,40,44,38,5,50,"positive",2,2,-1,-10
48,6,10,15,26,1,5,"negative",-16,16,1,-5
48,7,29,30,62,3,12,"neutral",-33,33,1,-17
48,8,3,3,59,4,22,"positive",-56,56,1,19
48,9,10,14,65,2,5,"negative",-55,55,1,-5
48,10,50,50,55,4,50,"positive",-5,5,1,0
48,11,30,33,52,4,44,"positive",-22,22,1,14
48,12,5,10,48,2,7,"negative",-43,43,1,2
48,13,5,5,30,1,29,"negative",-25,25,1,24
48,14,40,50,55,4,40,"positive",-15,15,1,0
48,15,20,33,42,2,55,"negative",-22,22,1,35
48,16,20,40,32,4,40,"positive",-12,12,1,20
48,17,33,44,41,4,30,"positive",-8,8,1,-3
48,18,30,33,48,3,10,"neutral",-18,18,1,-20
48,19,10,15,49,2,14,"negative",-39,39,1,4
48,20,5,6,44,1,33,"negative",-39,39,1,28
48,21,10,14,33,3,37,"neutral",-23,23,1,27
48,22,10,44,51,4,40,"positive",-41,41,1,30
48,23,3,3,37,1,20,"negative",-34,34,1,17
48,24,40,39,43,4,40,"positive",-3,3,1,0
48,25,33,14,39,4,39,"positive",-6,6,1,6
48,26,29,33,35,3,5,"neutral",-6,6,1,-24
48,27,45,40,30,2,12,"negative",15,15,-1,33
48,28,5,7,70,4,10,"positive",-65,65,1,5
48,29,20,30,10,1,33,"negative",10,10,-1,-13
48,30,40,50,23,1,44,"negative",17,17,-1,-4
48,31,4,10,23,4,44,"positive",-19,19,1,40
48,32,5,5,36,1,7,"negative",-31,31,1,2
48,33,40,40,33,4,50,"positive",7,7,-1,-10
48,34,28,30,36,3,30,"neutral",-8,8,1,2
48,35,30,40,45,4,30,"positive",-15,15,1,0
48,36,10,9,43,2,40,"negative",-33,33,1,30
48,37,40,44,38,4,50,"positive",2,2,-1,-10
48,38,5,5,33,1,33,"negative",-28,28,1,28
48,39,17,20,47,2,30,"negative",-30,30,1,13
49,1,23,30,56,4,50,"positive",-33,33,1,27
49,2,77,60,29,5,77,"positive",48,48,-1,0
49,3,60,65,20,5,30,"positive",40,40,-1,30
49,4,77,50,17,4,60,"positive",60,60,-1,17
49,5,10,5,38,2,20,"negative",-28,28,1,10
49,6,20,30,26,4,40,"positive",-6,6,1,20
49,7,50,45,62,4,20,"positive",-12,12,1,-30
49,8,30,43,59,4,50,"positive",-29,29,1,20
49,9,30,39,65,3,40,"neutral",-35,35,1,10
49,10,60,30,55,1,60,"negative",5,5,-1,0
49,11,20,21,52,2,40,"negative",-32,32,1,20
49,12,77,77,48,4,40,"positive",29,29,-1,37
49,13,30,23,30,3,40,"neutral",0,0,0,0
49,14,10,10,55,4,70,"positive",-45,45,1,60
49,15,20,53,42,4,20,"positive",-22,22,1,0
49,16,56,63,32,4,77,"positive",24,24,-1,-21
49,17,30,20,41,4,30,"positive",-11,11,1,0
49,18,77,77,48,4,40,"positive",29,29,-1,37
49,19,50,45,49,3,30,"neutral",1,1,-1,20
49,20,10,20,44,4,30,"positive",-34,34,1,20
49,21,60,53,33,4,50,"positive",27,27,-1,10
49,22,32,32,51,4,10,"positive",-19,19,1,-22
49,23,20,30,37,4,10,"positive",-17,17,1,-10
49,24,60,66,43,4,30,"positive",17,17,-1,30
49,25,60,60,39,3,40,"neutral",21,21,-1,20
49,26,40,35,35,4,10,"positive",5,5,-1,30
49,27,30,30,30,4,70,"positive",0,0,0,0
49,28,3,5,70,3,39,"neutral",-67,67,1,36
49,29,42,66,10,4,40,"positive",32,32,-1,2
49,30,30,45,23,4,60,"positive",7,7,-1,-30
49,31,30,30,23,4,30,"positive",7,7,-1,0
49,32,30,30,36,3,30,"neutral",-6,6,1,0
49,33,40,39,33,4,50,"positive",7,7,-1,-10
49,34,30,50,36,3,40,"neutral",-6,6,1,10
49,35,60,70,45,4,40,"positive",15,15,-1,20
49,36,30,23,43,3,60,"neutral",-13,13,1,30
49,37,30,30,38,4,10,"positive",-8,8,1,-20
49,38,36,32,33,4,40,"positive",3,3,-1,-4
49,39,40,53,47,4,40,"positive",-7,7,1,0
50,1,10,66,56,2,25,"negative",-46,46,1,15
50,2,10,30,29,4,10,"positive",-19,19,1,0
50,3,40,35,20,3,40,"neutral",20,20,-1,0
50,4,66,60,17,3,25,"neutral",49,49,-1,41
50,5,10,33,38,4,20,"positive",-28,28,1,10
50,6,20,20,26,2,30,"negative",-6,6,1,10
50,7,40,35,62,4,55,"positive",-22,22,1,15
50,8,50,55,59,3,55,"neutral",-9,9,1,5
50,9,10,10,65,1,20,"negative",-55,55,1,10
50,10,15,20,55,1,15,"negative",-40,40,1,0
50,11,77,65,52,2,70,"negative",25,25,-1,7
50,12,10,20,48,3,20,"neutral",-38,38,1,10
50,13,5,10,30,4,41,"positive",-25,25,1,36
50,14,50,45,55,3,50,"neutral",-5,5,1,0
50,15,20,25,42,4,30,"positive",-22,22,1,10
50,16,70,75,32,2,55,"negative",38,38,-1,15
50,17,10,15,41,3,40,"neutral",-31,31,1,30
50,18,50,50,48,3,50,"neutral",2,2,-1,0
50,19,3,25,49,1,10,"negative",-46,46,1,7
50,20,33,30,44,2,70,"negative",-11,11,1,37
50,21,30,30,33,2,66,"negative",-3,3,1,36
50,22,55,55,51,2,65,"negative",4,4,-1,-10
50,23,10,20,37,3,20,"neutral",-27,27,1,10
50,24,40,40,43,3,22,"neutral",-3,3,1,-18
50,25,55,40,39,3,66,"neutral",16,16,-1,-11
50,26,66,55,35,2,75,"negative",31,31,-1,-9
50,27,50,50,30,2,40,"negative",20,20,-1,10
50,28,60,55,70,3,40,"neutral",-10,10,1,-20
50,29,60,55,10,3,30,"neutral",50,50,-1,30
50,30,30,30,23,3,30,"neutral",7,7,-1,0
50,31,50,33,23,2,60,"negative",27,27,-1,-10
50,32,20,25,36,2,15,"negative",-16,16,1,-5
50,33,70,70,33,3,45,"neutral",37,37,-1,25
50,34,40,30,36,3,50,"neutral",4,4,-1,-10
50,35,50,30,45,3,70,"neutral",5,5,-1,-20
50,36,60,50,43,2,60,"negative",17,17,-1,0
50,37,50,60,38,3,60,"neutral",12,12,-1,-10
50,38,50,40,33,3,55,"neutral",17,17,-1,-5
50,39,10,20,47,2,20,"negative",-37,37,1,10
51,1,3,49,56,3,34,"neutral",-53,53,1,31
51,2,48,40,29,3,60,"neutral",19,19,-1,-12
51,3,40,40,20,3,38,"neutral",20,20,-1,2
51,4,12,19,17,4,17,"positive",-5,5,1,5
51,5,45,51,38,3,10,"neutral",7,7,-1,35
51,6,33,37,26,3,30,"neutral",7,7,-1,3
51,7,46,50,62,4,31,"positive",-16,16,1,-15
51,8,32,34,59,4,50,"positive",-27,27,1,18
51,9,45,47,65,4,46,"positive",-20,20,1,1
51,10,55,33,55,4,22,"positive",0,0,0,0
51,11,33,30,52,2,34,"negative",-19,19,1,1
51,12,65,59,48,3,52,"neutral",17,17,-1,13
51,13,44,45,30,2,45,"negative",14,14,-1,-1
51,14,35,39,55,3,46,"neutral",-20,20,1,11
51,15,33,36,42,4,45,"positive",-9,9,1,12
51,16,50,47,32,3,62,"neutral",18,18,-1,-12
51,17,34,34,41,3,61,"neutral",-7,7,1,27
51,18,70,59,48,3,67,"neutral",22,22,-1,3
51,19,60,59,49,3,56,"neutral",11,11,-1,4
51,20,54,57,44,4,33,"positive",10,10,-1,21
51,21,55,45,33,3,44,"neutral",22,22,-1,11
51,22,22,28,51,4,30,"positive",-29,29,1,8
51,23,34,37,37,3,38,"neutral",-3,3,1,4
51,24,43,48,43,3,41,"neutral",0,0,0,0
51,25,21,21,39,4,45,"positive",-18,18,1,24
51,26,45,46,35,4,45,"positive",10,10,-1,0
51,27,67,59,30,4,35,"positive",37,37,-1,32
51,28,43,44,70,3,50,"neutral",-27,27,1,7
51,29,55,49,10,2,20,"negative",45,45,-1,35
51,30,45,39,23,4,28,"positive",22,22,-1,17
51,31,57,61,23,3,44,"neutral",34,34,-1,13
51,32,50,55,36,4,40,"positive",14,14,-1,10
51,33,33,40,33,4,45,"positive",0,0,0,0
51,34,22,25,36,4,48,"positive",-14,14,1,26
51,35,70,68,45,4,76,"positive",25,25,-1,-6
51,36,10,45,43,3,44,"neutral",-33,33,1,34
51,37,44,50,38,3,45,"neutral",6,6,-1,-1
51,38,44,48,33,3,22,"neutral",11,11,-1,22
51,39,25,27,47,3,54,"neutral",-22,22,1,29
52,1,73,65,56,3,37,"neutral",17,17,-1,36
52,2,65,30,29,2,34,"negative",36,36,-1,31
52,3,25,30,20,4,41,"positive",5,5,-1,-16
52,4,75,70,17,2,30,"negative",58,58,-1,45
52,5,5,20,38,2,33,"negative",-33,33,1,28
52,6,65,60,26,2,55,"negative",39,39,-1,10
52,7,45,50,62,4,59,"positive",-17,17,1,14
52,8,55,50,59,4,59,"positive",-4,4,1,4
52,9,20,25,65,3,16,"neutral",-45,45,1,-4
52,10,30,40,55,3,38,"neutral",-25,25,1,8
52,11,3,3,52,1,38,"negative",-49,49,1,35
52,12,15,30,48,2,23,"negative",-33,33,1,8
52,13,8,15,30,3,56,"neutral",-22,22,1,48
52,14,77,60,55,3,29,"neutral",22,22,-1,48
52,15,65,40,42,3,20,"neutral",23,23,-1,45
52,16,75,77,32,1,21,"negative",43,43,-1,54
52,17,55,60,41,4,49,"positive",14,14,-1,6
52,18,65,65,48,3,28,"neutral",17,17,-1,37
52,19,40,50,49,4,55,"positive",-9,9,1,15
52,20,8,15,44,3,55,"neutral",-36,36,1,47
52,21,40,60,33,4,26,"positive",7,7,-1,14
52,22,40,60,51,4,55,"positive",-11,11,1,15
52,23,10,20,37,2,39,"negative",-27,27,1,29
52,24,60,55,43,3,19,"neutral",17,17,-1,41
52,25,40,50,39,5,50,"positive",1,1,-1,-10
52,26,70,65,35,2,25,"negative",35,35,-1,45
52,27,60,55,30,3,17,"neutral",30,30,-1,43
52,28,65,60,70,5,39,"positive",-5,5,1,-26
52,29,35,35,10,2,23,"negative",25,25,-1,12
52,30,30,50,23,3,41,"neutral",7,7,-1,-11
52,31,70,65,23,3,32,"neutral",47,47,-1,38
52,32,65,60,36,2,36,"negative",29,29,-1,29
52,33,70,70,33,3,61,"neutral",37,37,-1,9
52,34,20,30,36,4,44,"positive",-16,16,1,24
52,35,70,65,45,2,26,"negative",25,25,-1,44
52,36,77,70,43,2,32,"negative",34,34,-1,45
52,37,77,70,38,2,23,"negative",39,39,-1,54
52,38,15,20,33,3,22,"neutral",-18,18,1,7
52,39,40,50,47,4,46,"positive",-7,7,1,6
53,1,5,5,56,5,5,"positive",-51,51,1,0
53,2,4,4,29,4,4,"positive",-25,25,1,0
53,3,3,3,20,5,3,"positive",-17,17,1,0
53,4,5,5,17,3,5,"neutral",-12,12,1,0
53,5,5,5,38,5,5,"positive",-33,33,1,0
53,6,3,4,26,4,3,"positive",-23,23,1,0
53,7,3,3,62,3,3,"neutral",-59,59,1,0
53,8,3,3,59,5,3,"positive",-56,56,1,0
53,9,3,3,65,2,3,"negative",-62,62,1,0
53,10,3,3,55,1,3,"negative",-52,52,1,0
53,11,3,3,52,1,3,"negative",-49,49,1,0
53,12,3,3,48,4,3,"positive",-45,45,1,0
53,13,3,3,30,2,3,"negative",-27,27,1,0
53,14,3,5,55,2,4,"negative",-52,52,1,1
53,15,5,5,42,5,5,"positive",-37,37,1,0
53,16,5,4,32,3,4,"neutral",-27,27,1,-1
53,17,3,3,41,3,3,"neutral",-38,38,1,0
53,18,5,5,48,4,3,"positive",-43,43,1,-2
53,19,3,3,49,3,3,"neutral",-46,46,1,0
53,20,3,3,44,3,3,"neutral",-41,41,1,0
53,21,5,4,33,5,4,"positive",-28,28,1,-1
53,22,5,5,51,2,3,"negative",-46,46,1,-2
53,23,3,3,37,3,3,"neutral",-34,34,1,0
53,24,3,3,43,5,3,"positive",-40,40,1,0
53,25,3,4,39,5,4,"positive",-36,36,1,1
53,26,5,3,35,3,3,"neutral",-30,30,1,-2
53,27,3,3,30,3,3,"neutral",-27,27,1,0
53,28,5,5,70,4,3,"positive",-65,65,1,-2
53,29,3,3,10,4,3,"positive",-7,7,1,0
53,30,5,4,23,4,4,"positive",-18,18,1,-1
53,31,5,5,23,3,4,"neutral",-18,18,1,-1
53,32,4,3,36,3,3,"neutral",-32,32,1,-1
53,33,3,3,33,4,3,"positive",-30,30,1,0
53,34,3,3,36,3,3,"neutral",-33,33,1,0
53,35,3,3,45,5,3,"positive",-42,42,1,0
53,36,3,3,43,2,3,"negative",-40,40,1,0
53,37,3,3,38,3,4,"neutral",-35,35,1,1
53,38,3,3,33,2,3,"negative",-30,30,1,0
53,39,3,3,47,4,4,"positive",-44,44,1,1
54,1,15,50,56,4,15,"positive",-41,41,1,0
54,2,20,50,29,4,30,"positive",-9,9,1,10
54,3,25,25,20,3,25,"neutral",5,5,-1,0
54,4,15,50,17,2,15,"negative",-2,2,1,0
54,5,15,30,38,1,20,"negative",-23,23,1,5
54,6,30,40,26,4,30,"positive",4,4,-1,0
54,7,55,50,62,4,60,"positive",-7,7,1,5
54,8,5,30,59,3,10,"neutral",-54,54,1,5
54,9,20,30,65,3,30,"neutral",-45,45,1,10
54,10,15,15,55,3,10,"neutral",-40,40,1,-5
54,11,75,70,52,4,50,"positive",23,23,-1,25
54,12,60,50,48,3,70,"neutral",12,12,-1,-10
54,13,10,20,30,3,20,"neutral",-20,20,1,10
54,14,60,50,55,4,35,"positive",5,5,-1,25
54,15,70,40,42,3,70,"neutral",28,28,-1,0
54,16,60,50,32,3,65,"neutral",28,28,-1,-5
54,17,25,40,41,3,35,"neutral",-16,16,1,10
54,18,30,30,48,3,30,"neutral",-18,18,1,0
54,19,40,60,49,4,55,"positive",-9,9,1,15
54,20,35,35,44,2,30,"negative",-9,9,1,-5
54,21,25,40,33,3,30,"neutral",-8,8,1,5
54,22,40,60,51,3,15,"neutral",-11,11,1,-25
54,23,45,45,37,3,40,"neutral",8,8,-1,5
54,24,50,50,43,3,40,"neutral",7,7,-1,10
54,25,60,60,39,4,35,"positive",21,21,-1,25
54,26,35,50,35,3,30,"neutral",0,0,0,0
54,27,15,25,30,3,30,"neutral",-15,15,1,15
54,28,75,70,70,3,70,"neutral",5,5,-1,5
54,29,35,35,10,3,15,"neutral",25,25,-1,20
54,30,20,60,23,3,15,"neutral",-3,3,1,-5
54,31,25,40,23,3,45,"neutral",2,2,-1,-20
54,32,10,20,36,2,10,"negative",-26,26,1,0
54,33,20,60,33,2,20,"negative",-13,13,1,0
54,34,20,35,36,2,20,"negative",-16,16,1,0
54,35,10,60,45,3,5,"neutral",-35,35,1,-5
54,36,15,35,43,2,5,"negative",-28,28,1,-10
54,37,5,35,38,4,75,"positive",-33,33,1,70
54,38,40,40,33,3,20,"neutral",7,7,-1,20
54,39,20,40,47,2,33,"negative",-27,27,1,13
55,1,73,65,56,3,70,"neutral",17,17,-1,3
55,2,34,25,29,3,33,"neutral",5,5,-1,1
55,3,8,8,20,3,15,"neutral",-12,12,1,7
55,4,12,13,17,2,12,"negative",-5,5,1,0
55,5,15,34,38,3,15,"neutral",-23,23,1,0
55,6,25,34,26,3,20,"neutral",-1,1,1,-5
55,7,20,23,62,3,45,"neutral",-42,42,1,25
55,8,55,45,59,3,44,"neutral",-4,4,1,-11
55,9,5,12,65,2,12,"negative",-60,60,1,7
55,10,40,35,55,2,35,"negative",-15,15,1,-5
55,11,55,60,52,2,45,"negative",3,3,-1,10
55,12,23,22,48,3,32,"neutral",-25,25,1,9
55,13,21,23,30,3,33,"neutral",-9,9,1,12
55,14,40,45,55,3,33,"neutral",-15,15,1,-7
55,15,25,24,42,3,24,"neutral",-17,17,1,-1
55,16,65,65,32,3,34,"neutral",33,33,-1,31
55,17,30,50,41,3,34,"neutral",-11,11,1,4
55,18,36,43,48,3,34,"neutral",-12,12,1,-2
55,19,29,43,49,3,34,"neutral",-20,20,1,5
55,20,25,34,44,3,22,"neutral",-19,19,1,-3
55,21,55,45,33,3,56,"neutral",22,22,-1,-1
55,22,60,65,51,2,56,"negative",9,9,-1,4
55,23,20,20,37,2,24,"negative",-17,17,1,4
55,24,43,25,43,3,33,"neutral",0,0,0,0
55,25,24,20,39,3,45,"neutral",-15,15,1,21
55,26,55,55,35,3,45,"neutral",20,20,-1,10
55,27,45,50,30,3,33,"neutral",15,15,-1,12
55,28,55,60,70,3,55,"neutral",-15,15,1,0
55,29,24,33,10,3,24,"neutral",14,14,-1,0
55,30,4,5,23,3,15,"neutral",-19,19,1,11
55,31,10,10,23,3,23,"neutral",-13,13,1,13
55,32,4,7,36,2,15,"negative",-32,32,1,11
55,33,58,56,33,3,55,"neutral",25,25,-1,3
55,34,21,20,36,3,25,"neutral",-15,15,1,4
55,35,70,56,45,4,70,"positive",25,25,-1,0
55,36,40,34,43,3,23,"neutral",-3,3,1,-17
55,37,24,35,38,3,33,"neutral",-14,14,1,9
55,38,24,34,33,3,34,"neutral",-9,9,1,10
55,39,44,43,47,3,44,"neutral",-3,3,1,0
56,1,50,50,56,4,70,"positive",-6,6,1,20
56,2,54,69,29,3,35,"neutral",25,25,-1,19
56,3,77,77,20,4,66,"positive",57,57,-1,11
56,4,65,60,17,3,77,"neutral",48,48,-1,-12
56,5,70,77,38,3,47,"neutral",32,32,-1,23
56,6,20,50,26,3,65,"neutral",-6,6,1,45
56,7,70,70,62,4,67,"positive",8,8,-1,3
56,8,40,55,59,3,34,"neutral",-19,19,1,-6
56,9,35,50,65,2,20,"negative",-30,30,1,-15
56,10,75,65,55,3,70,"neutral",20,20,-1,5
56,11,55,65,52,2,77,"negative",3,3,-1,-22
56,12,40,60,48,3,58,"neutral",-8,8,1,18
56,13,3,3,30,1,15,"negative",-27,27,1,12
56,14,77,77,55,3,60,"neutral",22,22,-1,17
56,15,77,70,42,4,70,"positive",35,35,-1,7
56,16,40,60,32,3,20,"neutral",8,8,-1,20
56,17,60,60,41,3,60,"neutral",19,19,-1,0
56,18,30,50,48,3,35,"neutral",-18,18,1,5
56,19,50,45,49,4,60,"positive",1,1,-1,-10
56,20,45,50,44,4,70,"positive",1,1,-1,-25
56,21,20,30,33,5,20,"positive",-13,13,1,0
56,22,70,70,51,4,70,"positive",19,19,-1,0
56,23,55,70,37,4,20,"positive",18,18,-1,35
56,24,40,70,43,4,65,"positive",-3,3,1,25
56,25,5,10,39,2,65,"negative",-34,34,1,60
56,26,77,77,35,2,70,"negative",42,42,-1,7
56,27,70,70,30,3,65,"neutral",40,40,-1,5
56,28,50,77,70,4,50,"positive",-20,20,1,0
56,29,60,70,10,4,50,"positive",50,50,-1,10
56,30,35,35,23,3,35,"neutral",12,12,-1,0
56,31,45,55,23,3,60,"neutral",22,22,-1,-15
56,32,3,10,36,2,35,"negative",-33,33,1,32
56,33,65,70,33,4,45,"positive",32,32,-1,20
56,34,20,30,36,3,35,"neutral",-16,16,1,15
56,35,3,77,45,3,3,"neutral",-42,42,1,0
56,36,10,60,43,2,45,"negative",-33,33,1,35
56,37,50,60,38,4,60,"positive",12,12,-1,-10
56,38,50,50,33,3,40,"neutral",17,17,-1,10
56,39,65,70,47,2,60,"negative",18,18,-1,5
57,1,3,20,56,3,35,"neutral",-53,53,1,32
57,2,9,66,29,3,29,"neutral",-20,20,1,20
57,3,70,70,20,3,37,"neutral",50,50,-1,33
57,4,25,28,17,3,21,"neutral",8,8,-1,4
57,5,3,77,38,3,3,"neutral",-35,35,1,0
57,6,3,3,26,3,3,"neutral",-23,23,1,0
57,7,73,65,62,5,53,"positive",11,11,-1,20
57,8,3,50,59,3,25,"neutral",-56,56,1,22
57,9,45,45,65,3,30,"neutral",-20,20,1,-15
57,10,60,60,55,3,25,"neutral",5,5,-1,35
57,11,20,20,52,1,54,"negative",-32,32,1,34
57,12,65,65,48,3,51,"neutral",17,17,-1,14
57,13,3,9,30,3,10,"neutral",-27,27,1,7
57,14,50,50,55,3,25,"neutral",-5,5,1,-25
57,15,27,27,42,3,3,"neutral",-15,15,1,-24
57,16,77,64,32,3,26,"neutral",45,45,-1,51
57,17,20,77,41,3,55,"neutral",-21,21,1,35
57,18,55,55,48,3,37,"neutral",7,7,-1,18
57,19,52,52,49,3,54,"neutral",3,3,-1,-2
57,20,64,64,44,3,51,"neutral",20,20,-1,13
57,21,77,62,33,3,56,"neutral",44,44,-1,21
57,22,25,37,51,3,25,"neutral",-26,26,1,0
57,23,50,50,37,3,37,"neutral",13,13,-1,13
57,24,50,50,43,3,34,"neutral",7,7,-1,16
57,25,75,46,39,3,27,"neutral",36,36,-1,48
57,26,24,24,35,2,65,"negative",-11,11,1,41
57,27,69,69,30,3,50,"neutral",39,39,-1,19
57,28,26,26,70,3,65,"neutral",-44,44,1,39
57,29,45,45,10,3,21,"neutral",35,35,-1,24
57,30,3,50,23,1,3,"negative",-20,20,1,0
57,31,45,44,23,3,46,"neutral",22,22,-1,-1
57,32,35,35,36,2,36,"negative",-1,1,1,1
57,33,3,56,33,3,3,"neutral",-30,30,1,0
57,34,13,13,36,3,45,"neutral",-23,23,1,32
57,35,77,60,45,3,50,"neutral",32,32,-1,27
57,36,40,3,43,5,75,"positive",-3,3,1,35
57,37,33,33,38,4,63,"positive",-5,5,1,30
57,38,66,66,33,5,42,"positive",33,33,-1,24
57,39,77,77,47,3,25,"neutral",30,30,-1,52
58,1,77,77,56,4,77,"positive",21,21,-1,0
58,2,3,60,29,3,3,"neutral",-26,26,1,0
58,3,55,35,20,3,20,"neutral",35,35,-1,35
58,4,77,77,17,3,77,"neutral",60,60,-1,0
58,5,3,30,38,2,3,"negative",-35,35,1,0
58,6,60,50,26,3,60,"neutral",34,34,-1,0
58,7,30,45,62,3,30,"neutral",-32,32,1,0
58,8,25,32,59,3,30,"neutral",-34,34,1,5
58,9,35,30,65,3,20,"neutral",-30,30,1,-15
58,10,60,60,55,2,70,"negative",5,5,-1,-10
58,11,15,30,52,1,60,"negative",-37,37,1,45
58,12,70,60,48,3,60,"neutral",22,22,-1,10
58,13,30,40,30,3,20,"neutral",0,0,0,0
58,14,30,30,55,2,30,"negative",-25,25,1,0
58,15,3,60,42,3,3,"neutral",-39,39,1,0
58,16,60,20,32,3,60,"neutral",28,28,-1,0
58,17,50,40,41,3,30,"neutral",9,9,-1,20
58,18,40,35,48,3,40,"neutral",-8,8,1,0
58,19,40,50,49,3,50,"neutral",-9,9,1,10
58,20,40,33,44,3,25,"neutral",-4,4,1,-15
58,21,25,20,33,3,30,"neutral",-8,8,1,5
58,22,30,40,51,2,40,"negative",-21,21,1,10
58,23,77,20,37,3,30,"neutral",40,40,-1,47
58,24,20,30,43,3,77,"neutral",-23,23,1,57
58,25,5,3,39,3,20,"neutral",-34,34,1,15
58,26,50,70,35,3,20,"neutral",15,15,-1,30
58,27,35,50,30,3,40,"neutral",5,5,-1,-5
58,28,30,40,70,3,60,"neutral",-40,40,1,30
58,29,35,40,10,3,20,"neutral",25,25,-1,15
58,30,20,49,23,5,20,"positive",-3,3,1,0
58,31,30,20,23,3,20,"neutral",7,7,-1,10
58,32,20,50,36,3,30,"neutral",-16,16,1,10
58,33,50,60,33,3,60,"neutral",17,17,-1,-10
58,34,36,45,36,3,40,"neutral",0,0,0,0
58,35,3,34,45,3,3,"neutral",-42,42,1,0
58,36,3,60,43,1,3,"negative",-40,40,1,0
58,37,30,70,38,3,50,"neutral",-8,8,1,20
58,38,40,55,33,3,33,"neutral",7,7,-1,7
58,39,33,60,47,3,30,"neutral",-14,14,1,-3
59,1,35,56,56,2,53,"negative",-21,21,1,18
59,2,53,65,29,5,47,"positive",24,24,-1,6
59,3,38,55,20,3,51,"neutral",18,18,-1,-13
59,4,77,77,17,5,77,"positive",60,60,-1,0
59,5,54,63,38,4,41,"positive",16,16,-1,13
59,6,44,67,26,2,17,"negative",18,18,-1,27
59,7,47,64,62,4,57,"positive",-15,15,1,10
59,8,36,34,59,4,53,"positive",-23,23,1,17
59,9,6,11,65,4,37,"positive",-59,59,1,31
59,10,41,57,55,1,59,"negative",-14,14,1,18
59,11,28,23,52,1,26,"negative",-24,24,1,-2
59,12,72,68,48,4,22,"positive",24,24,-1,50
59,13,44,57,30,2,52,"negative",14,14,-1,-8
59,14,34,51,55,3,59,"neutral",-21,21,1,25
59,15,43,39,42,3,40,"neutral",1,1,-1,3
59,16,40,44,32,4,62,"positive",8,8,-1,-22
59,17,41,26,41,3,42,"neutral",0,0,0,0
59,18,63,36,48,3,60,"neutral",15,15,-1,3
59,19,21,43,49,2,63,"negative",-28,28,1,42
59,20,54,32,44,2,36,"negative",10,10,-1,18
59,21,60,69,33,5,24,"positive",27,27,-1,36
59,22,16,32,51,2,46,"negative",-35,35,1,30
59,23,50,50,37,2,32,"negative",13,13,-1,18
59,24,45,66,43,5,68,"positive",2,2,-1,-23
59,25,48,50,39,2,35,"negative",9,9,-1,13
59,26,71,58,35,3,29,"neutral",36,36,-1,42
59,27,28,62,30,3,48,"neutral",-2,2,1,20
59,28,37,41,70,3,55,"neutral",-33,33,1,18
59,29,18,26,10,5,31,"positive",8,8,-1,-13
59,30,9,32,23,4,62,"positive",-14,14,1,53
59,31,11,24,23,3,73,"neutral",-12,12,1,62
59,32,22,29,36,1,31,"negative",-14,14,1,9
59,33,18,41,33,3,28,"neutral",-15,15,1,10
59,34,48,69,36,4,26,"positive",12,12,-1,22
59,35,27,19,45,5,47,"positive",-18,18,1,20
59,36,25,33,43,1,66,"negative",-18,18,1,41
59,37,42,73,38,4,43,"positive",4,4,-1,-1
59,38,35,49,33,3,63,"neutral",2,2,-1,-28
59,39,26,53,47,1,49,"negative",-21,21,1,23
60,1,40,30,56,3,30,"neutral",-16,16,1,-10
60,2,20,40,29,4,20,"positive",-9,9,1,0
60,3,18,30,20,4,30,"positive",-2,2,1,12
60,4,18,20,17,2,5,"negative",1,1,-1,13
60,5,50,60,38,4,50,"positive",12,12,-1,0
60,6,4,20,26,1,3,"negative",-22,22,1,-1
60,7,65,60,62,4,70,"positive",3,3,-1,-5
60,8,70,70,59,5,67,"positive",11,11,-1,3
60,9,60,20,65,3,40,"neutral",-5,5,1,-20
60,10,65,60,55,1,60,"negative",10,10,-1,5
60,11,65,60,52,4,77,"positive",13,13,-1,-12
60,12,55,50,48,3,60,"neutral",7,7,-1,-5
60,13,5,20,30,3,30,"neutral",-25,25,1,25
60,14,70,65,55,2,50,"negative",15,15,-1,20
60,15,70,30,42,4,77,"positive",28,28,-1,-7
60,16,15,30,32,3,40,"neutral",-17,17,1,25
60,17,30,35,41,3,50,"neutral",-11,11,1,20
60,18,55,60,48,3,67,"neutral",7,7,-1,-12
60,19,40,50,49,4,67,"positive",-9,9,1,27
60,20,60,60,44,3,40,"neutral",16,16,-1,20
60,21,45,40,33,3,50,"neutral",12,12,-1,-5
60,22,10,30,51,2,30,"negative",-41,41,1,20
60,23,11,20,37,3,20,"neutral",-26,26,1,9
60,24,35,40,43,3,45,"neutral",-8,8,1,10
60,25,45,40,39,3,55,"neutral",6,6,-1,-10
60,26,23,45,35,3,50,"neutral",-12,12,1,27
60,27,30,30,30,4,20,"positive",0,0,0,0
60,28,60,70,70,3,60,"neutral",-10,10,1,0
60,29,30,35,10,3,15,"neutral",20,20,-1,15
60,30,30,50,23,3,50,"neutral",7,7,-1,-20
60,31,3,18,23,3,20,"neutral",-20,20,1,17
60,32,20,20,36,2,25,"negative",-16,16,1,5
60,33,50,50,33,3,60,"neutral",17,17,-1,-10
60,34,22,20,36,3,40,"neutral",-14,14,1,18
60,35,5,60,45,2,3,"negative",-40,40,1,-2
60,36,60,60,43,3,40,"neutral",17,17,-1,20
60,37,18,30,38,5,20,"positive",-20,20,1,2
60,38,50,60,33,3,55,"neutral",17,17,-1,-5
60,39,40,40,47,3,60,"neutral",-7,7,1,20
61,1,50,49,56,5,5,"positive",-6,6,1,-45
61,2,65,65,29,3,5,"neutral",36,36,-1,60
61,3,45,40,20,4,5,"positive",25,25,-1,40
61,4,70,65,17,4,20,"positive",53,53,-1,50
61,5,40,30,38,4,3,"positive",2,2,-1,37
61,6,45,55,26,4,39,"positive",19,19,-1,6
61,7,50,45,62,5,4,"positive",-12,12,1,-46
61,8,45,60,59,5,5,"positive",-14,14,1,-40
61,9,40,35,65,3,30,"neutral",-25,25,1,-10
61,10,50,66,55,5,4,"positive",-5,5,1,-46
61,11,50,65,52,4,4,"positive",-2,2,1,-46
61,12,35,40,48,4,40,"positive",-13,13,1,5
61,13,3,40,30,3,40,"neutral",-27,27,1,37
61,14,50,70,55,4,3,"positive",-5,5,1,-47
61,15,4,65,42,4,5,"positive",-38,38,1,1
61,16,40,39,32,4,40,"positive",8,8,-1,0
61,17,45,40,41,4,36,"positive",4,4,-1,9
61,18,50,65,48,5,4,"positive",2,2,-1,46
61,19,3,50,49,4,50,"positive",-46,46,1,47
61,20,3,30,44,4,40,"positive",-41,41,1,37
61,21,39,34,33,3,50,"neutral",6,6,-1,-11
61,22,50,70,51,4,4,"positive",-1,1,1,-46
61,23,35,30,37,4,40,"positive",-2,2,1,5
61,24,30,45,43,5,30,"positive",-13,13,1,0
61,25,55,65,39,3,50,"neutral",16,16,-1,5
61,26,45,65,35,3,3,"neutral",10,10,-1,42
61,27,50,65,30,5,40,"positive",20,20,-1,10
61,28,40,30,70,4,4,"positive",-30,30,1,-36
61,29,60,50,10,4,4,"positive",50,50,-1,56
61,30,50,45,23,4,4,"positive",27,27,-1,46
61,31,5,75,23,4,5,"positive",-18,18,1,0
61,32,3,6,36,4,4,"positive",-33,33,1,1
61,33,50,45,33,3,5,"neutral",17,17,-1,45
61,34,40,50,36,4,4,"positive",4,4,-1,36
61,35,45,50,45,4,39,"positive",0,0,0,0
61,36,49,59,43,5,3,"positive",6,6,-1,46
61,37,45,50,38,3,4,"neutral",7,7,-1,41
61,38,40,30,33,4,4,"positive",7,7,-1,36
61,39,50,30,47,3,4,"neutral",3,3,-1,46
62,1,70,35,56,4,70,"positive",14,14,-1,0
62,2,3,53,29,1,10,"negative",-26,26,1,7
62,3,57,57,20,3,27,"neutral",37,37,-1,30
62,4,35,45,17,3,25,"neutral",18,18,-1,10
62,5,65,65,38,1,3,"negative",27,27,-1,62
62,6,60,56,26,2,70,"negative",34,34,-1,-10
62,7,30,30,62,3,40,"neutral",-32,32,1,10
62,8,60,60,59,3,60,"neutral",1,1,-1,0
62,9,40,55,65,3,60,"neutral",-25,25,1,20
62,10,63,63,55,1,60,"negative",8,8,-1,3
62,11,67,67,52,5,60,"positive",15,15,-1,7
62,12,65,65,48,3,57,"neutral",17,17,-1,8
62,13,3,15,30,4,3,"positive",-27,27,1,0
62,14,40,60,55,3,30,"neutral",-15,15,1,-10
62,15,6,63,42,2,6,"negative",-36,36,1,0
62,16,60,60,32,4,56,"positive",28,28,-1,4
62,17,67,67,41,3,55,"neutral",26,26,-1,12
62,18,7,7,48,3,45,"neutral",-41,41,1,38
62,19,20,20,49,3,67,"neutral",-29,29,1,47
62,20,35,35,44,2,36,"negative",-9,9,1,1
62,21,70,50,33,3,45,"neutral",37,37,-1,25
62,22,45,55,51,2,37,"negative",-6,6,1,-8
62,23,20,20,37,3,36,"neutral",-17,17,1,16
62,24,64,64,43,3,40,"neutral",21,21,-1,24
62,25,45,45,39,3,43,"neutral",6,6,-1,2
62,26,67,67,35,3,68,"neutral",32,32,-1,-1
62,27,60,60,30,3,30,"neutral",30,30,-1,30
62,28,70,70,70,3,46,"neutral",0,0,0,0
62,29,65,60,10,4,46,"positive",55,55,-1,19
62,30,23,23,23,3,23,"neutral",0,0,0,0
62,31,57,57,23,3,30,"neutral",34,34,-1,27
62,32,34,34,36,2,40,"negative",-2,2,1,6
62,33,60,67,33,3,25,"neutral",27,27,-1,35
62,34,37,37,36,3,30,"neutral",1,1,-1,7
62,35,40,60,45,2,15,"negative",-5,5,1,-25
62,36,10,57,43,2,10,"negative",-33,33,1,0
62,37,70,70,38,3,49,"neutral",32,32,-1,21
62,38,3,3,33,3,40,"neutral",-30,30,1,37
62,39,47,47,47,2,35,"negative",0,0,0,0
63,1,10,10,56,3,3,"neutral",-46,46,1,-7
63,2,5,20,29,5,3,"positive",-24,24,1,-2
63,3,15,20,20,3,25,"neutral",-5,5,1,10
63,4,25,30,17,3,40,"neutral",8,8,-1,-15
63,5,15,28,38,4,20,"positive",-23,23,1,5
63,6,45,30,26,4,33,"positive",19,19,-1,12
63,7,15,40,62,3,50,"neutral",-47,47,1,35
63,8,20,60,59,3,60,"neutral",-39,39,1,40
63,9,40,40,65,2,45,"negative",-25,25,1,5
63,10,10,30,55,2,10,"negative",-45,45,1,0
63,11,77,70,52,3,60,"neutral",25,25,-1,17
63,12,45,40,48,3,60,"neutral",-3,3,1,15
63,13,10,10,30,3,40,"neutral",-20,20,1,30
63,14,65,60,55,4,60,"positive",10,10,-1,5
63,15,10,20,42,3,5,"neutral",-32,32,1,-5
63,16,5,60,32,3,5,"neutral",-27,27,1,0
63,17,35,40,41,3,65,"neutral",-6,6,1,30
63,18,60,60,48,3,60,"neutral",12,12,-1,0
63,19,50,60,49,3,30,"neutral",1,1,-1,20
63,20,45,40,44,3,45,"neutral",1,1,-1,0
63,21,25,40,33,4,30,"positive",-8,8,1,5
63,22,50,60,51,3,25,"neutral",-1,1,1,-25
63,23,8,15,37,2,15,"negative",-29,29,1,7
63,24,70,70,43,3,40,"neutral",27,27,-1,30
63,25,70,60,39,3,65,"neutral",31,31,-1,5
63,26,70,70,35,3,35,"neutral",35,35,-1,35
63,27,30,50,30,4,35,"positive",0,0,0,0
63,28,60,35,70,3,55,"neutral",-10,10,1,-5
63,29,15,20,10,3,15,"neutral",5,5,-1,0
63,30,66,66,23,3,35,"neutral",43,43,-1,31
63,31,40,40,23,3,35,"neutral",17,17,-1,5
63,32,20,30,36,3,30,"neutral",-16,16,1,10
63,33,30,60,33,3,15,"neutral",-3,3,1,-15
63,34,15,15,36,3,15,"neutral",-21,21,1,0
63,35,3,60,45,3,3,"neutral",-42,42,1,0
63,36,20,60,43,3,10,"neutral",-23,23,1,-10
63,37,30,40,38,3,15,"neutral",-8,8,1,-15
63,38,30,40,33,3,45,"neutral",-3,3,1,15
63,39,30,60,47,2,40,"negative",-17,17,1,10
64,1,3,66,56,2,3,"negative",-53,53,1,0
64,2,30,50,29,5,50,"positive",1,1,-1,-20
64,3,23,23,20,3,20,"neutral",3,3,-1,3
64,4,10,22,17,3,26,"neutral",-7,7,1,16
64,5,40,23,38,5,50,"positive",2,2,-1,-10
64,6,3,24,26,1,3,"negative",-23,23,1,0
64,7,3,5,62,3,58,"neutral",-59,59,1,55
64,8,40,35,59,3,64,"neutral",-19,19,1,24
64,9,7,8,65,1,62,"negative",-58,58,1,55
64,10,75,69,55,1,68,"negative",20,20,-1,7
64,11,77,70,52,4,3,"positive",25,25,-1,74
64,12,30,36,48,3,33,"neutral",-18,18,1,3
64,13,5,7,30,2,34,"negative",-25,25,1,29
64,14,15,24,55,3,47,"neutral",-40,40,1,32
64,15,33,33,42,3,50,"neutral",-9,9,1,17
64,16,77,70,32,3,64,"neutral",45,45,-1,13
64,17,72,69,41,3,38,"neutral",31,31,-1,34
64,18,70,70,48,3,33,"neutral",22,22,-1,37
64,19,65,60,49,5,30,"positive",16,16,-1,35
64,20,26,41,44,3,31,"neutral",-18,18,1,5
64,21,70,60,33,3,28,"neutral",37,37,-1,42
64,22,40,31,51,4,58,"positive",-11,11,1,18
64,23,45,40,37,3,30,"neutral",8,8,-1,15
64,24,57,51,43,4,40,"positive",14,14,-1,17
64,25,35,40,39,3,47,"neutral",-4,4,1,12
64,26,30,37,35,3,52,"neutral",-5,5,1,22
64,27,45,60,30,3,29,"neutral",15,15,-1,16
64,28,64,60,70,3,55,"neutral",-6,6,1,-9
64,29,40,33,10,5,17,"positive",30,30,-1,23
64,30,27,27,23,3,23,"neutral",4,4,-1,4
64,31,15,10,23,3,31,"neutral",-8,8,1,16
64,32,4,5,36,3,37,"neutral",-32,32,1,33
64,33,37,50,33,3,30,"neutral",4,4,-1,7
64,34,18,23,36,3,25,"neutral",-18,18,1,7
64,35,50,50,45,3,50,"neutral",5,5,-1,0
64,36,3,45,43,1,3,"negative",-40,40,1,0
64,37,71,62,38,3,26,"neutral",33,33,-1,45
64,38,65,65,33,3,55,"neutral",32,32,-1,10
64,39,60,40,47,2,39,"negative",13,13,-1,21
65,1,3,3,56,4,3,"positive",-53,53,1,0
65,2,20,35,29,5,48,"positive",-9,9,1,28
65,3,41,41,20,4,41,"positive",21,21,-1,0
65,4,65,41,17,3,46,"neutral",48,48,-1,19
65,5,3,56,38,1,3,"negative",-35,35,1,0
65,6,20,20,26,1,3,"negative",-6,6,1,-17
65,7,55,56,62,5,69,"positive",-7,7,1,14
65,8,46,45,59,4,59,"positive",-13,13,1,13
65,9,30,30,65,2,65,"negative",-35,35,1,35
65,10,10,14,55,1,48,"negative",-45,45,1,38
65,11,59,52,52,5,20,"positive",7,7,-1,39
65,12,30,30,48,3,38,"neutral",-18,18,1,8
65,13,14,5,30,2,48,"negative",-16,16,1,34
65,14,70,68,55,4,45,"positive",15,15,-1,25
65,15,56,60,42,5,48,"positive",14,14,-1,8
65,16,56,56,32,4,32,"positive",24,24,-1,24
65,17,25,35,41,3,36,"neutral",-16,16,1,11
65,18,19,20,48,3,23,"neutral",-29,29,1,4
65,19,25,30,49,4,52,"positive",-24,24,1,27
65,20,33,41,44,4,35,"positive",-11,11,1,2
65,21,30,30,33,3,30,"neutral",-3,3,1,0
65,22,56,56,51,4,17,"positive",5,5,-1,39
65,23,20,14,37,3,23,"neutral",-17,17,1,3
65,24,32,31,43,5,17,"positive",-11,11,1,-15
65,25,49,56,39,3,32,"neutral",10,10,-1,17
65,26,77,50,35,4,48,"positive",42,42,-1,29
65,27,43,42,30,3,42,"neutral",13,13,-1,1
65,28,42,48,70,4,52,"positive",-28,28,1,10
65,29,4,4,10,3,36,"neutral",-6,6,1,32
65,30,20,32,23,5,23,"positive",-3,3,1,3
65,31,60,66,23,4,49,"positive",37,37,-1,11
65,32,66,56,36,5,41,"positive",30,30,-1,25
65,33,35,69,33,5,45,"positive",2,2,-1,-10
65,34,48,42,36,3,42,"neutral",12,12,-1,6
65,35,4,77,45,3,32,"neutral",-41,41,1,28
65,36,58,45,43,4,18,"positive",15,15,-1,40
65,37,70,68,38,3,26,"neutral",32,32,-1,44
65,38,20,35,33,3,70,"neutral",-13,13,1,50
65,39,23,20,47,3,26,"neutral",-24,24,1,3
66,1,77,60,56,4,65,"positive",21,21,-1,12
66,2,20,52,29,4,23,"positive",-9,9,1,3
66,3,30,20,20,3,30,"neutral",10,10,-1,0
66,4,77,65,17,3,33,"neutral",60,60,-1,44
66,5,3,20,38,2,20,"negative",-35,35,1,17
66,6,30,40,26,4,20,"positive",4,4,-1,10
66,7,60,60,62,5,68,"positive",-2,2,1,8
66,8,43,40,59,3,45,"neutral",-16,16,1,2
66,9,23,23,65,3,60,"neutral",-42,42,1,37
66,10,56,55,55,2,42,"negative",1,1,-1,14
66,11,10,40,52,4,70,"positive",-42,42,1,60
66,12,65,60,48,3,64,"neutral",17,17,-1,1
66,13,3,10,30,2,20,"negative",-27,27,1,17
66,14,38,29,55,4,36,"positive",-17,17,1,-2
66,15,3,29,42,3,4,"neutral",-39,39,1,1
66,16,70,65,32,4,50,"positive",38,38,-1,20
66,17,9,9,41,3,65,"neutral",-32,32,1,56
66,18,60,40,48,3,48,"neutral",12,12,-1,12
66,19,56,50,49,5,77,"positive",7,7,-1,-21
66,20,40,65,44,4,32,"positive",-4,4,1,-8
66,21,24,20,33,3,32,"neutral",-9,9,1,8
66,22,77,45,51,3,41,"neutral",26,26,-1,36
66,23,45,36,37,3,58,"neutral",8,8,-1,-13
66,24,60,60,43,3,38,"neutral",17,17,-1,22
66,25,70,60,39,2,42,"negative",31,31,-1,28
66,26,39,36,35,3,36,"neutral",4,4,-1,3
66,27,50,46,30,4,35,"positive",20,20,-1,15
66,28,20,20,70,3,73,"neutral",-50,50,1,53
66,29,23,23,10,3,9,"neutral",13,13,-1,14
66,30,10,10,23,3,20,"neutral",-13,13,1,10
66,31,50,43,23,3,36,"neutral",27,27,-1,14
66,32,35,30,36,3,26,"neutral",-1,1,1,-9
66,33,72,60,33,3,60,"neutral",39,39,-1,12
66,34,30,26,36,3,29,"neutral",-6,6,1,-1
66,35,3,50,45,2,10,"negative",-42,42,1,7
66,36,3,67,43,1,3,"negative",-40,40,1,0
66,37,8,10,38,3,43,"neutral",-30,30,1,35
66,38,36,35,33,3,36,"neutral",3,3,-1,0
66,39,20,30,47,2,56,"negative",-27,27,1,36
67,1,10,45,56,4,46,"positive",-46,46,1,36
67,2,13,15,29,2,15,"negative",-16,16,1,2
67,3,65,24,20,4,21,"positive",45,45,-1,44
67,4,77,77,17,2,20,"negative",60,60,-1,57
67,5,65,45,38,4,60,"positive",27,27,-1,5
67,6,40,60,26,4,46,"positive",14,14,-1,-6
67,7,77,66,62,5,45,"positive",15,15,-1,32
67,8,14,46,59,2,16,"negative",-45,45,1,2
67,9,36,25,65,4,26,"positive",-29,29,1,-10
67,10,48,77,55,4,18,"positive",-7,7,1,-30
67,11,62,54,52,4,53,"positive",10,10,-1,9
67,12,26,45,48,4,14,"positive",-22,22,1,-12
67,13,34,26,30,3,46,"neutral",4,4,-1,-12
67,14,58,65,55,4,74,"positive",3,3,-1,-16
67,15,46,56,42,5,26,"positive",4,4,-1,20
67,16,34,56,32,3,52,"neutral",2,2,-1,-18
67,17,62,35,41,4,15,"positive",21,21,-1,47
67,18,77,45,48,2,54,"negative",29,29,-1,23
67,19,68,74,49,4,25,"positive",19,19,-1,43
67,20,23,14,44,3,12,"neutral",-21,21,1,-11
67,21,60,50,33,4,55,"positive",27,27,-1,5
67,22,50,50,51,3,17,"neutral",-1,1,1,-33
67,23,45,61,37,5,45,"positive",8,8,-1,0
67,24,26,41,43,4,46,"positive",-17,17,1,20
67,25,5,4,39,2,16,"negative",-34,34,1,11
67,26,41,26,35,2,62,"negative",6,6,-1,-21
67,27,18,23,30,3,16,"neutral",-12,12,1,-2
67,28,3,38,70,2,41,"negative",-67,67,1,38
67,29,26,72,10,2,13,"negative",16,16,-1,13
67,30,37,42,23,4,10,"positive",14,14,-1,27
67,31,77,77,23,5,18,"positive",54,54,-1,59
67,32,30,20,36,2,18,"negative",-6,6,1,-12
67,33,65,21,33,2,19,"negative",32,32,-1,46
67,34,47,26,36,2,46,"negative",11,11,-1,1
67,35,77,77,45,5,42,"positive",32,32,-1,35
67,36,23,45,43,2,23,"negative",-20,20,1,0
67,37,43,26,38,4,41,"positive",5,5,-1,2
67,38,35,14,33,2,12,"negative",2,2,-1,23
67,39,24,40,47,3,45,"neutral",-23,23,1,21
68,1,33,45,56,3,40,"neutral",-23,23,1,7
68,2,45,56,29,4,33,"positive",16,16,-1,12
68,3,50,65,20,4,45,"positive",30,30,-1,5
68,4,77,77,17,3,42,"neutral",60,60,-1,35
68,5,28,53,38,4,43,"positive",-10,10,1,15
68,6,33,40,26,4,45,"positive",7,7,-1,-12
68,7,42,60,62,2,56,"negative",-20,20,1,14
68,8,3,3,59,4,40,"positive",-56,56,1,37
68,9,33,28,65,3,55,"neutral",-32,32,1,22
68,10,65,77,55,4,42,"positive",10,10,-1,23
68,11,36,54,52,4,56,"positive",-16,16,1,20
68,12,53,3,48,3,55,"neutral",5,5,-1,-2
68,13,33,33,30,4,40,"positive",3,3,-1,-7
68,14,33,50,55,1,33,"negative",-22,22,1,0
68,15,65,68,42,4,33,"positive",23,23,-1,32
68,16,43,77,32,4,60,"positive",11,11,-1,-17
68,17,33,45,41,3,55,"neutral",-8,8,1,22
68,18,45,45,48,4,55,"positive",-3,3,1,10
68,19,42,63,49,4,45,"positive",-7,7,1,3
68,20,33,45,44,3,45,"neutral",-11,11,1,12
68,21,60,77,33,5,65,"positive",27,27,-1,-5
68,22,42,55,51,3,40,"neutral",-9,9,1,-2
68,23,55,35,37,3,33,"neutral",18,18,-1,22
68,24,34,65,43,4,77,"positive",-9,9,1,43
68,25,40,77,39,4,65,"positive",1,1,-1,-25
68,26,50,62,35,4,50,"positive",15,15,-1,0
68,27,42,45,30,4,33,"positive",12,12,-1,9
68,28,33,50,70,4,65,"positive",-37,37,1,32
68,29,35,42,10,3,68,"neutral",25,25,-1,-33
68,30,77,77,23,3,65,"neutral",54,54,-1,12
68,31,45,65,23,3,75,"neutral",22,22,-1,-30
68,32,54,42,36,3,33,"neutral",18,18,-1,21
68,33,66,66,33,4,65,"positive",33,33,-1,1
68,34,40,55,36,4,65,"positive",4,4,-1,-25
68,35,33,45,45,3,33,"neutral",-12,12,1,0
68,36,33,33,43,3,40,"neutral",-10,10,1,7
68,37,40,65,38,3,33,"neutral",2,2,-1,7
68,38,33,40,33,2,40,"negative",0,0,0,0
68,39,33,45,47,2,35,"negative",-14,14,1,2
69,1,50,70,56,4,50,"positive",-6,6,1,0
69,2,3,60,29,3,3,"neutral",-26,26,1,0
69,3,40,40,20,3,20,"neutral",20,20,-1,20
69,4,50,77,17,4,70,"positive",33,33,-1,-20
69,5,3,40,38,2,3,"negative",-35,35,1,0
69,6,3,25,26,4,3,"positive",-23,23,1,0
69,7,70,70,62,4,66,"positive",8,8,-1,4
69,8,10,25,59,4,60,"positive",-49,49,1,50
69,9,20,55,65,3,60,"neutral",-45,45,1,40
69,10,77,77,55,4,50,"positive",22,22,-1,27
69,11,70,70,52,4,55,"positive",18,18,-1,15
69,12,50,65,48,3,60,"neutral",2,2,-1,-10
69,13,3,3,30,3,60,"neutral",-27,27,1,57
69,14,20,30,55,4,40,"positive",-35,35,1,20
69,15,3,60,42,3,20,"neutral",-39,39,1,17
69,16,3,30,32,4,3,"positive",-29,29,1,0
69,17,40,40,41,4,60,"positive",-1,1,1,20
69,18,70,70,48,4,10,"positive",22,22,-1,60
69,19,40,50,49,4,20,"positive",-9,9,1,-20
69,20,50,77,44,3,40,"neutral",6,6,-1,10
69,21,10,77,33,2,40,"negative",-23,23,1,30
69,22,3,30,51,3,25,"neutral",-48,48,1,22
69,23,50,20,37,3,40,"neutral",13,13,-1,10
69,24,70,70,43,3,40,"neutral",27,27,-1,30
69,25,5,35,39,4,60,"positive",-34,34,1,55
69,26,10,77,35,3,50,"neutral",-25,25,1,40
69,27,3,10,30,4,60,"positive",-27,27,1,57
69,28,77,77,70,4,60,"positive",7,7,-1,17
69,29,20,60,10,4,20,"positive",10,10,-1,0
69,30,3,20,23,4,20,"positive",-20,20,1,17
69,31,20,20,23,4,77,"positive",-3,3,1,57
69,32,20,60,36,3,30,"neutral",-16,16,1,10
69,33,50,10,33,3,30,"neutral",17,17,-1,20
69,34,10,25,36,4,77,"positive",-26,26,1,67
69,35,77,65,45,3,77,"neutral",32,32,-1,0
69,36,77,65,43,2,60,"negative",34,34,-1,17
69,37,3,20,38,3,20,"neutral",-35,35,1,17
69,38,20,60,33,3,40,"neutral",-13,13,1,20
69,39,77,65,47,2,70,"negative",30,30,-1,7
70,1,40,40,56,3,40,"neutral",-16,16,1,0
70,2,33,33,29,3,40,"neutral",4,4,-1,-7
70,3,66,66,20,3,44,"neutral",46,46,-1,22
70,4,77,77,17,5,25,"positive",60,60,-1,52
70,5,20,40,38,3,35,"neutral",-18,18,1,15
70,6,10,10,26,3,50,"neutral",-16,16,1,40
70,7,20,20,62,3,44,"neutral",-42,42,1,24
70,8,33,33,59,4,44,"positive",-26,26,1,11
70,9,20,20,65,3,30,"neutral",-45,45,1,10
70,10,3,3,55,4,44,"positive",-52,52,1,41
70,11,44,44,52,4,44,"positive",-8,8,1,0
70,12,25,25,48,3,35,"neutral",-23,23,1,10
70,13,33,33,30,3,42,"neutral",3,3,-1,-9
70,14,33,33,55,4,56,"positive",-22,22,1,23
70,15,44,44,42,4,44,"positive",2,2,-1,0
70,16,65,65,32,5,35,"positive",33,33,-1,30
70,17,23,23,41,3,40,"neutral",-18,18,1,17
70,18,44,44,48,4,44,"positive",-4,4,1,0
70,19,20,20,49,2,33,"negative",-29,29,1,13
70,20,35,35,44,3,40,"neutral",-9,9,1,5
70,21,50,50,33,4,40,"positive",17,17,-1,10
70,22,25,25,51,3,35,"neutral",-26,26,1,10
70,23,33,33,37,3,20,"neutral",-4,4,1,-13
70,24,44,44,43,3,35,"neutral",1,1,-1,9
70,25,35,35,39,3,44,"neutral",-4,4,1,9
70,26,44,44,35,4,44,"positive",9,9,-1,0
70,27,3,3,30,3,35,"neutral",-27,27,1,32
70,28,3,3,70,4,44,"positive",-67,67,1,41
70,29,45,44,10,3,37,"neutral",35,35,-1,8
70,30,20,20,23,2,20,"negative",-3,3,1,0
70,31,3,3,23,2,55,"negative",-20,20,1,52
70,32,40,40,36,3,50,"neutral",4,4,-1,-10
70,33,3,3,33,4,35,"positive",-30,30,1,32
70,34,33,33,36,3,44,"neutral",-3,3,1,11
70,35,44,44,45,4,35,"positive",-1,1,1,-9
70,36,33,33,43,3,40,"neutral",-10,10,1,7
70,37,3,3,38,2,40,"negative",-35,35,1,37
70,38,20,20,33,3,40,"neutral",-13,13,1,20
70,39,40,40,47,4,60,"positive",-7,7,1,20
71,1,70,60,56,4,60,"positive",14,14,-1,10
71,2,60,50,29,4,50,"positive",31,31,-1,10
71,3,33,30,20,3,30,"neutral",13,13,-1,3
71,4,77,70,17,4,60,"positive",60,60,-1,17
71,5,30,30,38,4,30,"positive",-8,8,1,0
71,6,70,50,26,3,50,"neutral",44,44,-1,20
71,7,60,50,62,4,60,"positive",-2,2,1,0
71,8,30,30,59,3,40,"neutral",-29,29,1,10
71,9,40,40,65,3,40,"neutral",-25,25,1,0
71,10,30,30,55,2,40,"negative",-25,25,1,10
71,11,60,60,52,2,30,"negative",8,8,-1,30
71,12,30,30,48,3,30,"neutral",-18,18,1,0
71,13,30,30,30,3,49,"neutral",0,0,0,0
71,14,70,60,55,4,50,"positive",15,15,-1,20
71,15,50,50,42,4,60,"positive",8,8,-1,-10
71,16,40,30,32,4,40,"positive",8,8,-1,0
71,17,30,40,41,3,40,"neutral",-11,11,1,10
71,18,55,45,48,3,50,"neutral",7,7,-1,5
71,19,50,50,49,4,50,"positive",1,1,-1,0
71,20,40,30,44,4,40,"positive",-4,4,1,0
71,21,40,30,33,4,40,"positive",7,7,-1,0
71,22,40,30,51,4,40,"positive",-11,11,1,0
71,23,30,30,37,3,30,"neutral",-7,7,1,0
71,24,30,30,43,4,30,"positive",-13,13,1,0
71,25,60,70,39,3,40,"neutral",21,21,-1,20
71,26,60,60,35,3,50,"neutral",25,25,-1,10
71,27,60,60,30,3,40,"neutral",30,30,-1,20
71,28,45,40,70,3,30,"neutral",-25,25,1,-15
71,29,70,60,10,3,30,"neutral",60,60,-1,40
71,30,40,40,23,3,40,"neutral",17,17,-1,0
71,31,60,50,23,3,30,"neutral",37,37,-1,30
71,32,30,30,36,3,30,"neutral",-6,6,1,0
71,33,50,40,33,3,40,"neutral",17,17,-1,10
71,34,50,50,36,3,40,"neutral",14,14,-1,10
71,35,77,77,45,5,70,"positive",32,32,-1,7
71,36,30,30,43,3,30,"neutral",-13,13,1,0
71,37,30,30,38,3,50,"neutral",-8,8,1,20
71,38,55,45,33,3,40,"neutral",22,22,-1,15
71,39,70,60,47,3,50,"neutral",23,23,-1,20
72,1,3,50,56,3,3,"neutral",-53,53,1,0
72,2,77,77,29,4,77,"positive",48,48,-1,0
72,3,77,77,20,3,77,"neutral",57,57,-1,0
72,4,77,77,17,5,77,"positive",60,60,-1,0
72,5,3,77,38,5,3,"positive",-35,35,1,0
72,6,59,41,26,5,50,"positive",33,33,-1,9
72,7,3,3,62,5,77,"positive",-59,59,1,74
72,8,5,35,59,4,3,"positive",-54,54,1,-2
72,9,10,30,65,4,3,"positive",-55,55,1,-7
72,10,50,50,55,5,50,"positive",-5,5,1,0
72,11,3,30,52,3,3,"neutral",-49,49,1,0
72,12,50,50,48,5,3,"positive",2,2,-1,47
72,13,77,77,30,5,50,"positive",47,47,-1,27
72,14,66,66,55,3,77,"neutral",11,11,-1,-11
72,15,67,77,42,5,50,"positive",25,25,-1,17
72,16,5,77,32,5,3,"positive",-27,27,1,-2
72,17,77,77,41,5,50,"positive",36,36,-1,27
72,18,77,77,48,5,77,"positive",29,29,-1,0
72,19,77,47,49,5,77,"positive",28,28,-1,0
72,20,3,3,44,5,50,"positive",-41,41,1,47
72,21,70,70,33,3,77,"neutral",37,37,-1,-7
72,22,30,67,51,3,77,"neutral",-21,21,1,47
72,23,56,3,37,3,3,"neutral",19,19,-1,53
72,24,17,14,43,3,77,"neutral",-26,26,1,60
72,25,12,12,39,5,50,"positive",-27,27,1,38
72,26,77,77,35,3,77,"neutral",42,42,-1,0
72,27,3,35,30,3,77,"neutral",-27,27,1,74
72,28,77,77,70,3,77,"neutral",7,7,-1,0
72,29,50,50,10,3,77,"neutral",40,40,-1,-27
72,30,3,50,23,2,25,"negative",-20,20,1,22
72,31,46,46,23,3,67,"neutral",23,23,-1,-21
72,32,3,3,36,3,77,"neutral",-33,33,1,74
72,33,77,50,33,3,77,"neutral",44,44,-1,0
72,34,25,50,36,5,30,"positive",-11,11,1,5
72,35,77,77,45,3,77,"neutral",32,32,-1,0
72,36,20,30,43,3,77,"neutral",-23,23,1,57
72,37,77,10,38,4,3,"positive",39,39,-1,74
72,38,3,10,33,5,32,"positive",-30,30,1,29
72,39,77,77,47,3,77,"neutral",30,30,-1,0
73,1,3,20,56,4,45,"positive",-53,53,1,42
73,2,5,60,29,4,20,"positive",-24,24,1,15
73,3,5,50,20,4,20,"positive",-15,15,1,15
73,4,5,50,17,4,15,"positive",-12,12,1,10
73,5,3,20,38,3,30,"neutral",-35,35,1,27
73,6,3,20,26,3,15,"neutral",-23,23,1,12
73,7,4,35,62,4,50,"positive",-58,58,1,46
73,8,4,30,59,3,45,"neutral",-55,55,1,41
73,9,4,15,65,4,50,"positive",-61,61,1,46
73,10,5,75,55,2,20,"negative",-50,50,1,15
73,11,3,5,52,2,15,"negative",-49,49,1,12
73,12,4,20,48,3,20,"neutral",-44,44,1,16
73,13,4,25,30,3,33,"neutral",-26,26,1,29
73,14,5,50,55,4,46,"positive",-50,50,1,41
73,15,3,25,42,3,40,"neutral",-39,39,1,37
73,16,5,60,32,3,20,"neutral",-27,27,1,15
73,17,4,30,41,4,40,"positive",-37,37,1,36
73,18,4,20,48,5,45,"positive",-44,44,1,41
73,19,4,20,49,3,33,"neutral",-45,45,1,29
73,20,4,33,44,3,40,"neutral",-40,40,1,36
73,21,4,25,33,4,25,"positive",-29,29,1,21
73,22,3,20,51,3,50,"neutral",-48,48,1,47
73,23,4,5,37,2,30,"negative",-33,33,1,26
73,24,4,50,43,4,40,"positive",-39,39,1,36
73,25,3,20,39,3,39,"neutral",-36,36,1,36
73,26,4,40,35,4,35,"positive",-31,31,1,31
73,27,3,20,30,3,25,"neutral",-27,27,1,22
73,28,4,40,70,5,45,"positive",-66,66,1,41
73,29,3,15,10,4,40,"positive",-7,7,1,37
73,30,4,50,23,2,15,"negative",-19,19,1,11
73,31,4,20,23,4,23,"positive",-19,19,1,19
73,32,4,40,36,3,25,"neutral",-32,32,1,21
73,33,4,33,33,5,33,"positive",-29,29,1,29
73,34,3,20,36,3,39,"neutral",-33,33,1,36
73,35,4,60,45,4,30,"positive",-41,41,1,26
73,36,4,40,43,2,25,"negative",-39,39,1,21
73,37,3,15,38,3,35,"neutral",-35,35,1,32
73,38,3,25,33,3,35,"neutral",-30,30,1,32
73,39,4,33,47,3,30,"neutral",-43,43,1,26
74,1,20,60,56,4,10,"positive",-36,36,1,-10
74,2,30,45,29,3,20,"neutral",1,1,-1,10
74,3,40,30,20,4,20,"positive",20,20,-1,20
74,4,77,60,17,4,70,"positive",60,60,-1,7
74,5,3,30,38,4,10,"positive",-35,35,1,7
74,6,30,30,26,3,30,"neutral",4,4,-1,0
74,7,77,70,62,4,69,"positive",15,15,-1,8
74,8,30,40,59,4,40,"positive",-29,29,1,10
74,9,30,20,65,2,40,"negative",-35,35,1,10
74,10,70,60,55,2,70,"negative",15,15,-1,0
74,11,66,40,52,4,20,"positive",14,14,-1,46
74,12,15,35,48,4,20,"positive",-33,33,1,5
74,13,40,20,30,3,30,"neutral",10,10,-1,10
74,14,70,60,55,2,60,"negative",15,15,-1,10
74,15,70,40,42,3,70,"neutral",28,28,-1,0
74,16,30,50,32,4,30,"positive",-2,2,1,0
74,17,50,20,41,3,30,"neutral",9,9,-1,20
74,18,65,70,48,3,50,"neutral",17,17,-1,15
74,19,5,10,49,2,40,"negative",-44,44,1,35
74,20,40,50,44,3,20,"neutral",-4,4,1,-20
74,21,47,50,33,2,30,"negative",14,14,-1,17
74,22,20,50,51,4,30,"positive",-31,31,1,10
74,23,10,30,37,2,30,"negative",-27,27,1,20
74,24,50,40,43,4,33,"positive",7,7,-1,17
74,25,60,50,39,4,20,"positive",21,21,-1,40
74,26,77,50,35,3,50,"neutral",42,42,-1,27
74,27,45,50,30,3,30,"neutral",15,15,-1,15
74,28,20,30,70,3,50,"neutral",-50,50,1,30
74,29,10,10,10,3,20,"neutral",0,0,0,0
74,30,45,40,23,3,20,"neutral",22,22,-1,25
74,31,40,49,23,2,40,"negative",17,17,-1,0
74,32,40,53,36,2,25,"negative",4,4,-1,15
74,33,50,40,33,3,50,"neutral",17,17,-1,0
74,34,30,20,36,3,40,"neutral",-6,6,1,10
74,35,3,50,45,4,3,"positive",-42,42,1,0
74,36,5,40,43,3,30,"neutral",-38,38,1,25
74,37,20,40,38,3,10,"neutral",-18,18,1,-10
74,38,30,50,33,3,20,"neutral",-3,3,1,-10
74,39,30,50,47,3,30,"neutral",-17,17,1,0
75,1,23,35,56,3,51,"neutral",-33,33,1,28
75,2,45,54,29,5,35,"positive",16,16,-1,10
75,3,45,45,20,3,45,"neutral",25,25,-1,0
75,4,77,77,17,1,23,"negative",60,60,-1,54
75,5,23,26,38,3,51,"neutral",-15,15,1,28
75,6,67,50,26,2,60,"negative",41,41,-1,7
75,7,77,55,62,5,56,"positive",15,15,-1,21
75,8,77,77,59,3,40,"neutral",18,18,-1,37
75,9,33,50,65,1,35,"negative",-32,32,1,2
75,10,40,45,55,1,54,"negative",-15,15,1,14
75,11,15,33,52,1,57,"negative",-37,37,1,42
75,12,77,77,48,3,40,"neutral",29,29,-1,37
75,13,3,3,30,2,43,"negative",-27,27,1,40
75,14,45,20,55,2,56,"negative",-10,10,1,11
75,15,45,3,42,2,30,"negative",3,3,-1,15
75,16,68,55,32,4,47,"positive",36,36,-1,21
75,17,7,3,41,3,54,"neutral",-34,34,1,47
75,18,23,11,48,3,33,"neutral",-25,25,1,10
75,19,22,67,49,4,24,"positive",-27,27,1,2
75,20,27,35,44,3,56,"neutral",-17,17,1,29
75,21,45,56,33,4,30,"positive",12,12,-1,15
75,22,23,20,51,2,33,"negative",-28,28,1,10
75,23,35,33,37,2,34,"negative",-2,2,1,-1
75,24,25,20,43,5,31,"positive",-18,18,1,6
75,25,56,67,39,3,50,"neutral",17,17,-1,6
75,26,56,67,35,3,30,"neutral",21,21,-1,26
75,27,22,34,30,3,45,"neutral",-8,8,1,23
75,28,33,55,70,3,56,"neutral",-37,37,1,23
75,29,77,77,10,2,19,"negative",67,67,-1,58
75,30,67,77,23,3,23,"neutral",44,44,-1,44
75,31,77,77,23,3,27,"neutral",54,54,-1,50
75,32,56,56,36,1,40,"negative",20,20,-1,16
75,33,3,3,33,2,30,"negative",-30,30,1,27
75,34,20,50,36,3,21,"neutral",-16,16,1,1
75,35,45,50,45,4,3,"positive",0,0,0,0
75,36,40,30,43,2,39,"negative",-3,3,1,-1
75,37,77,77,38,2,50,"negative",39,39,-1,27
75,38,3,3,33,1,23,"negative",-30,30,1,20
75,39,3,10,47,2,34,"negative",-44,44,1,31
76,1,46,68,56,3,34,"neutral",-10,10,1,-12
76,2,54,54,29,5,67,"positive",25,25,-1,-13
76,3,34,53,20,1,20,"negative",14,14,-1,14
76,4,77,60,17,1,72,"negative",60,60,-1,5
76,5,77,60,38,2,77,"negative",39,39,-1,0
76,6,70,56,26,1,77,"negative",44,44,-1,-7
76,7,23,4,62,5,46,"positive",-39,39,1,23
76,8,24,50,59,1,22,"negative",-35,35,1,-2
76,9,34,3,65,5,12,"positive",-31,31,1,-22
76,10,28,22,55,1,23,"negative",-27,27,1,-5
76,11,5,12,52,2,57,"negative",-47,47,1,52
76,12,24,20,48,1,45,"negative",-24,24,1,21
76,13,12,28,30,5,8,"positive",-18,18,1,-4
76,14,60,60,55,3,32,"neutral",5,5,-1,28
76,15,60,40,42,3,60,"neutral",18,18,-1,0
76,16,50,50,32,1,45,"negative",18,18,-1,5
76,17,23,12,41,3,12,"neutral",-18,18,1,-11
76,18,66,65,48,2,42,"negative",18,18,-1,24
76,19,40,77,49,3,26,"neutral",-9,9,1,-14
76,20,50,40,44,4,48,"positive",6,6,-1,2
76,21,32,23,33,5,34,"positive",-1,1,1,2
76,22,77,69,51,5,32,"positive",26,26,-1,45
76,23,4,4,37,1,21,"negative",-33,33,1,17
76,24,40,23,43,5,48,"positive",-3,3,1,8
76,25,28,17,39,5,56,"positive",-11,11,1,28
76,26,46,24,35,1,67,"negative",11,11,-1,-21
76,27,36,38,30,3,33,"neutral",6,6,-1,3
76,28,32,30,70,3,38,"neutral",-38,38,1,6
76,29,75,77,10,3,70,"neutral",65,65,-1,5
76,30,56,45,23,3,43,"neutral",33,33,-1,13
76,31,47,45,23,3,18,"neutral",24,24,-1,29
76,32,21,22,36,1,24,"negative",-15,15,1,3
76,33,52,48,33,3,32,"neutral",19,19,-1,20
76,34,77,77,36,3,55,"neutral",41,41,-1,22
76,35,60,55,45,5,58,"positive",15,15,-1,2
76,36,24,68,43,1,5,"negative",-19,19,1,-19
76,37,77,77,38,1,58,"negative",39,39,-1,19
76,38,70,70,33,1,43,"negative",37,37,-1,27
76,39,34,45,47,3,20,"neutral",-13,13,1,-14
77,1,3,55,56,3,3,"neutral",-53,53,1,0
77,2,3,77,29,3,3,"neutral",-26,26,1,0
77,3,5,72,20,5,5,"positive",-15,15,1,0
77,4,4,67,17,4,5,"positive",-13,13,1,1
77,5,3,3,38,1,3,"negative",-35,35,1,0
77,6,4,50,26,3,4,"neutral",-22,22,1,0
77,7,3,77,62,3,4,"neutral",-59,59,1,1
77,8,5,75,59,4,5,"positive",-54,54,1,0
77,9,3,30,65,3,3,"neutral",-62,62,1,0
77,10,3,31,55,2,3,"negative",-52,52,1,0
77,11,3,50,52,2,3,"negative",-49,49,1,0
77,12,5,77,48,3,5,"neutral",-43,43,1,0
77,13,3,48,30,3,3,"neutral",-27,27,1,0
77,14,5,77,55,4,5,"positive",-50,50,1,0
77,15,5,77,42,4,4,"positive",-37,37,1,-1
77,16,3,33,32,3,3,"neutral",-29,29,1,0
77,17,3,45,41,3,4,"neutral",-38,38,1,1
77,18,3,60,48,3,4,"neutral",-45,45,1,1
77,19,3,43,49,3,3,"neutral",-46,46,1,0
77,20,3,77,44,3,4,"neutral",-41,41,1,1
77,21,4,56,33,4,5,"positive",-29,29,1,1
77,22,3,54,51,3,3,"neutral",-48,48,1,0
77,23,3,44,37,3,4,"neutral",-34,34,1,1
77,24,3,32,43,2,4,"negative",-40,40,1,1
77,25,3,34,39,3,3,"neutral",-36,36,1,0
77,26,4,77,35,3,4,"neutral",-31,31,1,0
77,27,3,34,30,3,3,"neutral",-27,27,1,0
77,28,4,60,70,3,4,"neutral",-66,66,1,0
77,29,4,34,10,3,3,"neutral",-6,6,1,-1
77,30,3,50,23,3,3,"neutral",-20,20,1,0
77,31,4,67,23,3,5,"neutral",-19,19,1,1
77,32,4,60,36,3,4,"neutral",-32,32,1,0
77,33,5,70,33,3,5,"neutral",-28,28,1,0
77,34,3,30,36,3,4,"neutral",-33,33,1,1
77,35,5,75,45,4,5,"positive",-40,40,1,0
77,36,3,33,43,1,3,"negative",-40,40,1,0
77,37,4,45,38,3,4,"neutral",-34,34,1,0
77,38,4,56,33,3,3,"neutral",-29,29,1,-1
77,39,3,45,47,3,4,"neutral",-44,44,1,1
78,1,70,40,56,3,70,"neutral",14,14,-1,0
78,2,50,40,29,2,50,"negative",21,21,-1,0
78,3,30,40,20,3,35,"neutral",10,10,-1,-5
78,4,65,55,17,4,55,"positive",48,48,-1,10
78,5,20,40,38,4,10,"positive",-18,18,1,-10
78,6,50,50,26,3,30,"neutral",24,24,-1,20
78,7,60,60,62,4,65,"positive",-2,2,1,5
78,8,55,50,59,3,50,"neutral",-4,4,1,-5
78,9,15,20,65,1,40,"negative",-50,50,1,25
78,10,50,60,55,3,60,"neutral",-5,5,1,10
78,11,70,60,52,3,70,"neutral",18,18,-1,0
78,12,60,60,48,3,40,"neutral",12,12,-1,20
78,13,40,40,30,3,35,"neutral",10,10,-1,5
78,14,60,60,55,2,60,"negative",5,5,-1,0
78,15,20,50,42,3,20,"neutral",-22,22,1,0
78,16,60,70,32,4,60,"positive",28,28,-1,0
78,17,60,50,41,3,60,"neutral",19,19,-1,0
78,18,50,50,48,3,50,"neutral",2,2,-1,0
78,19,40,30,49,2,20,"negative",-9,9,1,-20
78,20,25,30,44,4,50,"positive",-19,19,1,25
78,21,70,65,33,1,35,"negative",37,37,-1,35
78,22,60,70,51,3,50,"neutral",9,9,-1,10
78,23,65,60,37,3,60,"neutral",28,28,-1,5
78,24,70,60,43,3,40,"neutral",27,27,-1,30
78,25,40,50,39,3,35,"neutral",1,1,-1,5
78,26,40,50,35,2,40,"negative",5,5,-1,0
78,27,40,30,30,1,40,"negative",10,10,-1,0
78,28,60,60,70,3,60,"neutral",-10,10,1,0
78,29,40,40,10,3,50,"neutral",30,30,-1,-10
78,30,10,70,23,3,20,"neutral",-13,13,1,10
78,31,60,50,23,4,40,"positive",37,37,-1,20
78,32,40,50,36,3,20,"neutral",4,4,-1,20
78,33,65,60,33,3,30,"neutral",32,32,-1,35
78,34,50,45,36,3,40,"neutral",14,14,-1,10
78,35,70,50,45,3,65,"neutral",25,25,-1,5
78,36,50,45,43,2,20,"negative",7,7,-1,30
78,37,20,30,38,3,30,"neutral",-18,18,1,10
78,38,50,40,33,3,30,"neutral",17,17,-1,20
78,39,60,60,47,3,40,"neutral",13,13,-1,20
79,1,28,50,56,4,38,"positive",-28,28,1,10
79,2,20,23,29,3,30,"neutral",-9,9,1,10
79,3,55,70,20,3,35,"neutral",35,35,-1,20
79,4,20,44,17,2,30,"negative",3,3,-1,-10
79,5,66,60,38,4,30,"positive",28,28,-1,36
79,6,55,50,26,3,66,"neutral",29,29,-1,-11
79,7,35,45,62,3,60,"neutral",-27,27,1,25
79,8,32,45,59,4,70,"positive",-27,27,1,38
79,9,25,45,65,3,23,"neutral",-40,40,1,-2
79,10,70,60,55,2,45,"negative",15,15,-1,25
79,11,50,60,52,2,60,"negative",-2,2,1,10
79,12,10,20,48,3,30,"neutral",-38,38,1,20
79,13,35,50,30,3,35,"neutral",5,5,-1,0
79,14,20,60,55,2,45,"negative",-35,35,1,25
79,15,50,65,42,2,50,"negative",8,8,-1,0
79,16,55,50,32,3,37,"neutral",23,23,-1,18
79,17,40,55,41,3,43,"neutral",-1,1,1,3
79,18,40,50,48,3,55,"neutral",-8,8,1,15
79,19,40,45,49,3,49,"neutral",-9,9,1,9
79,20,40,45,44,3,30,"neutral",-4,4,1,-10
79,21,45,55,33,3,45,"neutral",12,12,-1,0
79,22,40,52,51,3,54,"neutral",-11,11,1,14
79,23,45,20,37,3,45,"neutral",8,8,-1,0
79,24,50,50,43,4,34,"positive",7,7,-1,16
79,25,70,60,39,3,36,"neutral",31,31,-1,34
79,26,58,70,35,3,65,"neutral",23,23,-1,-7
79,27,55,50,30,3,56,"neutral",25,25,-1,-1
79,28,32,55,70,3,50,"neutral",-38,38,1,18
79,29,45,50,10,3,70,"neutral",35,35,-1,-25
79,30,50,50,23,3,50,"neutral",27,27,-1,0
79,31,55,50,23,3,38,"neutral",32,32,-1,17
79,32,50,45,36,3,38,"neutral",14,14,-1,12
79,33,3,77,33,4,44,"positive",-30,30,1,41
79,34,50,50,36,3,70,"neutral",14,14,-1,-20
79,35,55,65,45,4,60,"positive",10,10,-1,-5
79,36,3,10,43,2,31,"negative",-40,40,1,28
79,37,48,40,38,3,45,"neutral",10,10,-1,3
79,38,34,43,33,3,30,"neutral",1,1,-1,4
79,39,25,35,47,3,50,"neutral",-22,22,1,25
80,1,10,10,56,3,23,"neutral",-46,46,1,13
80,2,31,46,29,4,25,"positive",2,2,-1,6
80,3,35,35,20,3,30,"neutral",15,15,-1,5
80,4,73,68,17,2,53,"negative",56,56,-1,20
80,5,29,31,38,3,27,"neutral",-9,9,1,-2
80,6,45,45,26,3,22,"neutral",19,19,-1,23
80,7,20,20,62,3,32,"neutral",-42,42,1,12
80,8,60,60,59,3,35,"neutral",1,1,-1,25
80,9,50,50,65,3,35,"neutral",-15,15,1,-15
80,10,26,33,55,2,47,"negative",-29,29,1,21
80,11,35,45,52,2,43,"negative",-17,17,1,8
80,12,65,55,48,3,31,"neutral",17,17,-1,34
80,13,50,50,30,3,21,"neutral",20,20,-1,29
80,14,67,67,55,3,28,"neutral",12,12,-1,39
80,15,25,40,42,3,28,"neutral",-17,17,1,3
80,16,27,37,32,3,30,"neutral",-5,5,1,3
80,17,35,37,41,3,40,"neutral",-6,6,1,5
80,18,30,30,48,3,25,"neutral",-18,18,1,-5
80,19,45,47,49,4,41,"positive",-4,4,1,-4
80,20,37,39,44,3,35,"neutral",-7,7,1,-2
80,21,25,30,33,4,25,"positive",-8,8,1,0
80,22,45,57,51,3,37,"neutral",-6,6,1,-8
80,23,35,35,37,3,38,"neutral",-2,2,1,3
80,24,30,35,43,3,30,"neutral",-13,13,1,0
80,25,69,65,39,3,53,"neutral",30,30,-1,16
80,26,65,60,35,3,42,"neutral",30,30,-1,23
80,27,27,27,30,3,23,"neutral",-3,3,1,-4
80,28,40,40,70,3,33,"neutral",-30,30,1,-7
80,29,22,27,10,3,18,"neutral",12,12,-1,4
80,30,14,27,23,3,24,"neutral",-9,9,1,10
80,31,60,60,23,3,27,"neutral",37,37,-1,33
80,32,20,45,36,2,31,"negative",-16,16,1,11
80,33,53,56,33,3,42,"neutral",20,20,-1,11
80,34,38,37,36,3,38,"neutral",2,2,-1,0
80,35,67,63,45,5,57,"positive",22,22,-1,10
80,36,10,10,43,2,17,"negative",-33,33,1,7
80,37,33,45,38,3,35,"neutral",-5,5,1,2
80,38,40,50,33,3,20,"neutral",7,7,-1,20
80,39,40,40,47,3,33,"neutral",-7,7,1,-7
81,1,75,40,56,5,77,"positive",19,19,-1,-2
81,2,77,77,29,5,60,"positive",48,48,-1,17
81,3,20,20,20,3,20,"neutral",0,0,0,0
81,4,30,10,17,3,40,"neutral",13,13,-1,-10
81,5,3,50,38,5,3,"positive",-35,35,1,0
81,6,50,50,26,4,20,"positive",24,24,-1,30
81,7,3,3,62,2,60,"negative",-59,59,1,57
81,8,65,65,59,3,60,"neutral",6,6,-1,5
81,9,50,50,65,3,20,"neutral",-15,15,1,-30
81,10,30,50,55,1,65,"negative",-25,25,1,35
81,11,40,20,52,5,20,"positive",-12,12,1,-20
81,12,30,30,48,3,43,"neutral",-18,18,1,13
81,13,3,3,30,4,30,"positive",-27,27,1,27
81,14,8,10,55,3,70,"neutral",-47,47,1,62
81,15,77,20,42,4,70,"positive",35,35,-1,7
81,16,65,77,32,4,70,"positive",33,33,-1,-5
81,17,50,50,41,3,77,"neutral",9,9,-1,-27
81,18,10,10,48,4,50,"positive",-38,38,1,40
81,19,50,65,49,3,40,"neutral",1,1,-1,10
81,20,40,60,44,3,40,"neutral",-4,4,1,0
81,21,40,30,33,4,60,"positive",7,7,-1,-20
81,22,10,10,51,3,50,"neutral",-41,41,1,40
81,23,20,20,37,3,50,"neutral",-17,17,1,30
81,24,45,33,43,3,60,"neutral",2,2,-1,-15
81,25,3,5,39,2,60,"negative",-36,36,1,57
81,26,75,75,35,3,75,"neutral",40,40,-1,0
81,27,60,60,30,4,30,"positive",30,30,-1,30
81,28,40,40,70,2,55,"negative",-30,30,1,15
81,29,50,50,10,3,30,"neutral",40,40,-1,20
81,30,20,20,23,3,23,"neutral",-3,3,1,3
81,31,35,35,23,3,60,"neutral",12,12,-1,-25
81,32,20,15,36,4,30,"positive",-16,16,1,10
81,33,75,65,33,4,60,"positive",42,42,-1,15
81,34,40,40,36,3,40,"neutral",4,4,-1,0
81,35,70,77,45,4,70,"positive",25,25,-1,0
81,36,60,40,43,4,50,"positive",17,17,-1,10
81,37,60,60,38,4,40,"positive",22,22,-1,20
81,38,77,50,33,3,60,"neutral",44,44,-1,17
81,39,77,65,47,2,43,"negative",30,30,-1,34
82,1,3,30,56,1,10,"negative",-53,53,1,7
82,2,40,50,29,5,20,"positive",11,11,-1,20
82,3,50,50,20,3,20,"neutral",30,30,-1,30
82,4,60,60,17,2,30,"negative",43,43,-1,30
82,5,10,50,38,3,10,"neutral",-28,28,1,0
82,6,20,50,26,1,20,"negative",-6,6,1,0
82,7,50,50,62,3,30,"neutral",-12,12,1,-20
82,8,50,50,59,3,30,"neutral",-9,9,1,-20
82,9,40,50,65,2,60,"negative",-25,25,1,20
82,10,40,40,55,2,20,"negative",-15,15,1,-20
82,11,70,70,52,4,70,"positive",18,18,-1,0
82,12,70,70,48,3,60,"neutral",22,22,-1,10
82,13,10,10,30,2,30,"negative",-20,20,1,20
82,14,60,60,55,4,50,"positive",5,5,-1,10
82,15,20,40,42,3,20,"neutral",-22,22,1,0
82,16,50,66,32,3,20,"neutral",18,18,-1,30
82,17,30,40,41,3,20,"neutral",-11,11,1,-10
82,18,30,30,48,3,60,"neutral",-18,18,1,30
82,19,60,60,49,3,50,"neutral",11,11,-1,10
82,20,40,40,44,3,50,"neutral",-4,4,1,10
82,21,30,30,33,3,50,"neutral",-3,3,1,20
82,22,70,60,51,4,40,"positive",19,19,-1,30
82,23,60,70,37,3,60,"neutral",23,23,-1,0
82,24,20,20,43,3,40,"neutral",-23,23,1,20
82,25,20,20,39,2,40,"negative",-19,19,1,20
82,26,70,50,35,4,60,"positive",35,35,-1,10
82,27,50,40,30,3,40,"neutral",20,20,-1,10
82,28,30,20,70,3,40,"neutral",-40,40,1,10
82,29,40,40,10,3,20,"neutral",30,30,-1,20
82,30,10,40,23,3,30,"neutral",-13,13,1,20
82,31,40,40,23,3,40,"neutral",17,17,-1,0
82,32,30,30,36,2,60,"negative",-6,6,1,30
82,33,60,60,33,4,30,"positive",27,27,-1,30
82,34,10,30,36,3,10,"neutral",-26,26,1,0
82,35,10,40,45,4,20,"positive",-35,35,1,10
82,36,70,60,43,2,50,"negative",27,27,-1,20
82,37,60,55,38,2,30,"negative",22,22,-1,30
82,38,60,60,33,3,20,"neutral",27,27,-1,40
82,39,50,50,47,2,50,"negative",3,3,-1,0
83,1,45,19,56,4,69,"positive",-11,11,1,24
83,2,73,59,29,5,63,"positive",44,44,-1,10
83,3,7,33,20,3,37,"neutral",-13,13,1,30
83,4,60,56,17,5,74,"positive",43,43,-1,-14
83,5,7,63,38,1,7,"negative",-31,31,1,0
83,6,20,10,26,3,49,"neutral",-6,6,1,29
83,7,57,62,62,4,59,"positive",-5,5,1,2
83,8,67,4,59,3,63,"neutral",8,8,-1,4
83,9,17,13,65,2,23,"negative",-48,48,1,6
83,10,16,10,55,4,16,"positive",-39,39,1,0
83,11,3,5,52,2,69,"negative",-49,49,1,66
83,12,67,58,48,4,58,"positive",19,19,-1,9
83,13,15,3,30,2,26,"negative",-15,15,1,11
83,14,36,27,55,3,17,"neutral",-19,19,1,-19
83,15,20,10,42,5,56,"positive",-22,22,1,36
83,16,74,4,32,5,73,"positive",42,42,-1,1
83,17,40,34,41,4,59,"positive",-1,1,1,19
83,18,44,20,48,2,65,"negative",-4,4,1,21
83,19,45,34,49,3,48,"neutral",-4,4,1,3
83,20,45,34,44,3,48,"neutral",1,1,-1,-3
83,21,10,5,33,3,17,"neutral",-23,23,1,7
83,22,56,33,51,4,23,"positive",5,5,-1,33
83,23,10,10,37,2,3,"negative",-27,27,1,-7
83,24,60,67,43,4,71,"positive",17,17,-1,-11
83,25,26,10,39,4,9,"positive",-13,13,1,-17
83,26,6,45,35,4,69,"positive",-29,29,1,63
83,27,17,45,30,4,40,"positive",-13,13,1,23
83,28,30,50,70,4,63,"positive",-40,40,1,33
83,29,50,45,10,2,49,"negative",40,40,-1,1
83,30,55,60,23,3,61,"neutral",32,32,-1,-6
83,31,71,73,23,1,59,"negative",48,48,-1,12
83,32,39,43,36,2,49,"negative",3,3,-1,-10
83,33,50,45,33,3,5,"neutral",17,17,-1,45
83,34,21,45,36,4,25,"positive",-15,15,1,4
83,35,77,60,45,4,77,"positive",32,32,-1,0
83,36,15,20,43,3,63,"neutral",-28,28,1,48
83,37,10,34,38,4,74,"positive",-28,28,1,64
83,38,12,14,33,2,40,"negative",-21,21,1,28
83,39,7,7,47,1,7,"negative",-40,40,1,0
84,1,67,34,56,4,67,"positive",11,11,-1,0
84,2,3,62,29,2,3,"negative",-26,26,1,0
84,3,60,60,20,2,68,"negative",40,40,-1,-8
84,4,3,56,17,2,3,"negative",-14,14,1,0
84,5,50,50,38,3,45,"neutral",12,12,-1,5
84,6,77,46,26,5,77,"positive",51,51,-1,0
84,7,7,28,62,3,6,"neutral",-55,55,1,-1
84,8,50,50,59,3,54,"neutral",-9,9,1,4
84,9,53,53,65,3,46,"neutral",-12,12,1,-7
84,10,77,57,55,3,67,"neutral",22,22,-1,10
84,11,3,77,52,5,3,"positive",-49,49,1,0
84,12,53,51,48,4,57,"positive",5,5,-1,-4
84,13,32,32,30,3,50,"neutral",2,2,-1,-18
84,14,63,63,55,3,49,"neutral",8,8,-1,14
84,15,3,63,42,3,3,"neutral",-39,39,1,0
84,16,20,50,32,3,20,"neutral",-12,12,1,0
84,17,50,50,41,3,52,"neutral",9,9,-1,-2
84,18,77,77,48,3,69,"neutral",29,29,-1,8
84,19,10,20,49,2,3,"negative",-39,39,1,-7
84,20,20,56,44,3,46,"neutral",-24,24,1,26
84,21,52,57,33,3,56,"neutral",19,19,-1,-4
84,22,56,57,51,2,61,"negative",5,5,-1,-5
84,23,20,53,37,3,28,"neutral",-17,17,1,8
84,24,77,49,43,4,57,"positive",34,34,-1,20
84,25,58,58,39,3,67,"neutral",19,19,-1,-9
84,26,34,46,35,3,35,"neutral",-1,1,1,1
84,27,64,50,30,4,64,"positive",34,34,-1,0
84,28,67,46,70,3,57,"neutral",-3,3,1,-10
84,29,36,36,10,5,46,"positive",26,26,-1,-10
84,30,59,59,23,3,50,"neutral",36,36,-1,9
84,31,45,45,23,3,48,"neutral",22,22,-1,-3
84,32,30,30,36,3,45,"neutral",-6,6,1,15
84,33,65,65,33,4,50,"positive",32,32,-1,15
84,34,27,40,36,2,65,"negative",-9,9,1,38
84,35,67,47,45,4,68,"positive",22,22,-1,-1
84,36,3,30,43,1,3,"negative",-40,40,1,0
84,37,3,46,38,3,3,"neutral",-35,35,1,0
84,38,3,60,33,4,77,"positive",-30,30,1,74
84,39,50,48,47,3,46,"neutral",3,3,-1,4
85,1,25,54,56,4,25,"positive",-31,31,1,0
85,2,77,50,29,5,77,"positive",48,48,-1,0
85,3,37,35,20,4,25,"positive",17,17,-1,12
85,4,45,70,17,5,25,"positive",28,28,-1,20
85,5,3,21,38,1,3,"negative",-35,35,1,0
85,6,3,50,26,3,3,"neutral",-23,23,1,0
85,7,70,53,62,3,65,"neutral",8,8,-1,5
85,8,30,55,59,2,42,"negative",-29,29,1,12
85,9,20,30,65,2,35,"negative",-45,45,1,15
85,10,77,70,55,4,70,"positive",22,22,-1,7
85,11,72,15,52,5,77,"positive",20,20,-1,-5
85,12,70,66,48,3,67,"neutral",22,22,-1,3
85,13,7,13,30,3,3,"neutral",-23,23,1,-4
85,14,62,65,55,2,62,"negative",7,7,-1,0
85,15,3,67,42,3,3,"neutral",-39,39,1,0
85,16,39,56,32,3,70,"neutral",7,7,-1,-31
85,17,20,30,41,3,62,"neutral",-21,21,1,42
85,18,58,58,48,4,55,"positive",10,10,-1,3
85,19,70,56,49,4,70,"positive",21,21,-1,0
85,20,25,31,44,4,41,"positive",-19,19,1,16
85,21,25,27,33,4,39,"positive",-8,8,1,14
85,22,77,68,51,3,10,"neutral",26,26,-1,67
85,23,69,65,37,5,57,"positive",32,32,-1,12
85,24,70,70,43,3,64,"neutral",27,27,-1,6
85,25,56,62,39,2,41,"negative",17,17,-1,15
85,26,75,68,35,2,68,"negative",40,40,-1,7
85,27,60,50,30,3,57,"neutral",30,30,-1,3
85,28,50,45,70,4,59,"positive",-20,20,1,9
85,29,32,38,10,4,22,"positive",22,22,-1,10
85,30,3,59,23,3,24,"neutral",-20,20,1,21
85,31,27,55,23,2,32,"negative",4,4,-1,-5
85,32,40,35,36,4,48,"positive",4,4,-1,-8
85,33,77,77,33,4,65,"positive",44,44,-1,12
85,34,72,65,36,4,42,"positive",36,36,-1,30
85,35,25,65,45,3,25,"neutral",-20,20,1,0
85,36,77,77,43,4,65,"positive",34,34,-1,12
85,37,77,77,38,3,65,"neutral",39,39,-1,12
85,38,40,42,33,3,46,"neutral",7,7,-1,-6
85,39,20,60,47,4,26,"positive",-27,27,1,6
86,1,77,77,56,4,56,"positive",21,21,-1,21
86,2,50,60,29,4,55,"positive",21,21,-1,-5
86,3,35,47,20,4,56,"positive",15,15,-1,-21
86,4,70,76,17,2,6,"negative",53,53,-1,64
86,5,41,44,38,4,57,"positive",3,3,-1,-16
86,6,5,56,26,4,5,"positive",-21,21,1,0
86,7,50,4,62,4,56,"positive",-12,12,1,6
86,8,44,70,59,4,39,"positive",-15,15,1,-5
86,9,43,44,65,2,67,"negative",-22,22,1,24
86,10,55,55,55,3,55,"neutral",0,0,0,0
86,11,3,3,52,4,65,"positive",-49,49,1,62
86,12,75,60,48,4,65,"positive",27,27,-1,10
86,13,3,33,30,4,77,"positive",-27,27,1,74
86,14,70,50,55,4,47,"positive",15,15,-1,23
86,15,77,77,42,3,40,"neutral",35,35,-1,37
86,16,3,33,32,5,55,"positive",-29,29,1,52
86,17,64,66,41,4,57,"positive",23,23,-1,7
86,18,72,70,48,4,60,"positive",24,24,-1,12
86,19,75,70,49,4,57,"positive",26,26,-1,18
86,20,33,40,44,4,68,"positive",-11,11,1,35
86,21,3,44,33,4,65,"positive",-30,30,1,62
86,22,70,70,51,4,58,"positive",19,19,-1,12
86,23,44,50,37,4,66,"positive",7,7,-1,-22
86,24,44,70,43,4,56,"positive",1,1,-1,-12
86,25,3,3,39,4,49,"positive",-36,36,1,46
86,26,3,77,35,2,47,"negative",-32,32,1,44
86,27,70,70,30,3,65,"neutral",40,40,-1,5
86,28,40,47,70,4,59,"positive",-30,30,1,19
86,29,65,40,10,3,58,"neutral",55,55,-1,7
86,30,3,35,23,3,3,"neutral",-20,20,1,0
86,31,77,77,23,4,69,"positive",54,54,-1,8
86,32,5,4,36,4,65,"positive",-31,31,1,60
86,33,77,77,33,2,65,"negative",44,44,-1,12
86,34,77,77,36,4,58,"positive",41,41,-1,19
86,35,77,77,45,4,77,"positive",32,32,-1,0
86,36,77,77,43,4,77,"positive",34,34,-1,0
86,37,75,74,38,4,45,"positive",37,37,-1,30
86,38,5,5,33,3,67,"neutral",-28,28,1,62
86,39,71,60,47,4,65,"positive",24,24,-1,6
87,1,18,43,56,5,14,"positive",-38,38,1,-4
87,2,15,33,29,5,17,"positive",-14,14,1,2
87,3,55,46,20,3,23,"neutral",35,35,-1,32
87,4,77,38,17,5,77,"positive",60,60,-1,0
87,5,50,22,38,2,33,"negative",12,12,-1,17
87,6,3,5,26,1,8,"negative",-23,23,1,5
87,7,60,58,62,5,77,"positive",-2,2,1,17
87,8,11,13,59,2,7,"negative",-48,48,1,-4
87,9,22,18,65,3,12,"neutral",-43,43,1,-10
87,10,75,68,55,1,77,"negative",20,20,-1,-2
87,11,70,37,52,1,77,"negative",18,18,-1,-7
87,12,11,12,48,3,11,"neutral",-37,37,1,0
87,13,8,12,30,2,9,"negative",-22,22,1,1
87,14,12,15,55,2,19,"negative",-43,43,1,7
87,15,74,60,42,5,77,"positive",32,32,-1,-3
87,16,77,58,32,5,77,"positive",45,45,-1,0
87,17,37,19,41,3,38,"neutral",-4,4,1,1
87,18,24,27,48,3,21,"neutral",-24,24,1,-3
87,19,71,55,49,3,65,"neutral",22,22,-1,6
87,20,40,22,44,3,32,"neutral",-4,4,1,-8
87,21,74,68,33,2,77,"negative",41,41,-1,-3
87,22,37,68,51,2,54,"negative",-14,14,1,17
87,23,3,3,37,3,13,"neutral",-34,34,1,10
87,24,70,48,43,4,33,"positive",27,27,-1,37
87,25,77,77,39,3,77,"neutral",38,38,-1,0
87,26,77,77,35,3,77,"neutral",42,42,-1,0
87,27,66,58,30,3,67,"neutral",36,36,-1,-1
87,28,32,40,70,4,36,"positive",-38,38,1,4
87,29,35,54,10,3,66,"neutral",25,25,-1,-31
87,30,23,70,23,3,68,"neutral",0,0,0,0
87,31,75,60,23,2,77,"negative",52,52,-1,-2
87,32,13,23,36,2,19,"negative",-23,23,1,6
87,33,74,68,33,4,77,"positive",41,41,-1,-3
87,34,76,70,36,2,46,"negative",40,40,-1,30
87,35,75,69,45,5,77,"positive",30,30,-1,-2
87,36,13,27,43,2,56,"negative",-30,30,1,43
87,37,72,52,38,2,70,"negative",34,34,-1,2
87,38,20,34,33,3,21,"neutral",-13,13,1,1
87,39,77,67,47,2,77,"negative",30,30,-1,0
88,1,35,56,56,3,10,"neutral",-21,21,1,-25
88,2,77,70,29,5,77,"positive",48,48,-1,0
88,3,38,50,20,5,43,"positive",18,18,-1,-5
88,4,77,77,17,4,77,"positive",60,60,-1,0
88,5,3,55,38,2,3,"negative",-35,35,1,0
88,6,60,75,26,4,58,"positive",34,34,-1,2
88,7,54,75,62,4,68,"positive",-8,8,1,14
88,8,40,60,59,4,68,"positive",-19,19,1,28
88,9,40,40,65,3,45,"neutral",-25,25,1,5
88,10,70,70,55,2,60,"negative",15,15,-1,10
88,11,45,58,52,1,25,"negative",-7,7,1,-20
88,12,30,30,48,3,45,"neutral",-18,18,1,15
88,13,10,12,30,4,10,"positive",-20,20,1,0
88,14,67,77,55,5,75,"positive",12,12,-1,-8
88,15,77,77,42,5,77,"positive",35,35,-1,0
88,16,20,50,32,3,35,"neutral",-12,12,1,15
88,17,30,55,41,4,45,"positive",-11,11,1,15
88,18,37,45,48,4,66,"positive",-11,11,1,29
88,19,62,77,49,2,30,"negative",13,13,-1,32
88,20,50,68,44,3,45,"neutral",6,6,-1,5
88,21,35,63,33,4,35,"positive",2,2,-1,0
88,22,68,68,51,3,65,"neutral",17,17,-1,3
88,23,20,32,37,2,24,"negative",-17,17,1,4
88,24,45,36,43,5,35,"positive",2,2,-1,10
88,25,60,66,39,3,50,"neutral",21,21,-1,10
88,26,77,77,35,3,68,"neutral",42,42,-1,9
88,27,68,60,30,4,45,"positive",38,38,-1,23
88,28,54,68,70,3,45,"neutral",-16,16,1,-9
88,29,60,60,10,3,56,"neutral",50,50,-1,4
88,30,10,60,23,3,24,"neutral",-13,13,1,14
88,31,42,71,23,3,65,"neutral",19,19,-1,-23
88,32,20,59,36,1,20,"negative",-16,16,1,0
88,33,45,75,33,3,46,"neutral",12,12,-1,-1
88,34,47,77,36,3,57,"neutral",11,11,-1,-10
88,35,20,50,45,3,20,"neutral",-25,25,1,0
88,36,35,60,43,1,34,"negative",-8,8,1,-1
88,37,25,30,38,4,10,"positive",-13,13,1,-15
88,38,40,57,33,3,45,"neutral",7,7,-1,-5
88,39,20,32,47,3,56,"neutral",-27,27,1,36
89,1,77,77,56,5,75,"positive",21,21,-1,2
89,2,10,50,29,5,10,"positive",-19,19,1,0
89,3,35,60,20,4,20,"positive",15,15,-1,15
89,4,77,70,17,2,70,"negative",60,60,-1,7
89,5,10,35,38,3,20,"neutral",-28,28,1,10
89,6,70,70,26,4,65,"positive",44,44,-1,5
89,7,60,60,62,5,45,"positive",-2,2,1,-15
89,8,35,50,59,4,40,"positive",-24,24,1,5
89,9,23,20,65,3,35,"neutral",-42,42,1,12
89,10,30,5,55,3,40,"neutral",-25,25,1,10
89,11,10,30,52,4,60,"positive",-42,42,1,50
89,12,3,4,48,4,4,"positive",-45,45,1,1
89,13,10,20,30,3,20,"neutral",-20,20,1,10
89,14,75,60,55,5,60,"positive",20,20,-1,15
89,15,70,70,42,5,60,"positive",28,28,-1,10
89,16,60,50,32,4,50,"positive",28,28,-1,10
89,17,60,70,41,3,60,"neutral",19,19,-1,0
89,18,75,60,48,4,75,"positive",27,27,-1,0
89,19,30,50,49,5,60,"positive",-19,19,1,30
89,20,50,70,44,4,50,"positive",6,6,-1,0
89,21,20,30,33,3,35,"neutral",-13,13,1,15
89,22,70,65,51,4,67,"positive",19,19,-1,3
89,23,3,36,37,1,20,"negative",-34,34,1,17
89,24,70,70,43,4,65,"positive",27,27,-1,5
89,25,20,60,39,5,50,"positive",-19,19,1,30
89,26,75,70,35,4,50,"positive",40,40,-1,25
89,27,76,76,30,5,60,"positive",46,46,-1,16
89,28,25,59,70,5,60,"positive",-45,45,1,35
89,29,10,35,10,4,65,"positive",0,0,0,0
89,30,35,10,23,3,10,"neutral",12,12,-1,25
89,31,45,50,23,3,23,"neutral",22,22,-1,22
89,32,5,10,36,2,65,"negative",-31,31,1,60
89,33,70,60,33,5,70,"positive",37,37,-1,0
89,34,30,20,36,4,10,"positive",-6,6,1,-20
89,35,20,70,45,5,20,"positive",-25,25,1,0
89,36,62,60,43,2,60,"negative",19,19,-1,2
89,37,70,60,38,4,60,"positive",32,32,-1,10
89,38,35,50,33,3,50,"neutral",2,2,-1,-15
89,39,20,30,47,3,50,"neutral",-27,27,1,30
90,1,10,50,56,2,10,"negative",-46,46,1,0
90,2,50,50,29,5,50,"positive",21,21,-1,0
90,3,60,45,20,3,39,"neutral",40,40,-1,21
90,4,75,73,17,3,65,"neutral",58,58,-1,10
90,5,15,15,38,4,50,"positive",-23,23,1,35
90,6,49,30,26,2,50,"negative",23,23,-1,-1
90,7,15,25,62,4,45,"positive",-47,47,1,30
90,8,60,60,59,3,55,"neutral",1,1,-1,5
90,9,60,45,65,1,50,"negative",-5,5,1,-10
90,10,70,65,55,3,60,"neutral",15,15,-1,10
90,11,10,25,52,2,40,"negative",-42,42,1,30
90,12,50,45,48,4,60,"positive",2,2,-1,-10
90,13,30,25,30,5,45,"positive",0,0,0,0
90,14,40,25,55,4,35,"positive",-15,15,1,-5
90,15,45,40,42,3,40,"neutral",3,3,-1,5
90,16,70,60,32,5,60,"positive",38,38,-1,10
90,17,35,30,41,3,30,"neutral",-6,6,1,-5
90,18,45,45,48,3,56,"neutral",-3,3,1,11
90,19,5,10,49,1,20,"negative",-44,44,1,15
90,20,50,60,44,3,35,"neutral",6,6,-1,15
90,21,10,15,33,5,35,"positive",-23,23,1,25
90,22,60,60,51,1,60,"negative",9,9,-1,0
90,23,10,40,37,3,20,"neutral",-27,27,1,10
90,24,40,35,43,4,50,"positive",-3,3,1,10
90,25,60,45,39,3,60,"neutral",21,21,-1,0
90,26,45,40,35,2,50,"negative",10,10,-1,-5
90,27,45,35,30,3,40,"neutral",15,15,-1,5
90,28,30,20,70,3,60,"neutral",-40,40,1,30
90,29,40,30,10,5,30,"positive",30,30,-1,10
90,30,10,25,23,3,15,"neutral",-13,13,1,5
90,31,45,35,23,3,45,"neutral",22,22,-1,0
90,32,20,30,36,1,15,"negative",-16,16,1,-5
90,33,20,20,33,3,35,"neutral",-13,13,1,15
90,34,49,45,36,3,30,"neutral",13,13,-1,19
90,35,60,40,45,5,65,"positive",15,15,-1,-5
90,36,10,30,43,1,10,"negative",-33,33,1,0
90,37,50,35,38,4,20,"positive",12,12,-1,30
90,38,40,50,33,3,30,"neutral",7,7,-1,10
90,39,60,50,47,4,54,"positive",13,13,-1,6
91,1,65,23,56,3,36,"neutral",9,9,-1,29
91,2,68,56,29,5,58,"positive",39,39,-1,10
91,3,20,25,20,3,37,"neutral",0,0,0,0
91,4,30,58,17,5,26,"positive",13,13,-1,4
91,5,27,48,38,3,28,"neutral",-11,11,1,1
91,6,70,70,26,2,45,"negative",44,44,-1,25
91,7,58,60,62,4,58,"positive",-4,4,1,0
91,8,56,60,59,3,69,"neutral",-3,3,1,13
91,9,6,17,65,1,26,"negative",-59,59,1,20
91,10,14,35,55,1,34,"negative",-41,41,1,20
91,11,77,70,52,2,60,"negative",25,25,-1,17
91,12,34,43,48,3,38,"neutral",-14,14,1,4
91,13,24,37,30,3,30,"neutral",-6,6,1,6
91,14,50,70,55,3,59,"neutral",-5,5,1,9
91,15,12,77,42,5,23,"positive",-30,30,1,11
91,16,34,50,32,3,29,"neutral",2,2,-1,5
91,17,3,3,41,1,35,"negative",-38,38,1,32
91,18,47,60,48,3,34,"neutral",-1,1,1,-13
91,19,23,50,49,3,36,"neutral",-26,26,1,13
91,20,70,65,44,3,45,"neutral",26,26,-1,25
91,21,65,58,33,4,30,"positive",32,32,-1,35
91,22,15,40,51,3,56,"neutral",-36,36,1,41
91,23,60,19,37,3,42,"neutral",23,23,-1,18
91,24,26,35,43,5,35,"positive",-17,17,1,9
91,25,3,32,39,4,34,"positive",-36,36,1,31
91,26,70,58,35,4,56,"positive",35,35,-1,14
91,27,48,46,30,3,36,"neutral",18,18,-1,12
91,28,77,77,70,3,56,"neutral",7,7,-1,21
91,29,53,62,10,3,47,"neutral",43,43,-1,6
91,30,42,38,23,3,36,"neutral",19,19,-1,6
91,31,58,56,23,3,34,"neutral",35,35,-1,24
91,32,3,14,36,3,35,"neutral",-33,33,1,32
91,33,40,45,33,3,42,"neutral",7,7,-1,-2
91,34,20,24,36,3,47,"neutral",-16,16,1,27
91,35,70,77,45,5,56,"positive",25,25,-1,14
91,36,20,47,43,3,27,"neutral",-23,23,1,7
91,37,40,45,38,3,45,"neutral",2,2,-1,-5
91,38,50,60,33,3,43,"neutral",17,17,-1,7
91,39,47,60,47,2,49,"negative",0,0,0,0
92,1,4,4,56,4,44,"positive",-52,52,1,40
92,2,30,32,29,5,44,"positive",1,1,-1,-14
92,3,57,55,20,3,55,"neutral",37,37,-1,2
92,4,5,4,17,4,55,"positive",-12,12,1,50
92,5,3,3,38,4,33,"positive",-35,35,1,30
92,6,55,44,26,3,66,"neutral",29,29,-1,-11
92,7,50,55,62,4,55,"positive",-12,12,1,5
92,8,4,3,59,4,44,"positive",-55,55,1,40
92,9,3,3,65,3,33,"neutral",-62,62,1,30
92,10,55,29,55,3,66,"neutral",0,0,0,0
92,11,3,3,52,4,44,"positive",-49,49,1,41
92,12,5,4,48,4,66,"positive",-43,43,1,61
92,13,33,45,30,3,44,"neutral",3,3,-1,-11
92,14,45,55,55,3,55,"neutral",-10,10,1,10
92,15,55,77,42,3,44,"neutral",13,13,-1,11
92,16,4,4,32,4,44,"positive",-28,28,1,40
92,17,45,33,41,5,33,"positive",4,4,-1,12
92,18,4,5,48,4,66,"positive",-44,44,1,62
92,19,49,55,49,3,33,"neutral",0,0,0,0
92,20,3,3,44,3,44,"neutral",-41,41,1,41
92,21,4,4,33,4,44,"positive",-29,29,1,40
92,22,29,33,51,4,33,"positive",-22,22,1,4
92,23,33,30,37,3,66,"neutral",-4,4,1,33
92,24,45,30,43,4,33,"positive",2,2,-1,12
92,25,55,55,39,4,30,"positive",16,16,-1,25
92,26,33,33,35,3,55,"neutral",-2,2,1,22
92,27,4,4,30,4,40,"positive",-26,26,1,36
92,28,49,55,70,3,55,"neutral",-21,21,1,6
92,29,4,4,10,4,66,"positive",-6,6,1,62
92,30,33,45,23,3,44,"neutral",10,10,-1,-11
92,31,33,33,23,3,44,"neutral",10,10,-1,-11
92,32,36,44,36,4,33,"positive",0,0,0,0
92,33,3,3,33,3,33,"neutral",-30,30,1,30
92,34,45,44,36,3,44,"neutral",9,9,-1,1
92,35,44,44,45,3,66,"neutral",-1,1,1,22
92,36,44,48,43,4,66,"positive",1,1,-1,-22
92,37,45,55,38,5,33,"positive",7,7,-1,12
92,38,3,3,33,3,66,"neutral",-30,30,1,63
92,39,3,3,47,3,44,"neutral",-44,44,1,41
93,1,50,77,56,4,55,"positive",-6,6,1,5
93,2,10,77,29,4,38,"positive",-19,19,1,28
93,3,23,74,20,4,26,"positive",3,3,-1,-3
93,4,77,77,17,4,26,"positive",60,60,-1,51
93,5,35,50,38,3,42,"neutral",-3,3,1,7
93,6,42,77,26,3,35,"neutral",16,16,-1,7
93,7,48,77,62,4,56,"positive",-14,14,1,8
93,8,26,65,59,3,60,"neutral",-33,33,1,34
93,9,35,52,65,3,56,"neutral",-30,30,1,21
93,10,3,35,55,3,58,"neutral",-52,52,1,55
93,11,48,73,52,4,26,"positive",-4,4,1,-22
93,12,10,42,48,2,48,"negative",-38,38,1,38
93,13,26,65,30,3,44,"neutral",-4,4,1,18
93,14,65,77,55,3,28,"neutral",10,10,-1,37
93,15,43,77,42,4,35,"positive",1,1,-1,8
93,16,35,65,32,3,48,"neutral",3,3,-1,-13
93,17,38,71,41,4,46,"positive",-3,3,1,8
93,18,70,77,48,4,32,"positive",22,22,-1,38
93,19,35,72,49,4,42,"positive",-14,14,1,7
93,20,65,77,44,4,56,"positive",21,21,-1,9
93,21,43,77,33,4,35,"positive",10,10,-1,8
93,22,35,70,51,3,23,"neutral",-16,16,1,-12
93,23,35,10,37,3,52,"neutral",-2,2,1,17
93,24,26,77,43,3,56,"neutral",-17,17,1,30
93,25,35,72,39,4,35,"positive",-4,4,1,0
93,26,70,65,35,3,35,"neutral",35,35,-1,35
93,27,26,50,30,3,35,"neutral",-4,4,1,9
93,28,17,77,70,3,48,"neutral",-53,53,1,31
93,29,43,77,10,3,48,"neutral",33,33,-1,-5
93,30,48,70,23,3,25,"neutral",25,25,-1,23
93,31,56,75,23,4,25,"positive",33,33,-1,31
93,32,43,65,36,2,35,"negative",7,7,-1,8
93,33,52,75,33,4,26,"positive",19,19,-1,26
93,34,43,77,36,3,48,"neutral",7,7,-1,-5
93,35,70,70,45,3,23,"neutral",25,25,-1,47
93,36,25,77,43,3,42,"neutral",-18,18,1,17
93,37,35,68,38,4,26,"positive",-3,3,1,-9
93,38,35,77,33,3,45,"neutral",2,2,-1,-10
93,39,10,77,47,2,48,"negative",-37,37,1,38
94,1,65,65,56,2,55,"negative",9,9,-1,10
94,2,20,50,29,4,16,"positive",-9,9,1,-4
94,3,40,35,20,3,31,"neutral",20,20,-1,9
94,4,35,23,17,2,22,"negative",18,18,-1,13
94,5,8,20,38,2,20,"negative",-30,30,1,12
94,6,50,25,26,4,15,"positive",24,24,-1,35
94,7,60,50,62,4,37,"positive",-2,2,1,-23
94,8,8,5,59,3,33,"neutral",-51,51,1,25
94,9,25,25,65,1,33,"negative",-40,40,1,8
94,10,35,45,55,1,45,"negative",-20,20,1,10
94,11,55,45,52,2,55,"negative",3,3,-1,0
94,12,5,25,48,4,39,"positive",-43,43,1,34
94,13,15,15,30,3,16,"neutral",-15,15,1,1
94,14,3,3,55,3,45,"neutral",-52,52,1,42
94,15,60,45,42,4,45,"positive",18,18,-1,15
94,16,55,65,32,3,23,"neutral",23,23,-1,32
94,17,15,10,41,3,55,"neutral",-26,26,1,40
94,18,25,15,48,3,73,"neutral",-23,23,1,48
94,19,45,45,49,3,45,"neutral",-4,4,1,0
94,20,45,65,44,4,35,"positive",1,1,-1,10
94,21,50,50,33,4,33,"positive",17,17,-1,17
94,22,25,30,51,3,42,"neutral",-26,26,1,17
94,23,45,50,37,3,41,"neutral",8,8,-1,4
94,24,55,56,43,4,25,"positive",12,12,-1,30
94,25,50,56,39,2,55,"negative",11,11,-1,-5
94,26,65,70,35,4,35,"positive",30,30,-1,30
94,27,40,55,30,2,35,"negative",10,10,-1,5
94,28,60,70,70,3,45,"neutral",-10,10,1,-15
94,29,45,45,10,5,33,"positive",35,35,-1,12
94,30,45,65,23,3,15,"neutral",22,22,-1,30
94,31,48,35,23,3,25,"neutral",25,25,-1,23
94,32,25,25,36,4,43,"positive",-11,11,1,18
94,33,50,55,33,4,25,"positive",17,17,-1,25
94,34,30,25,36,3,44,"neutral",-6,6,1,14
94,35,45,65,45,4,55,"positive",0,0,0,0
94,36,35,35,43,4,22,"positive",-8,8,1,-13
94,37,35,65,38,4,15,"positive",-3,3,1,-20
94,38,50,55,33,3,44,"neutral",17,17,-1,6
94,39,50,15,47,2,57,"negative",3,3,-1,-7
95,1,70,60,56,2,60,"negative",14,14,-1,10
95,2,70,70,29,3,60,"neutral",41,41,-1,10
95,3,50,60,20,3,40,"neutral",30,30,-1,10
95,4,30,50,17,2,30,"negative",13,13,-1,0
95,5,3,15,38,2,3,"negative",-35,35,1,0
95,6,10,20,26,1,10,"negative",-16,16,1,0
95,7,69,50,62,3,30,"neutral",7,7,-1,39
95,8,20,30,59,3,40,"neutral",-39,39,1,20
95,9,20,40,65,3,30,"neutral",-45,45,1,10
95,10,10,50,55,2,10,"negative",-45,45,1,0
95,11,70,30,52,4,70,"positive",18,18,-1,0
95,12,77,77,48,3,30,"neutral",29,29,-1,47
95,13,5,29,30,3,20,"neutral",-25,25,1,15
95,14,60,70,55,3,30,"neutral",5,5,-1,30
95,15,20,30,42,3,30,"neutral",-22,22,1,10
95,16,50,40,32,3,40,"neutral",18,18,-1,10
95,17,30,40,41,3,30,"neutral",-11,11,1,0
95,18,40,50,48,3,40,"neutral",-8,8,1,0
95,19,20,40,49,3,40,"neutral",-29,29,1,20
95,20,50,50,44,3,20,"neutral",6,6,-1,30
95,21,60,40,33,3,70,"neutral",27,27,-1,-10
95,22,3,77,51,3,30,"neutral",-48,48,1,27
95,23,10,20,37,2,30,"negative",-27,27,1,20
95,24,70,60,43,3,50,"neutral",27,27,-1,20
95,25,20,20,39,2,20,"negative",-19,19,1,0
95,26,70,70,35,3,30,"neutral",35,35,-1,40
95,27,70,60,30,1,40,"negative",40,40,-1,30
95,28,30,40,70,3,50,"neutral",-40,40,1,20
95,29,40,40,10,2,30,"negative",30,30,-1,10
95,30,20,30,23,3,10,"neutral",-3,3,1,-10
95,31,30,40,23,3,30,"neutral",7,7,-1,0
95,32,5,10,36,1,20,"negative",-31,31,1,15
95,33,70,70,33,3,60,"neutral",37,37,-1,10
95,34,30,40,36,3,20,"neutral",-6,6,1,-10
95,35,10,30,45,3,30,"neutral",-35,35,1,20
95,36,10,15,43,2,20,"negative",-33,33,1,10
95,37,10,30,38,3,10,"neutral",-28,28,1,0
95,38,50,60,33,3,30,"neutral",17,17,-1,20
95,39,50,60,47,3,30,"neutral",3,3,-1,20
96,1,70,70,56,3,70,"neutral",14,14,-1,0
96,2,60,60,29,5,54,"positive",31,31,-1,6
96,3,40,40,20,3,25,"neutral",20,20,-1,15
96,4,77,70,17,4,60,"positive",60,60,-1,17
96,5,70,50,38,3,65,"neutral",32,32,-1,5
96,6,45,40,26,3,51,"neutral",19,19,-1,-6
96,7,50,46,62,5,51,"positive",-12,12,1,1
96,8,10,20,59,3,60,"neutral",-49,49,1,50
96,9,5,10,65,3,12,"neutral",-60,60,1,7
96,10,26,35,55,2,57,"negative",-29,29,1,31
96,11,60,40,52,2,50,"negative",8,8,-1,10
96,12,25,30,48,3,25,"neutral",-23,23,1,0
96,13,20,15,30,3,34,"neutral",-10,10,1,14
96,14,35,24,55,4,34,"positive",-20,20,1,-1
96,15,70,70,42,4,70,"positive",28,28,-1,0
96,16,60,60,32,3,50,"neutral",28,28,-1,10
96,17,50,40,41,4,24,"positive",9,9,-1,26
96,18,40,40,48,3,40,"neutral",-8,8,1,0
96,19,40,25,49,4,40,"positive",-9,9,1,0
96,20,40,60,44,4,42,"positive",-4,4,1,2
96,21,50,60,33,5,56,"positive",17,17,-1,-6
96,22,20,20,51,3,40,"neutral",-31,31,1,20
96,23,3,5,37,2,3,"negative",-34,34,1,0
96,24,20,30,43,4,15,"positive",-23,23,1,-5
96,25,3,10,39,3,40,"neutral",-36,36,1,37
96,26,15,55,35,4,10,"positive",-20,20,1,-5
96,27,20,40,30,3,43,"neutral",-10,10,1,23
96,28,65,70,70,2,67,"negative",-5,5,1,2
96,29,20,50,10,3,38,"neutral",10,10,-1,-18
96,30,3,10,23,5,10,"positive",-20,20,1,7
96,31,20,15,23,4,30,"positive",-3,3,1,10
96,32,3,15,36,2,45,"negative",-33,33,1,42
96,33,30,30,33,3,45,"neutral",-3,3,1,15
96,34,60,60,36,3,30,"neutral",24,24,-1,30
96,35,77,65,45,4,70,"positive",32,32,-1,7
96,36,10,20,43,3,60,"neutral",-33,33,1,50
96,37,50,50,38,4,70,"positive",12,12,-1,-20
96,38,40,50,33,3,25,"neutral",7,7,-1,15
96,39,50,70,47,4,34,"positive",3,3,-1,16
97,1,3,77,56,3,3,"neutral",-53,53,1,0
97,2,15,28,29,4,20,"positive",-14,14,1,5
97,3,25,25,20,3,25,"neutral",5,5,-1,0
97,4,45,30,17,4,77,"positive",28,28,-1,-32
97,5,3,15,38,1,7,"negative",-35,35,1,4
97,6,10,50,26,3,7,"neutral",-16,16,1,-3
97,7,45,45,62,3,55,"neutral",-17,17,1,10
97,8,65,65,59,3,50,"neutral",6,6,-1,15
97,9,15,20,65,3,15,"neutral",-50,50,1,0
97,10,25,38,55,2,25,"negative",-30,30,1,0
97,11,77,77,52,4,77,"positive",25,25,-1,0
97,12,65,65,48,3,60,"neutral",17,17,-1,5
97,13,10,20,30,3,15,"neutral",-20,20,1,5
97,14,25,25,55,3,15,"neutral",-30,30,1,-10
97,15,3,45,42,4,5,"positive",-39,39,1,2
97,16,5,35,32,3,5,"neutral",-27,27,1,0
97,17,35,35,41,3,35,"neutral",-6,6,1,0
97,18,60,65,48,3,45,"neutral",12,12,-1,15
97,19,45,65,49,3,40,"neutral",-4,4,1,-5
97,20,10,15,44,3,35,"neutral",-34,34,1,25
97,21,25,15,33,3,25,"neutral",-8,8,1,0
97,22,35,35,51,3,20,"neutral",-16,16,1,-15
97,23,60,40,37,3,60,"neutral",23,23,-1,0
97,24,45,45,43,3,55,"neutral",2,2,-1,-10
97,25,7,7,39,3,20,"neutral",-32,32,1,13
97,26,70,70,35,3,70,"neutral",35,35,-1,0
97,27,38,38,30,3,35,"neutral",8,8,-1,3
97,28,55,35,70,3,65,"neutral",-15,15,1,10
97,29,40,42,10,3,30,"neutral",30,30,-1,10
97,30,3,45,23,3,3,"neutral",-20,20,1,0
97,31,30,30,23,3,40,"neutral",7,7,-1,-10
97,32,10,10,36,3,15,"neutral",-26,26,1,5
97,33,10,25,33,3,5,"neutral",-23,23,1,-5
97,34,45,58,36,3,55,"neutral",9,9,-1,-10
97,35,55,27,45,4,55,"positive",10,10,-1,0
97,36,3,10,43,1,15,"negative",-40,40,1,12
97,37,70,70,38,3,77,"neutral",32,32,-1,-7
97,38,55,55,33,3,55,"neutral",22,22,-1,0
97,39,66,55,47,2,50,"negative",19,19,-1,16
98,1,5,24,56,3,24,"neutral",-51,51,1,19
98,2,77,50,29,5,36,"positive",48,48,-1,41
98,3,69,60,20,3,26,"neutral",49,49,-1,43
98,4,19,67,17,2,11,"negative",2,2,-1,8
98,5,8,10,38,3,7,"neutral",-30,30,1,-1
98,6,5,32,26,1,7,"negative",-21,21,1,2
98,7,10,23,62,3,62,"neutral",-52,52,1,52
98,8,13,22,59,3,32,"neutral",-46,46,1,19
98,9,50,40,65,2,55,"negative",-15,15,1,5
98,10,60,75,55,1,64,"negative",5,5,-1,-4
98,11,68,24,52,1,65,"negative",16,16,-1,3
98,12,64,60,48,3,60,"neutral",16,16,-1,4
98,13,10,22,30,3,30,"neutral",-20,20,1,20
98,14,19,27,55,4,50,"positive",-36,36,1,31
98,15,20,54,42,3,28,"neutral",-22,22,1,8
98,16,55,43,32,3,29,"neutral",23,23,-1,26
98,17,10,23,41,3,39,"neutral",-31,31,1,29
98,18,77,77,48,4,33,"positive",29,29,-1,44
98,19,25,40,49,3,31,"neutral",-24,24,1,6
98,20,56,64,44,3,40,"neutral",12,12,-1,16
98,21,77,70,33,2,32,"negative",44,44,-1,45
98,22,50,69,51,3,35,"neutral",-1,1,1,-15
98,23,29,18,37,3,38,"neutral",-8,8,1,9
98,24,70,40,43,4,60,"positive",27,27,-1,10
98,25,15,20,39,3,40,"neutral",-24,24,1,25
98,26,70,70,35,3,21,"neutral",35,35,-1,49
98,27,53,39,30,4,37,"positive",23,23,-1,16
98,28,40,70,70,5,69,"positive",-30,30,1,29
98,29,21,40,10,4,36,"positive",11,11,-1,-15
98,30,3,34,23,2,6,"negative",-20,20,1,3
98,31,41,40,23,3,23,"neutral",18,18,-1,18
98,32,60,70,36,2,19,"negative",24,24,-1,41
98,33,77,75,33,4,40,"positive",44,44,-1,37
98,34,37,21,36,3,59,"neutral",1,1,-1,-22
98,35,12,23,45,4,33,"positive",-33,33,1,21
98,36,3,70,43,1,3,"negative",-40,40,1,0
98,37,8,5,38,3,50,"neutral",-30,30,1,42
98,38,54,61,33,4,23,"positive",21,21,-1,31
98,39,30,38,47,3,65,"neutral",-17,17,1,35
99,1,10,10,56,4,77,"positive",-46,46,1,67
99,2,40,30,29,5,77,"positive",11,11,-1,-37
99,3,20,20,20,3,20,"neutral",0,0,0,0
99,4,70,60,17,2,30,"negative",53,53,-1,40
99,5,3,3,38,4,40,"positive",-35,35,1,37
99,6,5,5,26,2,20,"negative",-21,21,1,15
99,7,3,3,62,3,30,"neutral",-59,59,1,27
99,8,55,55,59,3,50,"neutral",-4,4,1,-5
99,9,3,3,65,3,20,"neutral",-62,62,1,17
99,10,30,50,55,2,35,"negative",-25,25,1,5
99,11,3,3,52,1,10,"negative",-49,49,1,7
99,12,55,55,48,3,60,"neutral",7,7,-1,-5
99,13,30,30,30,3,30,"neutral",0,0,0,0
99,14,40,40,55,3,40,"neutral",-15,15,1,0
99,15,40,40,42,3,30,"neutral",-2,2,1,-10
99,16,30,30,32,3,20,"neutral",-2,2,1,-10
99,17,30,30,41,3,40,"neutral",-11,11,1,10
99,18,65,60,48,3,40,"neutral",17,17,-1,25
99,19,40,30,49,2,30,"negative",-9,9,1,-10
99,20,30,30,44,3,40,"neutral",-14,14,1,10
99,21,40,40,33,4,60,"positive",7,7,-1,-20
99,22,10,20,51,3,20,"neutral",-41,41,1,10
99,23,30,30,37,3,40,"neutral",-7,7,1,10
99,24,30,30,43,3,40,"neutral",-13,13,1,10
99,25,15,15,39,3,20,"neutral",-24,24,1,5
99,26,5,5,35,3,77,"neutral",-30,30,1,72
99,27,70,70,30,3,40,"neutral",40,40,-1,30
99,28,6,6,70,3,60,"neutral",-64,64,1,54
99,29,7,9,10,3,50,"neutral",-3,3,1,43
99,30,10,10,23,3,10,"neutral",-13,13,1,0
99,31,60,60,23,3,50,"neutral",37,37,-1,10
99,32,5,5,36,3,30,"neutral",-31,31,1,25
99,33,8,8,33,4,65,"positive",-25,25,1,57
99,34,40,40,36,3,40,"neutral",4,4,-1,0
99,35,70,20,45,4,67,"positive",25,25,-1,3
99,36,20,20,43,3,70,"neutral",-23,23,1,50
99,37,77,70,38,2,77,"negative",39,39,-1,0
99,38,60,60,33,3,50,"neutral",27,27,-1,10
99,39,5,5,47,3,50,"neutral",-42,42,1,45
100,1,24,43,56,3,39,"neutral",-32,32,1,15
100,2,60,76,29,2,43,"negative",31,31,-1,17
100,3,70,67,20,2,45,"negative",50,50,-1,25
100,4,60,57,17,3,47,"neutral",43,43,-1,13
100,5,42,21,38,4,41,"positive",4,4,-1,1
100,6,45,32,26,3,28,"neutral",19,19,-1,17
100,7,45,56,62,4,56,"positive",-17,17,1,11
100,8,9,12,59,3,55,"neutral",-50,50,1,46
100,9,21,43,65,2,56,"negative",-44,44,1,35
100,10,23,54,55,4,21,"positive",-32,32,1,-2
100,11,35,23,52,2,21,"negative",-17,17,1,-14
100,12,57,77,48,3,43,"neutral",9,9,-1,14
100,13,3,3,30,3,30,"neutral",-27,27,1,27
100,14,32,21,55,3,30,"neutral",-23,23,1,-2
100,15,70,67,42,3,34,"neutral",28,28,-1,36
100,16,45,65,32,3,41,"neutral",13,13,-1,4
100,17,54,65,41,3,43,"neutral",13,13,-1,11
100,18,53,54,48,4,47,"positive",5,5,-1,6
100,19,23,65,49,3,45,"neutral",-26,26,1,22
100,20,3,3,44,2,41,"negative",-41,41,1,38
100,21,39,45,33,4,43,"positive",6,6,-1,-4
100,22,10,17,51,3,41,"neutral",-41,41,1,31
100,23,56,47,37,4,45,"positive",19,19,-1,11
100,24,37,54,43,4,42,"positive",-6,6,1,5
100,25,56,76,39,2,51,"negative",17,17,-1,5
100,26,68,47,35,3,48,"neutral",33,33,-1,20
100,27,52,43,30,2,19,"negative",22,22,-1,33
100,28,44,65,70,3,63,"neutral",-26,26,1,19
100,29,34,56,10,2,60,"negative",24,24,-1,-26
100,30,37,54,23,3,43,"neutral",14,14,-1,-6
100,31,9,37,23,4,43,"positive",-14,14,1,34
100,32,3,35,36,3,42,"neutral",-33,33,1,39
100,33,77,77,33,2,31,"negative",44,44,-1,46
100,34,35,57,36,4,48,"positive",-1,1,1,13
100,35,34,45,45,4,48,"positive",-11,11,1,14
100,36,3,3,43,3,33,"neutral",-40,40,1,30
100,37,67,65,38,2,45,"negative",29,29,-1,22
100,38,5,3,33,3,32,"neutral",-28,28,1,27
100,39,26,34,47,3,39,"neutral",-21,21,1,13
